Affrica	Africa
Iapan	Japan
Sūðamerica	South America
Norþweg	Norway
Englaland	England
Scotland	Scotland
Wēalas	Wales
Norðerne Īrland	Northern Ireland
Īrland Cynewīse	Republic of Ireland
Ungerland	Hungary
Spēonland	Spain
Geānedu Rīcu American	United States
Belgice	Belgium
Letseburg	Luxembourg
Eorðe	Earth
Līf	Life
George Washington	George Washington
Finnland	Finland
Swēoland	Sweden
Denemearc	Denmark
Polaland	Poland
Liþþuania	Lithuania
Italia	Italy
Swissland	Switzerland
Ēastrīce	Austria
Grēcland	Greece
Turcland	Turkey
Bēor	Beer
Portugal	Portugal
Europe	Europe
Asia	Asia
Norðamerica	North America
Antarctica	Antarctica
Wikipǣdia	Wikipedia
Niðerland	Netherlands
Nīweoforwīcburg	New York City
Hwæsingatūn, D.C.	Washington, D.C.
Berlin	Berlin
Los Angeles	Los Angeles
Spearctelle	Computer
Genf	Geneva
Betweoxnett	Internet
Barack Obama	Barack Obama
Uruguay	Uruguay
Lunden	London
Æppel	Apple
Paris	Paris
Abraham Lincoln	Abraham Lincoln
Android	Android (operating system)
Google	Google
Mexico	Mexico
Atlantisc Gārsecg	Atlantic Ocean
Sericus Gārsecg	Pacific Ocean
California	California
Mōnandæg	Monday
Æfterra Gēola	January
Solmōnaþ	February
Hrēþmōnaþ	March
Tīw (tungol)	Mars
Cenia	Kenya
Sigelhearwenaland	Ethiopia
Ēastermōnaþ	April
Þrimilcemōnaþ	May
Sēremōnaþ	June
Mǣdmōnaþ	July
Wēodmōnaþ	August
Hāligmōnaþ	September
Winterfylleþ	October
Blōtmōnaþ	November
Gēolmōnaþ	December
Tīwesdæg	Tuesday
Wēdnesdæg	Wednesday
Þunresdæg	Thursday
Frīgedæg	Friday
Sæternesdæg	Saturday
Sunnandæg	Sunday
Lēo	Lion
Francland	France
Esperanto	Esperanto
Geāned Cynerīce	United Kingdom
Catte	Cat
Cīnan Folclicu Cynewīse	China
Frencisc sprǣc	French language
Fisc	Fish
Brasil	Brazil
Russland	Russia
Eoferwicscīr	Yorkshire
Sǣ	Sea
Euxinus	Black Sea
Toronto	Toronto
Alabama	Alabama
São Paulo	São Paulo
São Paulo (rīce)	São Paulo (state)
Quebec	Quebec
Piza	Pizza
Þēodscland	Germany
Hwītrussland	Belarus
Þēodsc sprǣc	German language
Īsland	Iceland
God	God
Estland	Estonia
Sætern (tungol)	Saturn
Ceocōlāte	Chocolate
2 (getæl)	2 (number)
Þrīe	3 (number)
Fēower	4 (number)
Fīf	5 (number)
George W. Bush	George W. Bush
Lettland	Latvia
Ucrægna	Ukraine
Cecland	Czech Republic
Slofacia	Slovakia
Slofenia	Slovenia
Vilnius	Vilnius
Moldofa	Moldova
Rumǣnia	Romania
Pulgaraland	Bulgaria
Rōm	Rome
Macedonia Cynewīse	Republic of Macedonia
Albania	Albania
Grēneland	Greenland
Croatia	Croatia
Bosnia and Herzegofina	Bosnia and Herzegovina
Godhopa	Nuuk
Azerbaijan	Azerbaijan
Andorra	Andorra
Cipros	Cyprus
Georgia (land)	Georgia (country)
Casahstan	Kazakhstan
Melita	Malta
Flandras	Flanders
Monaco	Monaco
Sweartbeorg	Montenegro
Faticanburg	Vatican City
San Marino	San Marino
Brysel	City of Brussels
Cūba	Cuba
Barbados	Barbados
Cǣgbord (spearctellend)	Computer keyboard
Indonesia	Indonesia
Wolfgang Amadeus Mozart	Wolfgang Amadeus Mozart
Ludwig van Beethoven	Ludwig van Beethoven
Sūðaffrica	South Africa
Algeria	Algeria
Usbecastan	Uzbekistan
Warsaw	Warsaw
Wīn (drinc)	Wine
Wæter	Water
Holt	Wood
Feorrsīen	Television
Īslendisc sprǣc	Icelandic language
Cile	Chile
Iesus	Jesus
Elvis Presley	Elvis Presley
Wōden (tungol)	Mercury (planet)
Stǣr	History
Apple Inc.	Apple Inc.
Frig (tungol)	Venus
Sprǣc	Language
Lufu	Love
Þunor (tungol)	Jupiter
Uranus	Uranus
Neptune (planēta)	Neptune
Tungolcræft	Astronomy
Witancræft	Science
Pluto	Pluto
Montreal	Montreal
Lēohtenstān	Liechtenstein
Plega	Sport
Grantanbrycg	Cambridge
Adolf Hitler	Adolf Hitler
Fyrst Woruldgūþ	World War I
Ōðru Woruldgūþ	World War II
Wikibēc	Wikibooks
Augusto Pinochet	Augusto Pinochet
Geanca Cupala	Yanka Kupala
Ubuntu	Ubuntu (operating system)
Stettin	Szczecin
Rīmcræft	Mathematics
U2	U2
Lǣden	Latin
Bahrain	Bahrain
Armenia	Armenia
Serbia	Serbia
Mōna	Moon
Constantinopolis	Istanbul
Australia	Australia
Bob Marley	Bob Marley
Argentina	Argentina
Peru	Peru
Norþcorēa	North Korea
Cambodia	Cambodia
Kuiperes gyrtel	Kuiper belt
Curān	Quran
Alladōm	Islam
Lech Wałęsa	Lech Wałęsa
Europisce Gesamnung	European Union
Woruldwīd Webb	World Wide Web
Wīf	Woman
Wætertyge	Aqueduct (bridge)
Don Quijote	Don Quixote
Megelan	Milan
Burg	City
Napoleon I Francena Cāsere	Napoleon
Uesuuius	Mount Vesuvius
Sunne	Sun
Lēohtgēar	Light-year
Sunnlicu Endebyrdnes	Solar System
Ostsǣ	Baltic Sea
Wisle	Vistula
Tōþ	Tooth
Wætertimber	Hydrogen
Wikimedia Commons	Wikimedia Commons
Dæg	Day
Ēasttimor	East Timor
Niht	Night
Gēar	Year
Hundgēar	Century
Rīn	Rhine
Oslo	Oslo
Katowice	Katowice
1 Ceres	Ceres (dwarf planet)
Ii	Iona
Dubai	Dubai
Folga	Volga River
Æðmlyft	Oxygen
Dweligende tungol	Planet
Venetia	Venice
Naruto	Naruto
Moscow	Moscow
Italisc sprǣc	Italian language
Cead	Chad
Nīwe Sǣland	New Zealand
Indea	India
Īsen	Iron
Willelm Scacaspere	William Shakespeare
Lēad	Lead
Mongolland	Mongolia
Ficgīege	Fiji
Feneswela	Venezuela
Blēobord	Chess
Maine	Maine
Hors	Horse
Amsterdam	Amsterdam
Wǣpen	Weapon
Dēor	Animal
Paraguay	Paraguay
Ecuador	Ecuador
Colombia	Colombia
Strēawberge	Fragaria
Buddendōm	Buddhism
Bolifia	Bolivia
Coper	Copper
Plante	Plant
Nīwu Hāmtūnscīr	New Hampshire
Iamaica	Jamaica
Massachusetts	Massachusetts
Connecticut	Connecticut
Henn	Chicken
Hawaii	Hawaii
Cēsarēa	Jersey
Swīn	Domestic pig
Īshæf	Arctic Ocean
Persealand	Iran
Irac	Iraq
Alaska	Alaska
Israhēl	Israel
Utrecht	Utrecht
Gemen	Yemen
Clēofanwyrm	Virus
Polisc sprǣc	Polish language
Hascemisc Cynerīce þæs Iordanes	Jordan
Florida	Florida
Arizona	Arizona
Cuwait	Kuwait
Libanus	Lebanon
Oregon	Oregon
Utah	Utah
Hriðer	Cattle
Malægsia	Malaysia
Burma	Burma
Oman	Oman
Pacistan	Pakistan
Qatar	Qatar
Tennis	Tennis
Saudisc Arabea	Saudi Arabia
Tāprabane	Sri Lanka
Iosep Stalin	Joseph Stalin
Syria	Syria
Plato	Plato
Tacgicastan	Tajikistan
Aristoteles	Aristotle
Thailand	Thailand
Ūtƿeorp	Radio
Turcmenistan	Turkmenistan
Geānedu Arabisc Bregorīcu	United Arab Emirates
Fietnam	Vietnam
Sūþcorēa	South Korea
Afghanistan	Afghanistan
J. R. R. Tolkien	J. R. R. Tolkien
Gold	Gold
Bængladesc	Bangladesh
Bleach (manga)	Bleach (manga)
Socrates	Socrates
Angola	Angola
Tansania	Tanzania
Philippines	Philippines
Middel Affricanisc Cynewīse	Central African Republic
Sūþende þǣre eaxe	South Pole
Norþende þære eaxe	North Pole
Isaac Newton	Isaac Newton
Albert Einstein	Albert Einstein
Geolu	Yellow
Tunisia	Tunisia
Simbabwe	Zimbabwe
Beicing	Beijing
Sūþsudan	South Sudan
Botswana	Botswana
Burkina Faso	Burkina Faso
Folcrīcelicu Cynewīse þæs Congwes	Democratic Republic of the Congo
Bægwaraland	Bavaria
Baden-Wyrttemberg	Baden-Württemberg
Æriþrea	Eritrea
Nīwe Delhi	New Delhi
Iohannes Paulus II Pāpa	Pope John Paul II
Gabon	Gabon
Mohandas Karamchand Gandhi	Mahatma Gandhi
Gambia	The Gambia
Guinea	Guinea
Elpendbānrima	Ivory Coast
Camerun	Cameroon
Grēnenæs Īega	Cape Verde
Lesotho	Lesotho
Liberia	Liberia
Libia	Libya
Madagascar	Madagascar
Mauritania	Mauritania
Morocco	Morocco
Mosambice	Mozambique
Namibia	Namibia
Nigeria	Nigeria
Charles Darwin	Charles Darwin
Uganda	Uganda
Rwanda	Rwanda
Sōmalia	Somalia
Gaius Iulius Caesar	Julius Caesar
Sudan	Sudan
Swasiland	Swaziland
Hamburg	Hamburg
Heorte	Heart
Brægen	Brain
Prag	Prague
Bleoh	Blue
Seolfor	Silver
Tin	Tin
Reddit	Reddit
Elsass	Alsace
Bihar	Bihar
Michigan	Michigan
Puerto Rico	Puerto Rico
Niðerseaxland	Lower Saxony
Hetwaraland	Hesse
Illinois	Illinois
Norþdakota	North Dakota
Brandenburg	Brandenburg
Langbeardnaland	Lombardy
Sūþdakota	South Dakota
Montǣna	Montana
Wyoming	Wyoming
Ierusalem	Jerusalem
Idaho	Idaho
Hwæsingatūn	Washington (state)
Nevada	Nevada
Danais	Don River (Russia)
Indisc Gārsecg	Indian Ocean
Caribisc Sǣ	Caribbean Sea
Colorado	Colorado
Tuscania	Tuscany
Alpis	Alps
Gænt	Ghent
Chicago	Chicago
The Beatles	The Beatles
Winter	Winter
Ēawielm	Spring (season)
Efenniht	Equinox
Spēonisc sprǣc	Spanish language
Caligardamana	Kolkata
West Bengal	West Bengal
Ātorcoppe	Spider
Virginia	Virginia
Westvirginia	West Virginia
Nīwe Eoforwīc	New York
Rhode Īeg	Rhode Island
Ceorfdēor	Insect
Marianland	Maryland
Delaware	Delaware
Fladimir Lenin	Vladimir Lenin
Ohio	Ohio
Pennsylvānia	Pennsylvania
Uetersen	Uetersen
Augustus	Augustus
Microsoft Windows	Microsoft Windows
Nīwe Cēsarēa	New Jersey
Calpis	Gibraltar
Finnisc sprǣc	Finnish language
Indiǣna	Indiana
Selffērende wægn	Car
Roger Federer	Roger Federer
Georgia (America)	Georgia (U.S. state)
Marcus Aurelius	Marcus Aurelius
Texas	Texas
Puilla	Apulia
Norþcarolīna	North Carolina
Sūþcarolīna	South Carolina
Sicilia	Sicily
Sardinia	Sardinia
Ligore	Loire
Sigen	Seine
Buenos Aires	Buenos Aires
Mexicoburg	Mexico City
Pīnæppel	Pineapple
Mississippi	Mississippi
Mississippi ēa	Mississippi River
Mizoram	Mizoram
Tennessee	Tennessee
Abu Dhabi	Abu Dhabi
Nīwe Mexico	New Mexico
Athēnas	Athens
Minnesota	Minnesota
Wisconsin	Wisconsin
Iowa	Iowa
Nebraska	Nebraska
Kansas	Kansas
Hafana	Havana
Pīpwēod	Tobacco
Missouri	Missouri
Louisiāna	Louisiana
Nagaland	Nagaland
Kentucky	Kentucky
Arkansas	Arkansas
Ælf ēa	Elbe
Oklahoma	Oklahoma
Donua	Danube
Hæfel	Havel
Norþsǣ	North Sea
Flēogeball	Volleyball
Uigenna	Vienna
Cēapmannahæfen	Copenhagen
Stoccholm	Stockholm
Helsinki	Helsinki
Difelin	Dublin
Rēcwīc	Reykjavík
Riga	Riga
Menuþias	Zanzibar
Dantsic	Gdańsk
Frankfurt	Frankfurt
Death Note	Death Note
Biblioþēce	Bible
Ho Chi Minh Burg	Ho Chi Minh City
Sōþ Iesus Cirice	True Jesus Church
Nīwenglisc sprǣc	English language
Andorra la Vella	Andorra la Vella
Đồng Hới	Đồng Hới
Concepcion	Concepción, Chile
Cænugeard	Kiev
Ontario	Ontario
Ottawa	Ottawa
Alberta	Alberta
Nīwe Scotland	Nova Scotia
Końskowola	Końskowola
Geocon Landscipe	Yukon
Florentia	Florence
Ǣt	Food
Snaca	Snake
Halifax	Halifax, Nova Scotia
Quebecceaster	Quebec City
3. Æfterran Gēolan	January 3
4. Æfterran Gēolan	January 4
Región del Biobío (Cile)	Bío Bío Region
5. Æfterran Gēolan	January 5
Arica	Arica
6. Æfterran Gēolan	January 6
7. Æfterran Gēolan	January 7
8. Æfterran Gēolan	January 8
9. Æfterran Gēolan	January 9
10. Æfterran Gēolan	January 10
11. Æfterran Gēolan	January 11
12. Æfterran Gēolan	January 12
13. Æfterran Gēolan	January 13
Beormingahām	Birmingham
14. Æfterran Gēolan	January 14
15. Æfterran Gēolan	January 15
16. Æfterran Gēolan	January 16
17. Æfterran Gēolan	January 17
18. Æfterran Gēolan	January 18
Rōmānisc Rīce	Roman Empire
Microsoft	Microsoft
30. Æfterran Gēolan	January 30
Kurów	Kurów
11. Solmōnðes	February 11
11. Gēolmōnþes	December 11
12. Gēolmōnðes	December 12
17. Gēolmōnðes	December 17
Wæþ	River Forth
Þrittiggēara Orlege	Thirty Years' War
Benedictus XVI Pāpa	Pope Benedict XVI
6. Ēastermōnðes	April 6
4. Ēastermōnþes	April 4
Helmut Kohl	Helmut Kohl
17. Ēastermōnðes	April 17
12. Þrimilcemōnþes	May 12
13. Þrimilcemōnþes	May 13
20. Þrimilcemōnðes	May 20
31 Þrimilcemōnaþ	May 31
6. Mǣdmōnðes	July 6
1. Mǣdmōnðes	July 1
18. Mǣdmōnðes	July 18
Gyldfōtþōðer	Association football
26. Gēolmōnðes	December 26
Eallbærnet	The Holocaust
IPad	IPad
Madrid	Madrid
Elton John	Elton John
Undersǣbāt	Submarine
26. Wēodmōnðes	August 26
24. Wēodmōnðes	August 24
2. Hāligmōnþes	September 2
Kassel	Kassel
Canadisc underrīcu	Provinces and territories of Canada
25. Hāligmōnðes	September 25
Santiago (Cile)	Santiago
1. Winterfylleðes	October 1
14. Winterfylleðes	October 14
8. Winterfylleðes	October 8
7. Winterfylleðes	October 7
Oldenburg (Oldenburg)	Oldenburg
26. Winterfylleðes	October 26
4. Blōtmōnðes	November 4
1. Blōtmōnðes	November 1
Wolfsburg	Wolfsburg
Carl Micela Francena Cyning	Charlemagne
Canberra	Canberra
Sydney	Sydney
Grēne	Green
Rēad	Red
Perþ (Australia)	Perth
Fȳr	Fire
Westerne Australia	Western Australia
Nīwe Sūþwealas	New South Wales
Norþerne Landscipe	Northern Territory
Australisc Hēafodbyrig Landscipe	Australian Capital Territory
Fīfeldor	Eider (river)
Nīl	Nile
Heortfordscīr	Hertfordshire
Comēta	Comet
Angol	Angol
Antofagasta	Antofagasta
Ancyra	Ankara
Flocc:Bysen	Category:Wikipedia templates
Castro (Cile)	Castro, Chile
Frencisc Guiana	French Guiana
Chillán (Cile)	Chillán
Amāzanēa	Amazon River
Tybingen	Tübingen
Coyhaique	Coyhaique
Flocc:Bysen Land	Category:Country templates
Flocc:Bysen tīd	Category:Time, date and calendar templates
Willelmeshæfen	Wilhelmshaven
Copiapó (Cile)	Copiapó
Manama	Manama
Delmenhorst	Delmenhorst
Brandenburg (burg)	Brandenburg an der Havel
Wikipǣdia:Sandbox	Wikipedia:Sandbox
Wikipǣdia:Inlǣdung	Wikipedia:Introduction
Cantabria	Cantabria
Hūs	House
Rīmagiefung	Algebra
Osasco	Osasco
Fujairah	Fujairah
Glasgow	Glasgow
Donghoi Lyfthæfene	Dong Hoi Airport
Rodor	Outer space
Sweartweald	Black Forest
Curitiba	Curitiba
Weald	Forest
Flocc:Cliferfētedēor	Category:Even-toed ungulates
Talca	Talca
Flothere	Navy
Andalién	Andalién River
Bysen:Lang-lt	Template:Lang-lt
Cwidbōc	Book of Proverbs
Rancagua	Rancagua
Confucius	Confucius
Corbin Bleu	Corbin Bleu
Flocc:Rīmcræft	Category:Mathematics
Faroisca Īega	Faroe Islands
Wendelsǣ	Mediterranean Sea
Flocc:Nīwes Sǣlandes īga	Category:Islands of New Zealand
Cōcnearuness	Cook Strait
Crīstendōm	Christianity
Windows 8	Windows 8
Bysen:Asia	Template:Countries of Asia
Gandis	Ganges
Worulddǣl	Continent
Fugol	Bird
Hēafodstōl	Capital city
Monzón	Monzón
Portuglisc sprǣc	Portuguese language
Mōnaþ	Month
Bysen:Fōtball stycce	Template:Footy-stub
Almazán	Almazán
Huang Siānfan	Huang Xianfan
Kescwisc sprǣccynn	Quechuan languages
Bill Gates	Bill Gates
Iapanisc sprǣc	Japanese language
Wīsdōmbōc	Encyclopedia
Hēafodtramet	Main Page
Golf	Golf
Hrōcburhfōtþōðer	Rugby football
Olympisc Gamen	Olympic Games
Eurasia	Eurasia
Andes	Andes
Durban	Durban
Caspia	Caspian Sea
Uictoriamere	Lake Victoria
Estmere	Vistula Lagoon
Babilōn	Babylon
Ēalendisca Īega	Åland Islands
Cægman Īegland	Cayman Islands
Novak Đoković	Novak Djokovic
Fortunatus iegland	Canary Islands
Hrōcburhgesamnunge plega	Rugby union
Ūðwitegung	Philosophy
Flocc:Candidates for speedy deletion	Category:Candidates for speedy deletion
Tē	Tea
Hebe Camargo	Hebe Camargo
Gemǣnre ǣhte rǣd	Communism
Wealdlīste rǣd	Anarchism
Ǣhtwealdes endebyrdness	Capitalism
Frēodōmes þōht	Liberalism
Gilmrǣd	Fascism
Cofentreo	Coventry
Lodi	Lodi, Lombardy
Ōðre Penisc Gūþ	Second Punic War
Cartaina	Carthage
Bryttisc Museum	British Museum
Sund	Human swimming
1451	1451
Ellaspontus	Dardanelles
Strǣtburg	Strasbourg
Gytārre	Guitar
Croatisc sprǣc	Croatian language
Cesena	Cesena
Hāmburgere	Hamburger
Fédération Internationale de Volleyball	Fédération Internationale de Volleyball
20e gēarhundred	20th century
Stefan Raab	Stefan Raab
Catalan sprǣc	Catalan language
11e gēarhundred	11th century
Gelēaflēasnes	Atheism
Cynn scī huang	Qin Shi Huang
Elisabeþ I Engla Cwēn	Elizabeth I of England
Cynewīse	Republic
Þēodlices gemǣnscipes rǣd	Nazism
Nazi Þēodscland	Nazi Germany
Christopher Columbus	Christopher Columbus
Iacobus Cōc	James Cook
Ēare	Ear
Nasu	Nose
Ēage	Eye
Scēap	Sheep
Mereswīn	Dolphin
Sǣhund	Shark
Sycedēor	Mammal
Ǣmette	Ant
Bēo	Bee
Niðerlendisc sprǣc	Dutch language
Ǣȝƿyrt	Eggplant
Draca	Dragon
Mōdor	Mother
Snāw	Snow
Wæterþōðer	Water polo
1865	1865
Napoleon III Francena Casere	Napoleon III
Russisc sprǣc	Russian language
Hloþwig XIV Francena Cyning	Louis XIV of France
Hām	Home
Vladimir Putin	Vladimir Putin
Loðwic-Philippus Francena Cyning	Louis Philippe I
Þēodacynewīse	Commonwealth of Nations
Hlāf	Bread
Taurica	Crimea
Līfclēofa	Cell (biology)
Blōd	Blood
Īwungplega	Video game
Rumǣnisc sprǣc	Romanian language
Regn	Rain
Medumweder	Climate
Woruldlicu wearmung	Global warming
Eorþbeofung	Earthquake
Museum on Dēoraby	Derby Museum and Art Gallery
Winston Churchill	Winston Churchill
Nelson Mandela	Nelson Mandela
10. gēarhundred	10th century
Fȳrbeorg	Volcano
Wolcen	Cloud
Īwungplegtōl	Video game console
Wind	Wind
Lyfthelm	Atmosphere
Pintel	Human penis
Sprǣccræft	Linguistics
Flocc:Pulgaraland	Category:Bulgaria
Flocc:Francland	Category:France
Flocc:Glīƿdrēam	Category:Music
Flocc:Bōccræft	Category:Literature
Fox	Red fox
Hræfn	Raven
Valladolid	Valladolid
Alexander Mæcedonia Cyning	Alexander the Great
Hēaphandþōðer	Handball
Hugo Chávez	Hugo Chávez
Þēowdōm	Slavery
Caffig	Coffee
Meolc	Milk
Beorg	Mountain
Oferswefn	Hypnosis
Andrew Johnson	Andrew Johnson
Miami	Miami
Americanisce Ingefeoht	American Civil War
Rio de Janeiro	Rio de Janeiro
Bryttisce Rīce	British Empire
Albanisc sprǣc	Albanian language
Ucrægnisc sprǣc	Ukrainian language
Crabba (steorra)	Cancer (constellation)
Swēonisc sprǣc	Swedish language
Denisc sprǣc	Danish language
Norðisc sprǣc	Norwegian language
Noam Chomsky	Noam Chomsky
Bæmisc sprǣc	Czech language
Karl Marx	Karl Marx
Lettisc sprǣc	Latvian language
Liþþuanisc sprǣc	Lithuanian language
Hinduismus	Hinduism
Wīflicu brēost	Breast
Mot	Atom
Crēacisc sprǣc	Greek language
Weorcendebyrdness	Operating system
Īrisc sprǣc	Irish language
Ambihtlic Cīnisc sprǣc/ᚱᚢᚾ	Mandarin Chinese
C. S. Lewis	C. S. Lewis
Baku	Baku
Hebrēisc sprǣc	Hebrew language
Azeri sprǣc	Azerbaijani language
Wilisc sprǣc	Welsh language
Scyttisce sprǣc	Scottish Gaelic
John Locke	John Locke
Friedrich Nietzsche	Friedrich Nietzsche
Lifere	Liver
Gārsecg	Ocean
Gautama Budda	Gautama Buddha
Premier League	Premier League
Mahomet	Muhammad
Ācweorna	Squirrel
Rēmisc Cirice	Catholic Church
Bengalisc sprǣc	Bengali language
Tunge	Tongue
Folcland Īegland	Falkland Islands
Manīeg	Isle of Man
Wiht (īeg)	Isle of Wight
Heortford	Hertford
Elisabeþ II	Elizabeth II
ß	ß
John F. Kennedy	John F. Kennedy
Ronald Reagan	Ronald Reagan
Æ	Æ
Ð	Eth
Fernando Alonso	Fernando Alonso
Flocc:Feneswela	Category:Venezuela
Þunreshæfen	Tórshavn
11. Hāligmōnþes 2001. torngemōt	September 11 attacks
Culfre	Columbidae
Trēow	Tree
Cīese	Cheese
Wīnberge	Grape
Hunig	Honey
Eorþperu	Potato
Searuþræl	Robot
Searucræft	Technology
Feorrspreca	Telephone
Lugo	Lugo
Hēahdēmere þāra Geāndena Rīca American	Chief Justice of the United States
Windows 7	Windows 7
Windows Vista	Windows Vista
World Trade Center	World Trade Center
Nelson Rockefeller	Nelson Rockefeller
David Rockefeller	David Rockefeller
One World Trade Center	One World Trade Center
Fidel Castro	Fidel Castro
Rockefeller Center	Rockefeller Center
Flocc:Brasil	Category:Brazil
Flocc:Rumǣnia	Category:Romania
Hēafodgesceaft	Chemical element
Gemot	Molecule
Cræftlicu endebyrdung	Biological classification
Lyft	Gas
Lyftcræft	Aircraft
Clāðas	Clothing
Swēg	Sound
Paper	Paper
Rīm	Number
Bere	Barley
Nirvana	Nirvana (band)
Weder	Weather
Land þǣre worulde	List of sovereign states
Bera	Bear
John Adams	John Adams
Thomas Jefferson	Thomas Jefferson
James Madison	James Madison
James Monroe	James Monroe
John Quincy Adams	John Quincy Adams
Andrew Jackson	Andrew Jackson
Martin Van Buren	Martin Van Buren
William Henry Harrison	William Henry Harrison
John Tyler	John Tyler
James K. Polk	James K. Polk
Zachary Taylor	Zachary Taylor
Ǣtweg	Digestion
Kylie Minogue	Kylie Minogue
Āc	Oak
Pīntrēow	Pine
Āte	Oat
Hwǣte	Wheat
Corn	Cereal
Unmeaht	Disability
Gerīmbōc	Calendar
Ādl	Disease
Gregorisc gerīmbōc	Gregorian calendar
Soria	Soria
Manisc sprǣc	Manx language
Bysen:Stedefindend scite Breten	Template:Location map United Kingdom
Millard Fillmore	Millard Fillmore
Franklin Pierce	Franklin Pierce
James Buchanan	James Buchanan
Pireni	Pyrenees
Hālig Rōmānisc Rīce	Holy Roman Empire
Mongolrīce	Mongol Empire
Oþomanisce Rīce	Ottoman Empire
Cirice Ednīwung	Protestant Reformation
Wīcingas	Vikings
Sweord	Sword
Fȳrwǣpen	Firearm
Iberia	Iberian Peninsula
Fȳrspringend	Explosive material
Campwægn	Tank
Antwerpen	Antwerp
François Asselineau	François Asselineau
Brycg (burh)	Bruges
Blǣwenberge	Blueberry
Blæcberige	Blackberry
Fenberge	Cranberry
Cīnisc gōsberige	Kiwifruit
Retoromanisc sprǣc	Romansh language
Īsrēam	Ice cream
Ceace	Cake
Īsbrīw	Sorbet
Dinegisc sprǣc	Navajo language
Meolcbrīw	Yogurt
Montserrat	Montserrat
Bysen:Location map Greenland	Template:Location map Greenland
Wikicynn	Wikispecies
Arabisc sprǣc	Arabic language
Ian Magen	Jan Mayen
Corsica	Corsica
Affricanisc sprǣc	Afrikaans
Forma Þegn þæs Geānedan Cynerīces	Prime Minister of the United Kingdom
Santiago de Compostela	Santiago de Compostela
Fiscoþ	Fishing
Iquique	Iquique
La Serena (Cile)	La Serena, Chile
Las Condes	Las Condes
Lebu	Lebu, Chile
Lo Barnechea	Lo Barnechea
Niðerscyttisc sprǣc	Scots language
Linux (cyrnel)	Linux kernel
Darwin (æhtendebyrd)	Darwin (operating system)
Emmen	Emmen, Netherlands
Sofiet Gesamnung	Soviet Union
Se Hlāford þāra Hringa	The Lord of the Rings
Hrūse	Crust (geology)
Sīensearu	Still camera
Gaðes	Cádiz
Llión	León, Spain
Fōt	Foot
Queen	Queen (band)
Freddie Mercury	Freddie Mercury
Normandig	Normandy
Metallica	Metallica
Wikipǣdia:Fulgōd gewritu	Wikipedia:Featured articles
Lēoht (dæg)	Daylight
Wikipǣdia:Se Þorpes Wella	Wikipedia:Village pump
Vermont	Vermont
Jacksonville, Florida	Jacksonville, Florida
Los Ángeles (Cile)	Los Ángeles, Bío Bío
Eþna	Mount Etna
Æg	Egg
Tibet	Tibet
Handsprecend	Mobile phone
Strȳta	Ostrich
Corēa	Korea
Wesend	Bison
Mameceaster	Manchester
Turcas and Caicos Īegland	Turks and Caicos Islands
Blēocræft	Embroidery
Wulf	Gray wolf
Major League Soccer	Major League Soccer
Þōðer	Ball
Club de Gimnasia y Esgrima La Plata	Club de Gimnasia y Esgrima La Plata
Nīwu Gecȳþnes	New Testament
Ælfric Ercebiscop of Cantawarabyrig	Ælfric of Abingdon
Middelseaxe	Middlesex
San Pedro de la Paz	San Pedro de la Paz
Scræf (fugol)	Cormorant
Dūfedoppa	Pelican
Nha Trang	Nha Trang
Podolsk	Podolsk
Pāpa	Pope
Rafael Correa	Rafael Correa
5	5
Louvre	Louvre
Sæfern	River Severn
Temes	River Thames
Tirana	Tirana
Motorhead	Motörhead
Afen	River Avon, Bristol
6	6
Josh Duhamel	Josh Duhamel
Stīðen Āc	Stevenage
Crīstesmæsse	Christmas
Bises	Leap year
Steve Jobs	Steve Jobs
Indo-Europisc sprǣchīred	Indo-European languages
Breinigerberg	Breinigerberg
Muammar al-Gaddafi	Muammar Gaddafi
Tiger	Tiger
Moru	List of root vegetables
Samsunghēap	Samsung
Ēaster	Easter
Germanisca sprǣca	Germanic languages
Windows Mobile	Windows Mobile
GNU Frēo Gewrita Amearcunge Lēaf	GNU Free Documentation License
John Kerry	John Kerry
Searusprecend	Smartphone
Trōia	Troy
Nīwe Eoforwīc (scīrung)	New York (disambiguation)
Ceafer	Beetle
Scōh	Shoe
Baðanceaster	Bath, Somerset
Īrland	Ireland
Bradanford	Bradford
Ceasterscīr	Cheshire
Lonceasterscīr	Lancashire
Norþhymbraland	Northumberland
Dūnholmscīr	County Durham
Lincolnscīr	Lincolnshire
Snotingahāmscīr	Nottinghamshire
Dēorabyscīr	Derbyshire
Scrobbesbyrigscīr	Shropshire
Stæffordscīr	Staffordshire
Lægreceastrescīr	Leicestershire
Roteland	Rutland
Norþfolc	Norfolk
Sūþfolc	Suffolk
Grantabrycgscīr	Cambridgeshire
Norþhāmtūnescīr	Northamptonshire
Westmidlandscīr	West Midlands (county)
Herefordscīr	Herefordshire
Wigreceastrescīr	Worcestershire
Wæringscīr	Warwickshire
Beadanfordscīr	Bedfordshire
Cornweal	Cornwall
Bricgstōw	Bristol
Defenascīr	Devon
Sumorsǣte	Somerset
Dorsǣte	Dorset
Gleawcesterscīr	Gloucestershire
Oxnafordscīr	Oxfordshire
Wiltūnscīr	Wiltshire
Hāmtūnescīr	Hampshire
Bearrucscīr	Berkshire
Buccingahāmscīr	Buckinghamshire
Ēastseaxe	Essex
Sūþrīge	Surrey
Cent	Kent
Lundenceaster	City of London
Westmoringaland	Westmorland
Huntandūnscīr	Huntingdonshire
Sūþseaxe	Sussex
Seofon	7 (number)
Taylor Lautner	Taylor Lautner
Cumbraland	Cumberland
Jeremy Renner	Jeremy Renner
Īs	Ice
Fæder ūre	Lord's Prayer
Musée d'Orsay	Musée d'Orsay
Hwerhwette	Cucumber
Edinburg	Edinburgh
Hwīt	White
Sweart	Black
Chris Pine	Chris Pine
Lordi	Lordi
6 (getæl)	6 (number)
Ambihtlicu sprǣc	Official language
Heortæppel	Tomato
Phong Nha-Ke Bang	Phong Nha-Kẻ Bàng National Park
Entrena	Entrena
Selena	Selena
NASA	NASA
Merida (Feneswela)	Mérida, Mérida
Atlanta	Atlanta
Benito Mussolini	Benito Mussolini
Bermuda	Bermuda
Hēafod	Head
Weolingtūn (Nīwe Sǣland)	Wellington
Bryten	Great Britain
Alfred Nobel	Alfred Nobel
Camb (tō hǣre)	Comb
Mennisc līc	Human body
Lila Downs	Lila Downs
Andrew Garfield	Andrew Garfield
Dottatiger	Cheetah
Rosanna Davison	Rosanna Davison
Albany on Nīwum Eoforwīce	Albany, New York
Ūle	Owl
Anguilla	Anguilla
Guernsey	Guernsey
Scearpbeorgas	Svalbard
Hrycgdēor	Vertebrate
Nowy Dwór Królewski	Nowy Dwór Królewski
Faroisc sprǣc	Faroese language
Catt	Felidae
Lytel Spēonland	Hispaniola
Harrisburg	Harrisburg, Pennsylvania
Hamor	Hammer
Picilemo	Pichilemu
Bryttiscan Fæmne Īegland	British Virgin Islands
Flēoge	Fly
Norða	Arctic
Hund	Canidae
Fresisc sprǣc	Frisian languages
Antoni Gaudí	Antoni Gaudí
Cliferfētedēor	Even-toed ungulate
Steorrfisc	Starfish
Eurasisc bleohcrāwe	Eurasian jay
Hrōc	Rook (bird)
Ēotaland	Jutland
Niþeru Þēodsc sprǣc	Low German
Mölnlycke	Mölnlycke
Coning	European rabbit
Cuscan Rīce	Kushan Empire
Tromsīeg	Tromsø
Sandwīc	Sandwich, Kent
Eormengyld Niccolò Cusano	Università degli Studi Niccolò Cusano
Montpelier on Uermonte	Montpelier, Vermont
Geac	Yak
Palistiniscre Frēogunge Þēodnes	Palestine Liberation Organization
Westgermanisca sprǣca	West Germanic languages
Taylor Swift	Taylor Swift
Cōcīega	Cook Islands
Brocc	European badger
Sealterisc sprǣc	Saterland Frisian language
Middelasia	Central Asia
Langaland	Langeland
Sealterland	Saterland
Ofersǣwisc rind	Cinnamon
Jackson (Mississippi)	Jackson, Mississippi
Concord (Nīwu Hāmtūnscīr)	Concord, New Hampshire
Annapolis	Annapolis, Maryland
Eald Corēa	Gojoseon
Hreaðemūs	Bat
Ēastrīce-Ungerland	Austria-Hungary
Tarnobrzeg	Tarnobrzeg
Wesle	Weasel
Scīr	County
Sandwīc (ǣt)	Sandwich
Spearwa	Sparrow
Eormanrīc	Ermanaric
Francisco Franco	Francisco Franco
Tarja Halonen	Tarja Halonen
Willis Tower	Willis Tower
Cantwaraburg	Canterbury
Universidad Mayor	Universidad Mayor
Tracter	Funnel
Englisc lagu	Common law
Seolh	Pinniped
Ecser	Ecser
Silesisc gereord	Silesian language
Zhengzhou	Zhengzhou
Foresittend	President
Frencisc Polynesia	French Polynesia
Roðem	Rouen
Crīstesmæsse Īeg	Christmas Island
Bleohfugol	Parrot
Cambihtere	Cockatoo
Arabea	Arabian Peninsula
Fȳstlāc	Boxing
Seax	Knife
Top Gear	Top Gear (2002 TV series)
Tasmansǣ	Tasman Sea
Ceroke sprǣc	Cherokee language
Campwīg be Tannebeorge	Battle of Grunwald
Īsbera	Polar bear
Hand	Hand
Tu Fu	Du Fu
Nīwe Scotta Ēaland	New Caledonia
Cecoslofacia	Czechoslovakia
Lēaf	Leaf
Nepal Bhasa	Newar language
Valparaíso (on Cilan)	Valparaíso
Fugolīeg, Sūþgeorgia	Bird Island, South Georgia
Annenkovīeg	Annenkov Island
Nathalia Dill	Nathalia Dill
Oaxaca	Oaxaca
Tahitisc sprǣc	Tahitian language
Flemisc sprǣc	Flemish
Yasser Arafat	Yasser Arafat
Oxnaford	Oxford
Międzyrzec Podlaski	Międzyrzec Podlaski
Tasmania	Tasmania
Creto	Crete
Saint-Dié-des-Vosges	Saint-Dié-des-Vosges
Eormengyld Oxnafordes	University of Oxford
Þyrla	Helicopter
Sancte Elene Īeg	Saint Helena
Nicor	Hippopotamus
Egisca Sǣ	Aegean Sea
Ichiro Mizuki	Ichirou Mizuki
Anastacia	Anastacia
Eufrāte	Euphrates
James A. Garfield	James A. Garfield
Cirice	Christian Church
Persisc Sǣ	Persian Gulf
Sand	Sand
Cyningestūn (Iamaica)	Kingston, Jamaica
Lafor	Leopard
Age of Empires	Age of Empires
Tequixquiac	Tequixquiac
Ulysses S. Grant	Ulysses S. Grant
Oklahoma City	Oklahoma City
Meotedisca Mere	Sea of Azov
William McKinley	William McKinley
Cawel	Cabbage
Foresittend þāra Geāndena Rīca	List of Presidents of the United States
Sūþgeorgia and þā Sūþsandwic Īegland	South Georgia and the South Sandwich Islands
Webbsīde	Website
Ealdfresisc sprǣc	Old Frisian
Catalão	Catalão
Grover Cleveland	Grover Cleveland
Ealdhēahþēodisc	Old High German
Ealdseaxisc sprǣc	Old Saxon
Satan	Satan
Wordstǣrcræft	Etymology
Beorglēo	Cougar
Arabas	Arabs
Proponditis	Sea of Marmara
Ēagduru	Window
Chester A. Arthur	Chester A. Arthur
Riffeng	Ural Mountains
Rīcu þāra Geāndena Rīca American	U.S. state
Pitcearnīega	Pitcairn Islands
Benjamin Harrison	Benjamin Harrison
Rutherford B. Hayes	Rutherford B. Hayes
Wīnlendisc panðer	Jaguar
Sūþaustralia	South Australia
Gotisc sprǣc	Gothic language
Boise	Boise, Idaho
Bāt	Boat
Awaisc sprǣc	Guarani language
Gærsbēam	Bamboo
Interlingua	Interlingua
Bosporos	Bosphorus
Smyrna	İzmir
Lemburg	Lviv
Cwēneland	Queensland
Siligo	Siligo
Puerto Montt	Puerto Montt
Iane Austen	Jane Austen
Tægcwondo	Taekwondo
Middel Englisc sprǣc	Middle English
Māorisc sprǣc	Māori language
Hannibal	Hannibal
Hōrdōm	Prostitution
Twinemniendlic nama	Binomial nomenclature
Victoria (Australia)	Victoria (Australia)
Geugoslafia	Yugoslavia
Ætla	Attila
Scrælingas	Indigenous peoples of the Americas
Arancón	Arancón
Willelm Heretoga of Grantanbrycge	Prince William, Duke of Cambridge
Toshiro Mifune	Toshiro Mifune
Tallahassee	Tallahassee, Florida
Sundorrīcehād	Independence
Bismarck (Norþdakota)	Bismarck, North Dakota
Aucland	Auckland
Iohannes Paulus I Pāpa	Pope John Paul I
John Michael Talbot	John Michael Talbot
Acrotiri and Ðecelia	Akrotiri and Dhekelia
Arara	Arara, Paraíba
Cnēo	Knee
Willelm I Engla Cyning	William the Conqueror
Campora Sancte Iohannes	Campora San Giovanni
Sīde	Silk
Sint-Truiden	Sint-Truiden
Lēoðlic scātung	Figure skating
Stefn (līfcræft)	Phylum
Heanrig VIII Engla Cyning	Henry VIII of England
Columbia (Sūþcarolīna)	Columbia, South Carolina
Xena: Warrior Princess	Xena: Warrior Princess
1880. gēar oþ 1889. gēar	1880s
Helena (Montana)	Helena, Montana
Wælhwelp	Hunting dog
Eormengyld Biobiwes	University of the Bío Bío
Sufa	Suva
Muntgumniscīr	Montgomeryshire
Eorþmistel	Basil
Lēohtfȳsend	Laser
Prēossland	Prussia
Cheyenne (Wyoming)	Cheyenne, Wyoming
Norðerne healftrendel	Northern Hemisphere
Loidis	Leeds
Fūcgī Beorg	Mount Fuji
Mūs	Mouse
Geolurēad	Orange (colour)
Æcs	Axe
Seofonbyrig	Transylvania
Tōl	Tool
Alī	Ali
Hrān	Reindeer
Stānhencg	Stonehenge
Ágreda	Ágreda
Amazonas	Amazonas (Brazilian state)
Ajaccio	Ajaccio
Rodorcræft	Spacecraft
Lisa Gerrard	Lisa Gerrard
Thirty Seconds to Mars	Thirty Seconds to Mars
Paulínia	Paulínia
Pierre	Pierre, South Dakota
Crabba	Crab
God Nerie þā Cwēne	God Save the Queen
Meteūtsiht	Diarrhea
Anna Maria Jopek	Anna Maria Jopek
Horshwæl	Walrus
Fōrhēafod	Forehead
Haile Selassie	Haile Selassie
Caðum	Caen
Sonygegyld	Sony
Mynet	Coin
Sūðerne Healftrendel	Southern Hemisphere
Cnihtas þæm Temple	Knights Templar
Americanisc fōtball	American football
Tōþsticca	Toothpick
Folcmorðor	Genocide
Hociȝ	Ice hockey
Swīnmūþa	Świnoujście
Īrisc Sǣ	Irish Sea
Tracia	Thrace
Mongolas	Mongols
Mǣs	Meuse (river)
Talcahuano	Talcahuano
Tahitīeg	Tahiti
Ontynung	Book of Revelation
Abel Tasman	Abel Tasman
Gotan	Goths
Nettfrumfindend	Uniform resource locator
Ænglisc sprǣc	Old English
Englisc folc	English people
Eoforwic	York
Iron Maiden	Iron Maiden
Asterix	Asterix
Grǣg	Grey
Wearm geard	Tropics
Hwælhuntoþ	Whaling
Sǣcū	Manatee
Gregorius Pāpa I	Pope Gregory I
Cȳta (lyftcræft)	Kite
Þunor	Thor
Castel Goffredo	Castel Goffredo
Roðos	Rhodes
Sanct	Saint
Wikipǣdia:FAQ	Wikipedia:FAQ
Galatasaray	Galatasaray S.K.
Cycene	Kitchen
Wæterdraca	Crocodylidae
Hlæstwægn	Truck
Carl Wēala Þēoden	Charles, Prince of Wales
Villeneuve-d'Ascq	Villeneuve-d'Ascq
Crāwe	Corvus (genus)
Sūþtun on Defnum	Plymouth
Bryttisca Indisca Garsecg Landscipe	British Indian Ocean Territory
Dēoraby	Derby
Francan	Franks
Fealcen	Falcon
Nightwish	Nightwish
Mattheus se Godspellere	Matthew the Apostle
Mac OS	Mac OS
Leyden	Leiden
Fiðerlēasere	Kiwi
Montehermoso	Montehermoso
Louis the Pious	Louis the Pious
Cwēnsǣ	White Sea
Jim Morrison	Jim Morrison
GNOME	GNOME
Hāt	Heat
Spere	Spear
Ēadig getæl	Happy number
Charleston (Westvirginia)	Charleston, West Virginia
Mynster	Monastery
Oxnaford Englisc Wordbōc	Oxford English Dictionary
Īsearn	Kingfisher
Carl XVI Gustaf Swēona Cyning	Carl XVI Gustaf of Sweden
Świętochłowice	Świętochłowice
Nile	Nile (disambiguation)
Zac Efron	Zac Efron
Monte Carlo	Monte Carlo
Elba	Elba
The Doors	The Doors
Fylfōt	Swastika
Clerke Clūdas	Clerke Rocks
Hara	Hare
Rīcisc edisc	National park
Boga	Bow and arrow
Byrdling	Tortoise
Bryttisc landbūnes	British Overseas Territories
Handscēotend	Side arm
Brūn	Brown
Hjaltland	Shetland
Byrddæg	Birthday
Æx-in-Profentse	Aix-en-Provence
Gaza	Gaza City
Īsbeorg	Iceberg
Ephese	Ephesus
Englisc wera rīcisc fōtballtēam	England national football team
Pratibha Patil	Pratibha Patil
Minte	Mentha
Spilcarte	Playing card
Bysen:Commonscat	Template:Commons category
Hālig Land	Holy Land
Folcland Gewinn	Falklands War
Beadu be Culme	Battle of Kulm
Bēowulf	Beowulf
Marīahæfen	Mariehamn
Hrǣw	Cadaver
IOS	IOS
Lee Harvey Oswald	Lee Harvey Oswald
Frumtæl	Prime number
Þ	Thorn (letter)
Orlando	Orlando, Florida
Saint Petersburg	St. Petersburg, Florida
Hereðaland	Hordaland
Sogn and þa Flēotas	Sogn og Fjordane
Meore and Romsdæl	Møre og Romsdal
Troms	Troms
Dǣlere	Divisor
Australisc fōtþōðer	Australian rules football
Secglēac	Chives
Stānweall sacunga	Stonewall riots
Providencia (Cile)	Providencia, Chile
Punta Arenas	Punta Arenas
Aaron	Aaron
Wu-Tang Clan	Wu-Tang Clan
Osgar I Swēona Cyning	Oscar I of Sweden
Hwēolrinnung	Cycling
Aquilegia	Aquileia
Hyll	Hill
Flocc:Cyningas	Category:Kings
Beorneslēah	Barnsley
Banff	Banff, Aberdeenshire
Soria (scīr)	Province of Soria
San Carlos (on Cilan)	San Carlos, Chile
El Royo	El Royo
Harold V Norrena Cyning	Harald V of Norway
Þēodlic Dæg	National Day
John Key	John Key
Ēadweard I Engla Cyning	Edward I of England
Sūþerne Thila	Southern Thule
Candelmæssanīega	Candlemas Islands
Ræt	Muroidea
Vladimír Franz	Vladimír Franz
Ariel Sharon	Ariel Sharon
1050e	1050s
Æneid	Aeneid
Autaugaville, Alabama	Autaugaville, Alabama
Forma Frencisce Rīce	First French Empire
Brādford	Bredevoort
Se Holbytla	The Hobbit
Eocene	Eocene
Hwilpe	Long-billed curlew
Strǣt	Street
Superman	Superman
Heorotbrēr	Rhamnus (genus)
Wikipǣdia:Fulgōdra gewrita teohhunga	Wikipedia:Featured article candidates
Wikipǣdia:Gōd gewrit genamunga	Wikipedia:Good article nominations
Rætswīn	Guinea pig
Iconium	Konya
Emma Goldman	Emma Goldman
Iacobus I Grēatre Bryten Cyning	James VI and I
Crīstcirice	Christchurch
Coronel Fabriciano	Coronel Fabriciano
Babsk	Babsk
Englisca Ingewinn	English Civil War
Bengal	Bengal
Morgenmete	Breakfast
1060e	1060s
Pippen III Francena Cyning	Pepin the Short
Carl I (Grēatre Bryten Cyning)	Charles I of England
Ȝealdor/ᚷᛖᚪᛚᛞᚩᚱ	Magic (paranormal)
Cucler	Spoon
Geþofted Rīcu American	Confederate States of America
Elpendbān	Ivory
Villarrobledo	Villarrobledo
Temuco	Temuco
Hloðwic I Francena Cyning	Clovis I
William Wallace	William Wallace
Bundesliga	Bundesliga
Fȳrland	Tierra del Fuego
Frēols þǣre Sunnan (on Meridan)	Feria del Sol (Mérida)
Maria I Engla Cwēn	Mary I of England
Angelcirice	Church of England
Engla Cyning	List of English monarchs
Lencten (tīd)	Lent
Fuþorc	Runes
Lēactric	Lettuce
Beadu Hǣstingum	Battle of Hastings
Ēadweard VI Engla Cyning	Edward VI of England
Jacques-Yves Cousteau	Jacques Cousteau
Horatio Nelson	Horatio Nelson, 1st Viscount Nelson
Galilēa	Galilee
Gaderscypefāna	Flag of the United Kingdom
Foldlic clūt	Lithosphere
Þunor (weder)	Thunder
Þūma	Thumb
Ælfrēd Micela	Alfred the Great
Hāmlǣrung	Homeschooling
Teutoburg Weald Beadu	Battle of the Teutoburg Forest
Bysen:Cite book	Template:Cite book
O Canada	O Canada
Biobío	Bío Bío River
Orcanege	Orkney
Profentse	Provence
Predore	Predore
Seaxe	Saxons
Willelm II Engla Cyning	William II of England
Limburgisc	Limburgish language
Eallerīca Gotena Cyning	Alaric I
Tygelwīg	Tug of war
Boētius	Boethius
Hunigbēo	Honey bee
Abbod	Abbot
Mæcedonia	Macedonia (region)
Sameramis	Semiramis
Pīp	Tobacco pipe
Aerosol	Aerosol
Gangnihessou	Do-Aklin
Ilfingburg	Elbląg
Mierce	Mercia
Þēodrīc Ēastgotena Cyning	Theoderic the Great
Westseaxena Rīce	Wessex
Hēahland	Scottish Highlands
Norþhymbra Rīce	Kingdom of Northumbria
Wulfila	Ulfilas
Bram Stoker's Dracula	Bram Stoker's Dracula
Angeow	Anjou
2011 FIFA Frēona Woruldceampscipe	2011 FIFA Women's World Cup
Alexander VI Pāpa	Pope Alexander VI
Æppellēaf	Viola odorata
Mexiciscu rīce	Administrative divisions of Mexico
Edward Braddock	Edward Braddock
Cethāmīga	Chatham Islands
Norþīg	North Island
Anne Cwēn	Anne, Queen of Great Britain
Sūþīeg	South Island
Husvik	Husvik
Dziecinów	Dziecinów, Otwock County
Sunnstede	Solstice
Wynton Rufer	Wynton Rufer
Regnwyrm	Earthworm
Kara	Kara (band)
Ceadmere	Lake Chad
Getalu Rōmāniscra Cāsera	List of Roman emperors
Heantun	Wolverhampton
Wascas	Basques
Minerva	Minerva
Fȳræg	Bomb
Ashley Tisdale	Ashley Tisdale
Þrondham	Trøndelag
Nīwe Woruld	New World
Fȳrweorc	Fireworks
Æsc	Fraxinus
Galwæg	Galway
Ēadweard Andettere	Edward the Confessor
Hramsa	Allium ursinum
Scīdfarung	Skiing
World of Warcraft	World of Warcraft
Byrig þāra Geāndena Rīca	List of United States cities by population
Nemniendlic cāsus	Nominative case
Folcawanderung	Migration Period
Slayer	Slayer
Maria Scotta Cwēn	Mary, Queen of Scots
Indisc rīce	States and union territories of India
Scield	Shield
Henry V Englalandes	Henry V of England
Sciþþia	Scythians
Universidade Federal de Minas Gerais	Universidade Federal de Minas Gerais
Sceanca	Leg
Pulgare	Bulgarians
Lyftscip	Airship
Cnut se Micela	Cnut the Great
Saturnus	Saturn (mythology)
Exanceaster	Exeter
Sanctes Laurentes Ēa	Saint Lawrence River
Patricia Grace	Patricia Grace
Mundlēow	Sink
Sūþhjaltland	South Shetland Islands
Cartespil	Card game
Iscimbag	Ishimbay
Basu Heorte	Purple Heart
Crecganford	Crayford
Marianburg	Malbork
Tenczynek	Tenczynek
Rudno	Rudno, Lesser Poland Voivodeship
Rudawa	Rudawa, Lesser Poland Voivodeship
Rosseg	Mainland, Orkney
Monica Iozzi	Monica Iozzi
Nīwsǣlandworulddǣl	Zealandia (continent)
Carl Fǣtta Francena Cyning	Charles the Fat
Þēodisc Āþbēorscipe	German Confederation
Wikipǣdia:How to edit a page	Help:Editing
Cantwarabyrig eorþbeofung 2011.	2011 Christchurch earthquake
Eorðæppelstycce	French fries
Rīnland	Rhineland
Eormengyld Tybingenes	University of Tübingen
Blōdmearh	Blood sausage
Midsumor	Midsummer
Anlaf V Norrena Cyning	Olav V of Norway
Ēadweard Westseaxna Eorl	Prince Edward, Earl of Wessex
Hacun VII Norrena Cyning	Haakon VII of Norway
Ecgbryht	Egbert of Wessex
Earnulf Carendran	Arnulf of Carinthia
Bēda	Bede
Laplandes Gūþ	Lapland War
Willelm-Alexander Niðerlanda Cyning	Willem-Alexander of the Netherlands
Bredspearctellend	Tablet computer
Mathusal	Methuselah
Universidade Estadual de Feira de Santana	State University of Feira de Santana
Europisc wild gingifer	Asarum europaeum
Bēowyrt	Acorus calamus
Pontcysyllte Wætertyge	Pontcysyllte Aqueduct
Universidade Federal da Bahia	Federal University of Bahia
Centro Federal de Educação Tecnológica de Minas Gerais	Centro Federal de Educação Tecnológica de Minas Gerais
Nēohwæl	Narwhal
Ajman	Emirate of Ajman
Harold Godwinson	Harold Godwinson
Ȳþrīdung	Surfing
Brū	Eyelash
Port:Stǣr	Flag of Tajikistan
Kiæresburh	Cherbourg-Octeville
Bresl	Pretzel
CONCACAF	CONCACAF
Mentha arvensis	Mentha arvensis
Searoburg	Salisbury
Lunden Ēage	London Eye
Valdivia	Valdivia
Pachuca de Soto	Pachuca
Crāwlēac	Allium vineale
Balsminte	Mentha aquatica
Dweorgedosle	Mentha pulegium
Landbūnes	Dependent territory
Rēadingas	Reading, Berkshire
Mængo	Mangifera
Grēate Bryten Cynerīce	Kingdom of Great Britain
Brōcminte	Mentha longifolia
Iane Grey Hlæfdige	Lady Jane Grey
Charmed	Charmed
Grammatisc cyn	Grammatical gender
Nica Ūphebbung	Nika riots
Sihþ	Visual perception
Brycgāðexe	Tuatara
Hetware	Chatti
Americanisc wera rīcisc fōtballtēam	United States men's national soccer team
Maywood, Illinois	Maywood, Illinois
Þrēo Coreaniscu Cynerīcu	Three Kingdoms of Korea
Feðer (blæces)	Pen
Pening	Pfennig
Bryttisca Antarctisca Landscipe	British Antarctic Territory
Starcraft	StarCraft
Seofon dēadlica synna	Seven deadly sins
Zavodovski-īeg	Zavodovski Island
Finger	Middle finger
Midwearme geardas	Temperate climate
Angleseg	Anglesey
Niðerseaxisc sprǣc	West Low German
Māse	Tit (bird)
Caselle Landi	Caselle Landi
Penwiðsteort	Land's End
Ratchet & Clank	Ratchet & Clank (video game)
Æðelstān Engla Cyning	Æthelstan
Ras al-Khaimah	Ras al-Khaimah
Elene Constantinoples	Helena (empress)
Nintendo DS	Nintendo DS
Ēse	Æsir
Nīwe Francland	New France
Englalandes Fana	Flag of England
Cyclades	Cyclades
Trafalgar Sǣfeoht	Battle of Trafalgar
Iosephine Francena Caserin	Joséphine de Beauharnais
Sōlate	Helianthus annuus
Cynelica Sciphere	Royal Navy
Inbærnes	Frankincense
Difelinscīr	County Dublin
Æppelcyrnel (wǣpen)	Hand grenade
Helm	Helmet
Umm Al Quwain	Umm al-Quwain
Nīwes Sǣlandes þēodlīc fōtþōðerhēap	New Zealand national football team
Ingang:Stǣr	Portal:History
Nonne Etone	Nuneaton
Fīfte Cynewīse	Fifth Republic
The Oval	The Oval (Belfast)
2010 FIFA Woruldceampscipe	2010 FIFA World Cup
Sunu	Son
Caltojar	Caltojar
Grīpfealcen	Gyrfalcon
Snāwbordfarung	Snowboarding
Ōsgeard	Asgard
Glīdflēogung	Paragliding
Mageoscīr	County Mayo
Berlanga de Duero	Berlanga de Duero
Australisc rīce	States and territories of Australia
Blizzard Entertainment	Blizzard Entertainment
Gerinnung	Coagulation
Dofras	Dover
Cannae Beadu	Battle of Cannae
Herenuma	Prisoner of war
Dȳfung	Underwater diving
Daguerreotype	Daguerreotype
Dūnholm	Durham, England
Þrēotīene Landbūnessa	Thirteen Colonies
Brenda Song	Brenda Song
Lincoln	Lincoln, England
Syllīega	Isles of Scilly
Smallville (TV endebyrdnes)	Smallville
Helen Clark	Helen Clark
Būr	Room
Wēala Þēoden	Prince of Wales
Scōnīeg	Scania
Milanes Bann	Edict of Milan
Francforta	Hot dog
Gelocen boge	Crossbow
Catalan Byht	Catalan Bay
Meremægden	Mermaid
Wichlawscīr	County Wicklow
Striuelin	Stirling
Æðelred Unrǣd	Æthelred the Unready
Twentig Þūsend Lēowena Under þǣm Sǣ	Twenty Thousand Leagues Under the Sea
Baius	Bayeux
Ballōn (lyftcræft)	Balloon (aeronautics)
Colneceaster	Colchester
Meodu	Mead
Met (Grammaticcræft)	Grammatical mood
Sǣelpend	Elephant seal
Grytviken	Grytviken
Fox News	Fox News Channel
Brīw	Porridge
Ēadweard se Ieldra	Edward the Elder
Iþacige	Ithaca
Baius tæpped	Bayeux Tapestry
San Fabián de Alico	San Fabián
Montréal Canadiens	Montreal Canadiens
Underburg	Suburb
Sharjah	Emirate of Sharjah
Antrimscīr	County Antrim
Vigdís Finnbogadóttir	Vigdís Finnbogadóttir
Final Fantasy	Final Fantasy
Norrena Cyning	List of Norwegian monarchs
Westmynster	Westminster
Ēadmund Æðeling	Edmund I
Rachel McAdams	Rachel McAdams
Fermanagh	County Fermanagh
Dūnscīr	County Down
E Pluribus Unum	E pluribus unum
Foresittend Franclandes	President of France
New Jersey Devils	New Jersey Devils
Philadelphia Flyers	Philadelphia Flyers
Yun Chi-ho	Yun Chi-ho
Sancte Elene Īeg, Upstigeīeg and Tristan da Cunha	Saint Helena, Ascension and Tristan da Cunha
Tirowen	County Tyrone
Jack Ruby	Jack Ruby
Ardmachusscīr	County Armagh
Scene	River Shannon
Wīnland	Vinland
Venom (trūðhlōð)	Venom (band)
Luel	Carlisle, Cumbria
Ēadgar Engla Cyning	Edgar the Peaceful
Kea	Kea
Itumbiara	Itumbiara
A Night at the Opera	A Night at the Opera (Queen album)
Queen (album)	Queen (Queen album)
Þunres Hamor	Mjölnir
Oben am jungen Rhein	Oben am jungen Rhein
Guinness	Guinness
Scræfclūdas (Sūþgeorgia)	Shag Rocks, South Georgia
Łobez	Łobez
Liðere	Sling (weapon)
Thomas Cranmer	Thomas Cranmer
Tawpomere	Lake Taupo
Universidad de Concepción	University of Concepción
Hameldūn (Nīwe Sǣland)	Hamilton, New Zealand
Stǣr þǣre Worulde	History of the world
Rēad wulf	Red wolf
Normandisca Forcyme	Norman conquest of England
Vitacura	Vitacura
Yungay	Yungay, Chile
Fif Scīr	Fife
Stǣrwrītere	Historian
Carolina Hurricanes	Carolina Hurricanes
Nebrond	Nimrod
Tampa Bay Lightning	Tampa Bay Lightning
Scrobbesburh	Shrewsbury
Fæger hǣr	Blond
Napier (Nīwe Sǣland)	Napier, New Zealand
Myrra	Myrrh
Harold III Norrena Cyning	Harald Hardrada
Fisc and styccu	Fish and chips
Brooke Fraser	Brooke Fraser
Middeltūn þǣra de Cahaignes	Milton Keynes
Florida Panthers	Florida Panthers
Washington Capitals	Washington Capitals
Īrisc fōtþōðer	Gaelic football
Nīwes Sǣlandes Þēodlic Stēormǣlhēap	New Zealand National Party
West Loðene	West Lothian
Lonceaster	Lancaster, Lancashire
Sūþalpis	Southern Alps
Midloðene	Midlothian
Neamere	Lough Neagh
Wyrt	Herb
Maðante	Mantes-la-Jolie
Ēast Loðene	East Lothian
Fermat tæl	Fermat number
Clackmannanscīr	Clackmannanshire
Liccidfeld	Lichfield
Sūþorcanege	South Orkney Islands
Rænkīnes hātȝemet	Rankine scale
Se Fēolagascipe þæs Hringes	The Fellowship of the Ring
Cod	Gadidae
Gold (bleoh)	Gold (color)
Holstānburg	Sisimiut
Micel Ficgīeg	Viti Levu
Wrenna	Wren
Ciricewæl	Kirkwall
1984 (bōc)	Nineteen Eighty-Four
Folcaþing	The Folketing
Underset gamen	Expansion pack
Elig	Ely, Cambridgeshire
Getalu burga in Þēodsclande	List of cities and towns in Germany
Innuendo	Innuendo (album)
Concepcion Hēafodcirice	Cathedral of the Most Holy Conception, Chile
The Game	The Game (Queen album)
Bancorena burg	Bangor
Gēol	Yule
Washington Redskins	Washington Redskins
Swīma	Vertigo
Ægelesburg	Aylesbury
Tristania	Tristania (band)
Wuldor	Ullr
Lāmwic	Lerwick
Westgeatland	Västergötland
Rosenrot	Rosenrot
Wīcinga Ieldu	Viking Age
Victory (scip)	HMS Victory
Sihhem	Nablus
Beatrix Potter	Beatrix Potter
Ēadgar Æðeling	Edgar the Ætheling
Grēat Rōmisc Fȳr	Great Fire of Rome
Mann	Person
Tollund wer	Tollund Man
Hēapplega	Team sport
Levanger	Levanger
Violetta Villas	Violetta Villas
Ynce	Inch
Gearwung (plega)	Physical exercise
Diablo (gamen)	Diablo (video game)
Anggun	Anggun
Verizon Center	Verizon Center
Wīfa rihta forðung	Women's rights
Apaxco	Apaxco
Cham	Ham (son of Noah)
Zune	Zune
Nettþōðer	Netball
Lox	Lynx (disambiguation)
In	IN
Diablo	Diablo
Wiltūn	Wilton
Roanoke	Roanoke
Cnut	Knut (disambiguation)
Acan tūn	Acton
Eormengyld Ciles	University of Chile
Sēremōnaþ 2007	June 2007
Offa Miercna Cyning	Offa of Mercia
Mǣdmōnaþ 2006	July 2006
Mǣdmōnaþ 2007.	July 2007
Wēodmōnaþ 2007	August 2007
Engel	Angel
Sasha Cohen	Sasha Cohen
Rachael Taylor	Rachael Taylor
Æðelflǣd	Æthelflæd
Pat Benatar	Pat Benatar
Michelle Kwan	Michelle Kwan
Wæstm	Crop
Beate Eriksen	Beate Eriksen
Berhte Cent Cwēn	Bertha of Kent
D.C. United	D.C. United
Eowland	Öland
Starcraft II	StarCraft II: Wings of Liberty
Gregorius Pāpa	Pope Gregory
Allan Kardec	Allan Kardec
Deadache	Deadache
Diablo III	Diablo III
Sceadu (gyden)	Skaði
Diablo II	Diablo II
Atlanta Thrashers	Atlanta Thrashers
Hwītlēachring	Onion ring
The God Delusion	The God Delusion
Canadisc fōtþōðer	Canadian football
Hæstingas (missenlīc gewritu)	Hastings (disambiguation)
Ealra Hālgena Ǣfen	Halloween
Ēostre	Ēostre
Sūþtun	Sutton
Weorcdæg	Working time
Seofonbyrigseaxisc sprǣc	Transylvanian Saxon dialect
Leðerhosu	Lederhosen
Acantūn on Sūþfolce	Acton, Suffolk
Bān	Bone
7 World Trade Center	7 World Trade Center
Vampire Knight	Vampire Knight
Wēodmōnaþ 2006	August 2006
Ælfrīc Abbod of Egoneshame	Ælfric of Eynsham
Ælle Sūþseaxna cyning	Ælle of Sussex
Æðelbald West-Seaxna Cyning	Æthelbald of Wessex
Æðelrǣd	Æthelred of Mercia
Æðelstān	Æthelstan (disambiguation)
Æðelstān Sūþseaxa Cyning	Æthelstan of Sussex
Ælfweard West-Seaxes	Ælfweard of Wessex
Bēagel	Bagel
Rēcels	Incense
Ūtwyrp	Radio broadcasting
Iapanisc āttorcopplic crabba	Japanese spider crab
Stromnæss, Sūþgeorgia	Stromness, South Georgia
Woruldlic Gemōt þāra Ciricena	World Council of Churches
Blæcesburg, Virginia	Blacksburg, Virginia
Harriet Miers	Harriet Miers
Dūnhēafod	Launceston, Cornwall
Ériu	Ériu
Marjorie Estiano	Marjorie Estiano
Ítróttarfelag Fuglafjarðar	ÍF Fuglafjørður
Fotþōðer	Football (disambiguation)
Transformers	Transformers (disambiguation)
Oresundes brycg	Øresund Bridge
Ieshaiah	Isaiah (disambiguation)
Denegield	Danegeld
Vadillo	Vadillo
Dohtor	Daughter
Spell Twēgra Burga	A Tale of Two Cities
Morbid Angel	Morbid Angel
John Ashcroft	John Ashcroft
Alexander Ovechkin	Alexander Ovechkin
Orosius	Orosius
Alexis Tsipras	Alexis Tsipras
Dufenal I Scotta	Domnall mac Ailpín
Constontinus I Scotta Cyning	Causantín mac Cináeda
Joseph Serchuk	Joseph Serchuk
Seolfor (bleoh)	Silver (color)
Babez for breakfast	Babez for Breakfast
Philip Jaisohn	Seo Jae-pil
Widukind	Widukind
Wælheall Herig	Walhalla memorial
Æbbandūn	Abingdon-on-Thames
Law & Order	Law & Order
Westmannland	Västmanland
Moretoin	Mortain
Leaves' Eyes	Leaves' Eyes
Jeanette Biedermann	Jeanette Biedermann
Corn Flakes	Corn flakes
Amol	Amol
Penda Miercna Cyning	Penda of Mercia
Dūnstān	Dunstan
Mælcolm II Scotta Cyning	Malcolm II of Scotland
Ēadgar Scotta Cyning	Edgar, King of Scotland
Ofergewiht	Overweight
Constontinus II Scotta Cyning	Constantine II of Scotland
Pak Hon-yong	Pak Hon-yong
Americanisc frēona rīcisc fōtballtēam	United States women's national soccer team
Obituary	Obituary (band)
Mǣdmōnaþ 2005	July 2005
Winterfylleþ 2005	October 2005
Berserca	Berserker
Jordan Galland	Jordan Galland
Acrassicauda	Acrassicauda
Bēam	Beam
Minoru Yamasaki	Minoru Yamasaki
Offa	Offa (disambiguation)
Tom	River Tame, West Midlands
Īslendisc stæfrǣw	Icelandic alphabet
Canceler	Chancellor
Dēaðes toln	List of wars and anthropogenic disasters by death toll
Almaluez	Almaluez
Pulgara Cyning	List of Bulgarian monarchs
Cuneglæsse	Cynoglossum officinale
Ēadmund se Martyr	Edmund the Martyr
Australisca Witenagemōt	Parliament of Australia
Lao	Lao people
Wīfel	Weevil
Agalloch	Agalloch
Godspell Mattheus	Gospel of Matthew
Ēadweard Cyning Næss	King Edward Point
Ēadmund	Edmund
Wīn	Win
Palestinisce Landscipas	Palestinian territories
Ajattara	Ajattara
James Ēa	James River
Ȝ	Yogh
Gærsīeg, Sūþgeorgia	Grass Island, South Georgia
Nazarēth	Nazareth
Ænglisc grammaticcræft	Old English grammar
Rise of Nations	Rise of Nations
Kate Sheppard	Kate Sheppard
Geþingedōm	Subdivisions of Scotland
Getalu Smallville-belimpdǣla	List of Smallville episodes
Kwara Rīce	Kwara State
Windlesōra	Windsor, Berkshire
Ēastermōnaþ 2005	April 2005
Heo Jong-suk	Heo Jong-suk
Caroline Zhang	Caroline Zhang
America's Cup	America's Cup
Wīnlendisc cystel	American chestnut
Rædwald Ēastengla Cyning	Rædwald of East Anglia
Ēadbald	Eadbald of Kent
Oswiu Norþhymbra Cyning	Oswiu of Northumbria
Brian Jacques	Brian Jacques
Agmodesham	Amersham
Paramore	Paramore
Recedham	Rochdale
Illative cāsus	Illative case
Herelic munucregol	Military order (monastic society)
Ǣȝhnōg	Eggnog
Coritiba Foot Ball Club	Coritiba Foot Ball Club
Tansonnhates Geondrīciscum Lyfthæfene	Tan Son Nhat International Airport
Þresc stīele	Thrash metal
The Chronicles of Narnia	The Chronicles of Narnia
Aliud	Aliud
Iacub Colas	Yakub Kolas
Baraona	Baraona
James Hetfield	James Hetfield
Keane	Keane (band)
Medinaceli	Medinaceli
Láchar	Láchar
Burgo de Osma-Ciudad de Osma	Burgo de Osma-Ciudad de Osma
Suellacabras	Suellacabras
Yanguas	Yanguas
Get Heavy	Get Heavy
Pensacola	Pensacola, Florida
The Arockalypse	The Arockalypse
Anath	Anat
San Esteban de Gormaz	San Esteban de Gormaz
The Monsterican Dream	The Monsterican Dream
Barbourscīr, Westvirginia	Barbour County, West Virginia
Duval Scīr, Florida	Duval County, Florida
Hāmtūnscīr Scīr, West Virginia	Hampshire County, West Virginia
Rēadgrot mid flīetan	Rødgrød
Niðerseaxiscu hūs	Low German house
Samsung Galaxy Note	Samsung Galaxy Note (original)
Perfume	Perfume (Japanese band)
Park Jung-yang	Park Jung-yang
Beadu Cealdre Hȳðe	Battle of Cold Harbor
Rōwrenoc (Virginia)	Roanoke, Virginia
Sūþtūn Hōh	Sutton Hoo
Tuidi	River Tweed
Sǣbeorg	Seamount
Dornwaraceaster	Dorchester, Dorset
Chris Pratt	Chris Pratt
Walhshalh	Walsall
Bēdesford, Virginia	Bedford, Virginia
Ēadƿeard Æðeling Scīr, Virginia	Prince Edward County, Virginia
Angul	Angeln
Fiðele	Fiddle
Cañamaque	Cañamaque
Cambihtuc	Cockatiel
Navaleno	Navaleno
Masters of the Universe	Masters of the Universe
Hwælsang	Whale vocalization
Boston Breakers	Boston Breakers (WPSL Elite)
Lanercscīr	Lanarkshire
Apulder	Appledore
Wyr, Orcanege	Wyre, Orkney
Dasaratha Maurya	Dasaratha Maurya
Þrīnessunnandæg	Trinity Sunday
Brecenscīr	Brecknockshire
Hramesige on Huntadūnscīre	Ramsey, Cambridgeshire
Anna Ēastengla Cyning	Anna of East Anglia
Simeon Varlamov	Semyon Varlamov
Cannae	Cannae
Debauchery	Debauchery (band)
Wettersteinplatz	Wettersteinplatz
Punt	Punt (boat)
Olympia-Einkaufszentrum	Olympia-Einkaufszentrum
Þunresbeorg mōr	Thorsberg moor
Niht (gyden)	Nótt
Trévago	Trévago
Tamer	River Tamar
Scīrburna	Sherborne
Īsenhamstede	Chenies
JavaScript weorcsearu	JavaScript engine
Dévanos	Dévanos
Mexicanisc frēona rīcisc fōtballtēam	Mexico women's national football team
Læland	Lolland
Bukan	Bukan
God Hates Us All	God Hates Us All
Gemǣne Rīca of Australie	Governor-General of Australia
FC Gold Pride	FC Gold Pride
Geþacasteort	Thatcher Peninsula
Ælmer	Eilmer of Malmesbury
Grahamland	Graham Land
Wikipǣdia:Sceortpæþ	Wikipedia:Shortcut
Ólvega	Ólvega
Die Deutschen Inschriften	Die Deutschen Inschriften
Mirai Nagasu	Mirai Nagasu
Eormengyld Juraj Dobrila on Pula	Juraj Dobrila University of Pula
Dunnan tūn	Dunnington
Scieppend	Creator deity
Dopenid	Coot
Norþwīces Angelseaxa mann	Norwich Anglo-Saxon
Swearttægelhara	Black-tailed jackrabbit
Sybelhūs on Lundne	Banqueting House, Whitehall
Beadu þæs Bogn	Battle of the Boyne
Puebla FC	Puebla F.C.
MorphOS	MorphOS
Minga Guazú	Minga Guazú
Atari Jaguar	Atari Jaguar
Smallville (Gēar 4)	Smallville (season 4)
Hēffe Wehbig	Haifa Wehbe
Augusta, West Virginia	Augusta, West Virginia
Magaña	Magaña
Ulfretūn	Newbury, Berkshire
Tæppa	Tap (valve)
Smallville (Gēar 3)	Smallville (season 3)
Tīdunghēap	Usenet newsgroup
Nile (trūðhlōð)	Nile (band)
Ilfing	Elbląg (river)
Scēaþ	Scabbard
Stǣr Angelþēode ciricean	Ecclesiastical History of the English People
Rēan	Rán
Vindicationīeg	Vindication Island
Tæfingstoc	Tavistock, Devon
Negombo	Negombo
Selesdūn	Selsdon
Centenera de Andaluz	Centenera de Andaluz
Þrimilcemōnaþ 2005	May 2005
Blecinga īeg	Blekinge
Lox (catte)	Lynx
Gewuldorbeagungīeg (on Sūþorcanege)	Coronation Island
Lǣden-ofgangena stæfrǣwa	Latin alphabets
Æfterra Gēola 2005.	January 2005
Huntandūn	Huntingdon
Wyrd	Wyrd
Scotburg ēa	Kongeå
Hoym	Hoym
Hude (Oldenburg)	Hude
Tomtun	Tamworth, Staffordshire
City of Heroes	City of Heroes
World of Warcraft: Wrath of the Lich King	World of Warcraft: Wrath of the Lich King
Ambihtlicu Cīnisc sprǣc	Standard Chinese
Leþ Hæfen	Leith Harbour
Mans	Maine (province)
Hwicce	Hwicce
Falster	Falster
Janus (Windows beta)	Windows 3.x
Ealdfriþ	Aldfrith of Northumbria
Difelinburg	Dublin Castle
SOX leoht-fæt	Sodium-vapor lamp
Association of Volleyball Professionals	Association of Volleyball Professionals
Madrynhȳð	Puerto Madryn
Solmōnaþ 2005	February 2005
Hāligmōnaþ 2005	September 2005
Atlanta Beat	Atlanta Beat (WPS)
Wuduhen	Weka
Gawain and se Grēna Cniht	Sir Gawain and the Green Knight
Maroare	Moravians
Centro Federal de Educação Tecnológica Celso Suckow da Fonseca	Centro Federal de Educação Tecnológica Celso Suckow da Fonseca
Chrono Trigger	Chrono Trigger
Antônio Fagundes	Antônio Fagundes
Cippanhamm	Chippenham
Télépopmusik	Télépopmusik
Selfrīcsiendlica landbūnessa	Autonomous region
Getæl dēora swēga	List of animal sounds
Berewicscīr	Berwickshire
Axanmynster	Axminster
Ægelesþrep	Aylesford
Lex Acilia Calpurnia	Lex Acilia Calpurnia
Bloomesdæg	Bloomsday
Banffscīr	Banffshire
Barca	Barca (ancient city)
Beordan īeg	Bardney
Bardanstapol	Barnstaple
Bellingshausenīeg	Bellingshausen Island
Rīdungfȳrramm	Human torpedo
Wedrebi	Wetherby
Adreminte	Tanacetum parthenium
Stæfford	Stafford
Almarza	Almarza
Aldealices	Aldealices
Aldealafuente	Aldealafuente
Alentisque	Alentisque
Adradas	Adradas
Alconaba	Alconaba
Abejar	Abejar
Almajano	Almajano
Arenillas	Arenillas
Aldealpozo	Aldealpozo
Alcubilla de las Peñas	Alcubilla de las Peñas
Aldealseñor	Aldealseñor
Alcubilla de Avellaneda	Alcubilla de Avellaneda
Covaleda	Covaleda
Casarejos	Casarejos
Cerbón	Cerbón
Calatañazor	Calatañazor
Almazul	Almazul
Cidones	Cidones
Besliwdifca	Bezliudivka
Alpanseque	Alpanseque
Arcos de Jalón	Arcos de Jalón
Aldehuela de Periáñez	Aldehuela de Periáñez
Beratón	Beratón
Almenar de Soria	Almenar de Soria
Maján	Maján
Coscurita	Coscurita
Barcones	Barcones
Castilfrío de la Sierra	Castilfrío de la Sierra
Castilruiz	Castilruiz
Miño de Medinaceli	Miño de Medinaceli
Vinuesa	Vinuesa
Cigudosa	Cigudosa
Candilichera	Candilichera
Ausejo de la Sierra	Ausejo de la Sierra
Carabantes	Carabantes
Soliedra	Soliedra
Taroda	Taroda
Nepas	Nepas
Valtajeros	Valtajeros
Arévalo de la Sierra	Arévalo de la Sierra
Pozalmuro	Pozalmuro
Cabrejas del Pinar	Cabrejas del Pinar
Villasayas	Villasayas
Cubilla	Cubilla, Soria
Castillejo de Robledo	Castillejo de Robledo
Escobosa de Almazán	Escobosa de Almazán
Estepa de San Juan	Estepa de San Juan
Carrascosa de la Sierra	Carrascosa de la Sierra
Las Aldehuelas	Las Aldehuelas
Bayubas de Arriba	Bayubas de Arriba
Borobia	Borobia
Bliecos	Bliecos
Buberos	Buberos
Muriel Viejo	Muriel Viejo
Oncala	Oncala
Fuentecambrón	Fuentecambrón
Cabrejas del Campo	Cabrejas del Campo
Frechilla de Almazán	Frechilla de Almazán
Ergo Proxy	Ergo Proxy
Valdelagua del Cerro	Valdelagua del Cerro
Ciria	Ciria
Buitrago	Buitrago
Talveila	Talveila
Salduero	Salduero
Fuentes de Magaña	Fuentes de Magaña
Viana de Duero	Viana de Duero
Tardelcuende	Tardelcuende
Duruelo de la Sierra	Duruelo de la Sierra
Bayubas de Abajo	Bayubas de Abajo
Fuentearmegil	Fuentearmegil
Fuentelmonge	Fuentelmonge
Rollamienta	Rollamienta
Villar del Ala	Villar del Ala
Velilla de los Ajos	Velilla de los Ajos
Momblona	Momblona
Fresno de Caracena	Fresno de Caracena
Valdegeña	Valdegeña
Velamazán	Velamazán
Torlengua	Torlengua
Fuentecantos	Fuentecantos
Carrascosa de Abajo	Carrascosa de Abajo
Pinilla del Campo	Pinilla del Campo
Serón de Nágima	Serón de Nágima
Blacos	Blacos
Valdeavellano de Tera	Valdeavellano de Tera
Narros	Narros
Valdeprado	Valdeprado
Borjabad	Borjabad
Fuentelsaz de Soria	Fuentelsaz de Soria
San Leonardo de Yagüe	San Leonardo de Yagüe
Muriel de la Fuente	Muriel de la Fuente
Villar del Río	Villar del Río
Valderrodilla	Valderrodilla
Espejón	Espejón
Liceras	Liceras
Matalebreras	Matalebreras
Quintana Redonda	Quintana Redonda
Nafría de Ucero	Nafría de Ucero
Sotillo del Rincón	Sotillo del Rincón
Torrubia de Soria	Torrubia de Soria
Noviercas	Noviercas
Tajueco	Tajueco
Valdenebro	Valdenebro
Villaciervos	Villaciervos
Villanueva de Gormaz	Villanueva de Gormaz
Yelo	Yelo
Montenegro de Cameros	Montenegro de Cameros
Ucero	Ucero
Langa de Duero	Langa de Duero
Quiñonería	Quiñonería
Villar del Campo	Villar del Campo
Portillo de Soria	Portillo de Soria
Gormaz	Gormaz
Santa Cruz de Yanguas	Santa Cruz de Yanguas
Villaseca de Arciel	Villaseca de Arciel
Reznos	Reznos
Cueva de Ágreda	Cueva de Ágreda
Nolay	Nolay, Soria
Cirujales del Río	Cirujales del Río
Grēatu Scōl of Sealterlande	Schulzentrum Saterland
Caracena	Caracena
Cubo de la Solana	Cubo de la Solana
Miño de San Esteban	Miño de San Esteban
Fuentestrún	Fuentestrún
Espeja de San Marcelino	Espeja de San Marcelino
Matamala de Almazán	Matamala de Almazán
La Póveda de Soria	La Póveda de Soria
Los Rábanos	Los Rábanos
Quintanas de Gormaz	Quintanas de Gormaz
Santa María de Huerta	Santa María de Huerta
San Pedro Manrique	San Pedro Manrique
Velilla de la Sierra	Velilla de la Sierra
Valdemaluque	Valdemaluque
San Felices	San Felices
Renieblas	Renieblas
Morón de Almazán	Morón de Almazán
Los Villares de Soria	Los Villares de Soria
Torreblacos	Torreblacos
Vizmanos	Vizmanos
Tejado	Tejado
Retortillo de Soria	Retortillo de Soria
Herrera de Soria	Herrera de Soria
Deza	Deza, Soria
Monteagudo de las Vicarías	Monteagudo de las Vicarías
La Riba de Escalote	La Riba de Escalote
Montejo de Tiermes	Montejo de Tiermes
La Losilla	La Losilla
Recuerda	Recuerda
Tajahuerce	Tajahuerce
Santa María de las Hoyas	Santa María de las Hoyas
Fuentepinilla	Fuentepinilla
Golmayo	Golmayo
Rioseco de Soria	Rioseco de Soria
Gómara	Gómara, Soria
Stromnæs	Stromness
Hwǣlbordfarung	Skateboarding
Rōmānisc Cāsere	Roman emperor
Weogornaceasterscīrsēaw	Worcestershire sauce
Picilemwes eorþbeofung 2010 gēares	2010 Pichilemu earthquake
Getalu ambihtlicra sprǣca	List of official languages
Maybach Exelero	Maybach Exelero
Īslendisc frēona rīcisc fōtþōðerhēap	Iceland women's national football team
Worulde Fanan	Flags of the World
Hafoc	Hawk
York University	York University
Hrēþmōnaþ 2005	March 2005
Cirenceaster	Cirencester
Strēoneshalh	Whitby
Skræling	Skræling
Grēnelandes Norren sprǣc	Greenlandic Norse
BloodRayne 2	BloodRayne 2
Gēolmōnaþ 2004	December 2004
Brytenwealda	Bretwalda
Glamorgan	Glamorgan
Winterfylleþ 2004	October 2004
Sǣearmlandes Rīcisc Edisc	Fiordland National Park
Gafolbyrðen in Þēodisclande	Taxation in Germany
Port Authority of New York and New Jersey	Port Authority of New York and New Jersey
Getalu īega be landware	List of islands by population
Denisc and Norþwegisc stæfrǣw	Danish and Norwegian alphabet
Cwatbrycg	Bridgnorth
Street Fighter IV	Street Fighter IV
Help:Innoþ	Help:Contents
Wikipǣdia:Tutorial	Wikipedia:Tutorial
Wīntrēow	Vine
Brycgstōwīeg	Bristol Island
Groove is in the Heart	Groove Is in the Heart
Witch Hunter Robin	Witch Hunter Robin
Twilight of the Thunder God	Twilight of the Thunder God
Pontifícia Universidade Católica de Minas Gerais	Pontifícia Universidade Católica de Minas Gerais
Smallville (Gēar 5)	Smallville (season 5)
Deorwente	River Derwent, Derbyshire
Universidad de los Andes (Cile)	University of the Andes, Chile
Oenoīeg	Oeno Island
3 World Trade Center	Three World Trade Center
Landa getalu be lēodweardcynne	List of countries by system of government
Granta	River Cam
Los Angeles Sol	Los Angeles Sol
Rūnstæfisc gerīmbōc	Runic calendar
Waneting	Wantage
Młoszowa	Młoszowa
Hāligmōnaþ 2006	September 2006
Hrodulf se rēadnosoda hrāndēor	Rudolph the Red-Nosed Reindeer
Bæme	Bohemian
Murilo Rosa	Murilo Rosa
2009–10 NHL tīma	2009–10 NHL season
John Clare	John Clare
Molinos de Duero	Molinos de Duero
Vozmediano	Vozmediano
Hinojosa del Campo	Hinojosa del Campo
Elpendīeg	Elephant Island
Getæl īega	List of islands
Faroisce cwidas	Kvæði
Dærentamūða	Dartmouth, Devon
Elenesburh	Helensburgh
Exanmūþa	Exmouth
Sūþern Strēamflēot	Kangerlussuaq
Tottaness	Totnes
Mældūn	Maldon, Essex
Burgstall Gegenpoint	Burgstall Gegenpoint
Burns Niht	Burns supper
Vrahovice	Vrahovice
Gafolford	Camelford
Walhshalh Weald	Walsall Wood
Hlydanford	Lydford
Gēatland	Gotland
Būc	Stomach
Candelmæssanīeg	Candlemas Island
Loppestre	Lobster
Blōtmōnaþ 2004	November 2004
Sculdorscēotend	Long gun
Rello	Rello
Nīwes Sǣlandes Weorces Stēormǣlhēap	New Zealand Labour Party
Rebollar	Rebollar, Soria
Unicron	Unicron
Garray	Garray
Stǣr Floridan	History of Florida
Stēamwægn	Steam car
Simeon II Pulgara Cyning	Simeon Saxe-Coburg-Gotha
Lopphāma	Weta
Heortæppelbroþ	Tomato soup
Chicago Red Stars	Chicago Red Stars
Cutey Honey	Cutie Honey
Besancurt	Bézancourt
Clarenceīeg, Sūþhjaltland	Clarence Island (South Shetland Islands)
Umm Culþþūm	Umm Kulthum
Tenercebrai	Tinchebray
Germanisc Hǣðenscipe	Germanic paganism
2 World Trade Center	Two World Trade Center
Cōcīeg (þāra Sūþsandwic Īeglanda)	Cook Island, South Sandwich Islands
Cooperīeg	Cooper Island
Universidade Tecnológica Federal do Paraná	Federal Technological University of Paraná
Stæffordscīr hord	Staffordshire Hoard
Gemyndigung Twintorra	National September 11 Memorial & Museum
Swamphæn	Swamphen
Froggmann	Frogman
Roanoke Express	Roanoke Express
Beadu Omdurmanes	Battle of Omdurman
Cridiantūn	Crediton
Crumbaþynscīr	Cromartyshire
Ƿ	Wynn
Ninus	Ninus
Lundene Foreweard (1839.)	Treaty of London (1839)
Hellraiser	Hellraiser
Rǣdels þæs Sandes	The Riddle of the Sands
Harrogætes hord	Vale of York Hoard
Æsir–Vanir þurhgefeht	Æsir–Vanir War
Elisabeþ Cwēn Land	Queen Elizabeth Land
Teach Children to Worship Satan	Teach Children to Worship Satan
Wikipǣdia:Ambihtsecghof	Wikipedia:Embassy
Sēo Rād tō Wiganshwearfe	The Road to Wigan Pier
National Hockey League	National Hockey League
Striuelinscīr	Stirlingshire
Frōm	Frome
Axanmūða	Axmouth
Dorceceaster	Dorchester on Thames
Monmuþscīr	Monmouthshire (historic)
Seleciricescīr	Selkirkshire
Perþscīr	Perthshire
2010 WPS tīma	2010 Women's Professional Soccer season
Grēat Langtūn	Great Langton
Flyhthæfen	Airport
Drēag	Draugr
Universidad de Santiago de Chile	University of Santiago, Chile
Mare	Mare (folklore)
Dormceaster	Durobrivae (Water Newton)
Sandeg, Orcanege	Sanday, Orkney
Sundrodland	City of Sunderland
Beadu Fossalta	Battle of Fossalta
Egilseg	Egilsay
Leskovīeg	Leskov Island
Love Machine (sang)	Love Machine (Morning Musume song)
Major Antônio Couto Pereira Stadium	Estádio Couto Pereira
Ēaster-ǣfen	Easter Saturday
Nīwes Sǣlandes Grēne Stēormǣlhēap	Green Party of Aotearoa New Zealand
Stǣrlice gemynddagas	List of historical anniversaries
Pecland	Peak District
Uzumaki	Uzumaki
4 World Trade Center	Four World Trade Center
KMFDM	KMFDM
Women's Professional Soccer	Women's Professional Soccer
Sǣweardþrēat	Coast guard
Agnes Monica	Agnez Mo
Montaguīeg	Montagu Island
Windlesōra and Mægdenhȳþ	Royal Borough of Windsor and Maidenhead
Wīdsīð	Widsith
Evile	Evile
Pasquier Quesnel	Pasquier Quesnel
Eoh	Eihwaz
Feoh (rūnstæf)	Fehu
Flocc:Ƿeras	Category:Men
Flocc:Þēodscland	Category:Germany
Flocc:Italia	Category:Italy
Flocc:Geānedu Rīcu American	Category:United States
Flocc:Russland	Category:Russia
Flocc:Canada	Category:Canada
Flocc:Geānede Cynerīce	Category:United Kingdom
Flocc:Spēonland	Category:Spain
Flocc:Cīna	Category:China
Flocc:Iapan	Category:Japan
Flocc:Australia	Category:Australia
Flocc:Mexico	Category:Mexico
Flocc:Indea	Category:India
Flocc:Saudisc Arabea	Category:Saudi Arabia
Flocc:Israhēl	Category:Israel
Flocc:Turcland	Category:Turkey
Flocc:Sūðaffrica	Category:South Africa
Flocc:Ǣgypt	Category:Egypt
Flocc:Persealand	Category:Iran
Flocc:Nīwe Sǣland	Category:New Zealand
Flocc:Argentina	Category:Argentina
Axa on Defenum	River Axe (Lyme Bay)
Traversayīega	Traversay Islands
Wergyld	Weregild
Siebenbürgen	Siebenbürgen (band)
Sky Blue FC	Sky Blue FC
Flocc:Afghanistan	Category:Afghanistan
Flocc:Algeria	Category:Algeria
Flocc:Ēastrīce	Category:Austria
Flocc:Bangladesc	Category:Bangladesh
Flocc:Cūba	Category:Cuba
Flocc:Sigelhearwenaland	Category:Ethiopia
Flocc:Indonesia	Category:Indonesia
Flocc:Irac	Category:Iraq
Flocc:Niðerland	Category:Netherlands
Flocc:Nigeria	Category:Nigeria
Flocc:Pacistan	Category:Pakistan
Flocc:Pōlaland	Category:Poland
Flocc:Portugal	Category:Portugal
Flocc:Sudan	Category:Sudan
Flocc:Tansania	Category:Tanzania
Flocc:Ucrægna	Category:Ukraine
Flocc:Fietnam	Category:Vietnam
Flocc:Rōmānisc Cāsere	Category:Roman Empire
Flocc:Sycedēor	Category:Mammals
Flocc:Fugolas	Category:Birds
Flocc:Plantan	Category:Plants
Flocc:Stǣr	Category:History
Flocc:Ferscipe	Category:Society
Flocc:Gelēafan	Category:Religion
Flocc:Plegan	Category:Sports
Flocc:Sprǣc	Category:Language
Flocc:Eorþ	Category:Earth
Victor Iusccenco	Viktor Yushchenko
Slowly We Rot	Slowly We Rot
Surtur Rising	Surtur Rising
Thila-īeg	Thule Island
Gealdor	Galdr
Ēatūn Socn	Eaton Socon
Lēo Hlāford Wǣponcyning	Lord Lyon King of Arms
Godmundesceaster	Godmanchester
Saint Louis Athletica	Saint Louis Athletica
Palmerland	Palmer Land
Pagetbeorg	Mount Paget
Handfisc	Handfish
Phil Keaggy	Phil Keaggy
Hedingelei	Headingley
Hocig	Hockey
Frēodōm	Freedom
MTB	Motor Torpedo Boat
Īsensmiþ	Blacksmith
Visokoi-īeg	Visokoi Island
Willisīega	Willis Islands
Wiogoraceastre	Worcester
Abbodesse	Abbess
Ganet	Gannet
Geondrīciscra laga fōtþōðer	International rules football
Mōr	Mire
Ranko Matasović	Ranko Matasović
Pickersgillīega	Pickersgill Islands
Três Pontas	Três Pontas
Swǣfisc cnotta	Suebian knot
Truso	Truso
Saundersīeg	Saunders Island, South Sandwich Islands
Ānlāfes Æþelinges Hæfen	Prince Olav Harbour
Sydneycofa	Sydney Cove
The Miracles	The Miracles
Siissisoq	Siissisoq
Universidad del Desarrollo	Universidad del Desarrollo
Tasca1:	Tironian notes
Kupriyanovīega	Kupriyanov Islands
Rankine	Rankine
Eormengyld Finis Terrae	Finis Terrae University
Grantaceaster	Chesterton, Cambridge
Loch a' Choire	Tarn (lake)
Smith & Wesson 500	Smith & Wesson Model 500
Hwæl	Whale
Tempest 2000	Tempest 2000
Apulder on Cente	Appledore, Kent
Ælmhām	North Elmham
Richard Pearse	Richard Pearse
Philadelphia Independence	Philadelphia Independence
Flocc:Scīrung	Category:Disambiguation pages
Flocc:Olympisc Gamen	Category:Olympic Games
Flocc:Crīstendōm	Category:Christianity
Flocc:Alladōm	Category:Islam
Godmundingahām	Goodmanham
Ieldra Fuþark	Elder Futhark
Offa, Nigeria	Offa, Nigeria
Beorgford	Burford
Wolmer green	Woolmer Green
Mǣþhild	Matilda (name)
Decatur	Decatur
Wilcumanīega	Welcome Islands
Ammomanes	Ammomanes
Ātmǣl	Oatmeal
Earn	Eagle
Skaugum	Skaugum
Bresl/ᚱᚢᚾ	Kringle
Acan tūn, Ceasterscīr	Acton, Cheshire
Washington Freedom	Washington Freedom
Loch a' Chàirn Bhàin	Loch a' Chàirn Bhàin
Scyrte	Skirt
Abercurnig	Abercorn
Wyomingdenu wæl	Battle of Wyoming
Dave Dobbyn	Dave Dobbyn
Daðan	Dathan
Irac Cyning	List of kings of Iraq
Oferferung on Francenarīce	Transport in France
Occidental (California)	Occidental, California
Benesingtūn	Benson, Oxfordshire
Smallville	Smallville (comics)
Elpend	Elephantidae
Elworuldontygenes	Alter-globalization
Bochotnica	Bochotnica
Exanmynster	Exminster
Anna Hutchison	Anna Hutchison
Universidade do Estado de Minas Gerais	Universidade do Estado de Minas Gerais
Grantasæte	Grantchester
Adesa	Adze
Abiron	Abiram
Mageo	Mayo, County Mayo
Beormas	Permians
Wōden	Wōden
Cūlingon	Cooling, Kent
Brecenanmere	Llangorse Lake
Mancus	Mancus
Āhyrstod cȳse	Cheese sandwich
Harads	Harads
Nægling	Nægling
Ægleswurþ	Ailsworth
Sceota	Brown trout
Aniam	Ani'am
Þēodacynewīse Dæg	Commonwealth Day
Camila Morgado	Camila Morgado
Flocc:Styccelicu gewritu	Category:Stubs
Flocc:Wikipedia categorization	Category:Wikipedia categorization
Flocc:Sidaþing	Category:Culture
Flocc:Gēar	Category:Years
Flocc:Worulddǣl	Category:Continents
Flocc:Lyftcræftas	Category:Aircraft
Ciricehūs	Church House, Westminster
Getalu þāra Atari Jaguares gamena	List of Atari Jaguar games
Gealdorstæf	Icelandic magical staves
Wiht (wist)	Vættir
Nexus: The Jupiter Incident	Nexus: The Jupiter Incident
Gnæt	Gnat
Nīwe Eoforwīcingas	Demographics of New York
The Tonight Show with Jay Leno	The Tonight Show with Jay Leno
Sprǣca merung	Miriwoong language
Hæstingas (Englisc þēod)	Haestingas
Wikipǣdia:Gecorene gemynddagas	Wikipedia:Selected anniversaries
Wikipǣdia:Tutorial (Editing)	Wikipedia:Tutorial/Editing
Bysen:Stēorungsunnanendebyrdnes	Template:Solar System table
Smiþþfeld, Lunden	Smithfield, London
Wikipǣdia:Nīwe ēacan	Wikipedia:Did you know
Edward Hungerford (Hungerford Market)	Edward Hungerford (spendthrift)
Wikipǣdia:Wikibōceras	Wikipedia:Wikipedians
Scearseax	Safety razor
Wikipǣdia:Snell bīcniend	Portal:Contents/A–Z index
Wikipǣdia:Recentchanges	Help:Recent changes
Morgenmearh	Breakfast sausage
Basu	Purple
Yfelland Ƿeard	Badlands Guardian
Sciþþisc īsmægden	Pazyryk burials
Good Monsters	Good Monsters
Perfekte Welle	Perfekte Welle
Henri Castelli	Henri Castelli
AmigaOS 4	AmigaOS 4
Ode to a Nightingale	Ode to a Nightingale
Bysen:Succession box	Template:Succession box
Dēorhām	Dyrham
Yrse	Yrsa
Þrīe Cirican, West Virginia	Three Churches, West Virginia
Skyhammer	Skyhammer
Æðelinga īg	Athelney
Estadio La Barranquita	Estadio La Barranquita
Flocc:Flēogeball	Category:Volleyball
Bēow (god)	Beowa
Flocc:Wikipedia bots	Category:All Wikipedia bots
Port:Gefērscipe	Portal:Society
Ened	Duck
Ostmanntūn	Oxmantown
Æppalæcianisc Englisc	Appalachian English
Hwīt Draca	White dragon
Bysen:Cquote	Template:Quote
Flocc:Þēodisc	Category:German people
Caco Ciocler	Caco Ciocler
Eormengyld ''Guglielmo Marconi''	Marconi University
Flocc:Land	Category:Countries
Catherine	Catherine (disambiguation)
Wikipǣdia:Bewitendas	Wikipedia:Administrators
Flocc:Lēode	Category:People
Wikipǣdia:Bēna tō and fram bewitendhāde	Wikipedia:Requests for adminship
Flocc:Tīd	Category:Time
Flocc:Bodiȝlār	Category:Anatomy
Wikipǣdia:Betwuxsprǽclice bendas	Help:Interlanguage links
Flocc:Leornung	Category:Education
Cyningesbeorg	Königsberg
Ægypt	Egypt
Yulia Lipnitskaya	Yulia Lipnitskaya
Flocc:Ūtwitan	Category:Philosophers
Bysen:Bot	Template:Bot
Wikipǣdia:Hwæt Wikipǣdia Nis	Wikipedia:What Wikipedia is not
Canada	Canada
Flocc:Ungerland	Category:Hungary
Flocc:Belgice	Category:Belgium
Flocc:Cipros	Category:Cyprus
Flocc:Cecland	Category:Czech Republic
Flocc:Denemearc	Category:Denmark
Flocc:Estland	Category:Estonia
Flocc:Finnland	Category:Finland
Flocc:Crecaland	Category:Greece
Flocc:Lettland	Category:Latvia
Flocc:Īsland	Category:Iceland
Flocc:Letseburg	Category:Luxembourg
Flocc:Liþuania	Category:Lithuania
Flocc:Melita	Category:Malta
Flocc:Swēoland	Category:Sweden
Flocc:Slofacia	Category:Slovakia
Flocc:Īrland Cynewīse	Category:Republic of Ireland
Flocc:Fulgōd ȝeƿritu	Category:Featured articles
Amy Robach	Amy Robach
Port:Innung/Portas	Portal:Contents/Outlines
Flocc:Spærcletelle gamen	Category:Video games
Heofon	Heaven
Fresland	Frisia
Flocc:Microsoft	Category:Microsoft
Wikipǣdia:Edit summary	Help:Edit summary
Bysen:Flagicon	Template:Flagicon
Flocc:Land on Europan	Category:Countries in Europe
Flocc:Europe	Category:Europe
Flocc:Wikipedia:Help	Category:Wikipedia help
Lefenax	Lennox (district)
Help:Mōtungtramet	Help:Using talk pages
Wikipǣdia:Efenealde belimpas	Portal:Current events
Bysen:Documentation	Template:Documentation
Wikipǣdia:Protected pages	Wikipedia:Protection policy
AC Transit Bus feoht	AC Transit Bus fight
Flocc:Wikibōceras	Category:Wikipedians
Wikipǣdia:Gemǣnscipes Ingang	Wikipedia:Community portal
Flocc:Brūcendsprǣc	Category:Wikipedians by language
Wikipǣdia:Fīf styde	Wikipedia:Five pillars
Wikipǣdia:Ānsund styccegewrit	Wikipedia:Stub
Wikipǣdia:Bealu	Wikipedia:Vandalism
Āctūn, Stæffordscīr	Acton, Staffordshire
Sung Jae-ki	Sung Jae-gi
Aisgernis	Askernish
Bosworth and Toller	An Anglo-Saxon Dictionary
Sundorrīcesdæg	List of national independence days
Instituto Federal da Bahia	Bahia Federal Institute of Education, Science and Technology
Bysen:Softredirect	Template:Soft redirect
Bysen:Delete	Template:Db
Barnes Mill, West Virginia	Barnes Mill, West Virginia
Snægel	Gastropoda
Bryttisce Wealdendas	List of British monarchs
Flocc:Searucræft	Category:Technology
Beormingas	Beormingas
Biscop of Calpis in Europan	Bishop in Europe
Bloomery, Hāmtūnscīr Scīr, Westvirginia	Bloomery, Hampshire County, West Virginia
Blues Beach, West Virginia	Blues Beach, West Virginia
Flocc:Sprǣca	Category:Languages
Flocc:Gerīmbōc	Category:Calendars
Flocc:Hāliȝdagas	Category:Holidays
Help:Onbregdan nīwne tramet	Wikipedia:Starting an article
Flocc:Wikipǣdia	Category:Wikipedia
Bubbling Spring, West Virginia	Bubbling Spring, West Virginia
Flocc:Unȝebēacniende trametas	Category:Noindexed pages
Flocc:Pages with broken file links	Category:Pages with missing files
Wikipǣdia:Manual of Style	Wikipedia:Manual of Style
C-Dogs	C-Dogs
Bysen:-	Template:-
Bysen:Navbox	Template:Navbox
Leorninghūs of Hēafodstōle	Capital High School (Charleston, West Virginia)
Capon Lake, Westvirginia	Capon Lake, West Virginia
Handspearctellend	Mobile device
Cūþburga	Cuthburh
Flocc:Byrig on Persum	Category:Cities in Iran
Wulfrūn	Wulfrun
Ēadweard Cyning Cofa	King Edward Cove
Roy Moore	Roy Moore
Maryland SoccerPlex	Maryland SoccerPlex
Ichikawadaimon, Yamanashi	Ichikawadaimon, Yamanashi
Margaret Waters	Margaret Waters
Éire	Éire
Bysen:Sēðung þurfed	Template:Citation needed
Ēadgar	Eadgar
Angelfresisca sprǣca	Anglo-Frisian languages
Flocc:Fana bysen	Category:Flag templates
Bysen:((	Template:((
Bysen:!-	Template:!-
Bysen:!!	Template:!!
Bysen:=	Template:=
Bysen:Navbar	Template:Navbar
Bysen:Unicode	Template:Unicode
Bysen:E	Template:E
Bysen:Clear	Template:Clear
Bysen:Col-break	Template:Col-break
Bysen:Col-begin	Template:Col-begin
Bysen:Col-end	Template:Col-end
Bysen:Color	Template:Color
Bysen:Anchor	Template:Anchor
Wikipǣdia:List of articles all languages should have	Wikipedia:Vital articles
Flocc:Affrica	Category:Africa
Flocc:Mǣdmōnaþ	Category:July
Flocc:Þorpas	Category:Villages
Flocc:Bēc	Category:Books
Flocc:Mōnþas	Category:Months
Bysen:Wikisource	Template:Wikisource
Bysen:Babel	Template:Babel
Bysen:Commons	Template:Commons
Bysen:Reflist	Template:Reflist
Bysen:NavPeriodicTable	Template:Periodic table (32 columns, micro)
Wikipǣdia:Fulgōdra gewrita hwætgōdnesse	Wikipedia:Featured article criteria
Bysen:Stycce	Template:Stub
Bysen:Brūcend de	Template:User de
Bysen:Brūcend de-1	Template:User de-1
Bysen:Brūcend el	Template:User el
Bysen:Brūcend es	Template:User es
Bysen:Brūcend de-3	Template:User de-3
Bysen:Brūcend en-3	Template:User en-3
Bysen:Brūcend el-1	Template:User el-1
Bysen:Brūcend en-1	Template:User en-1
Bysen:Brūcend en-2	Template:User en-2
Bysen:Brūcend eo-2	Template:User eo-2
Bysen:Brūcend en-4	Template:User en-4
Bysen:Brūcend fi	Template:User fi
Bysen:Brūcend en-0	Template:User en-0
Bysen:Brūcend es-4	Template:User es-4
Bysen:Brūcend en	Template:User en
Bysen:Brūcend de-2	Template:User de-2
Bysen:Brūcend es-1	Template:User es-1
Bysen:Brūcend fi-1	Template:User fi-1
Bysen:Brūcend fr-1	Template:User fr-1
Flocc:Līf	Category:Life
Bysen:Brūcend he-2	Template:User he-2
Bysen:Brūcend it-3	Template:User it-3
Bysen:User sk	Template:User sk
Bysen:Brūcend fr-2	Template:User fr-2
Bysen:Brūcend ja	Template:User ja
Bysen:Brūcend ja-1	Template:User ja-1
Bysen:Brūcend it-1	Template:User it-1
Bysen:Brūcend fr	Template:User fr
Cosco	Cusco
Wikipedia:Find oþþe gebét stycce	Wikipedia:WikiProject Stub sorting/Stub types/Commerce
Flocc:Solmōnaþ	Category:February
Flocc:1949	Category:1949
Bysen:Stedefindend scite/Writ	Template:Location map/Info
Flocc:Ceorfdēor	Category:Insects
Bysen:Fs mid	Template:Football squad mid
Flocc:Asia	Category:Asia
Flocc:Cile	Category:Chile
Flocc:21e gēarhundred	Category:21st century
Flocc:Lesotho	Category:Lesotho
Flocc:Brūcend uk	Category:User uk
Flocc:Sūðamerica	Category:South America
Flocc:Brūcend uk-M	Category:User uk-N
Flocc:1918	Category:1918
Flocc:1954	Category:1954
Flocc:Ǣt	Category:Foods
Flocc:1946	Category:1946
Bysen:Fs player	Template:Football squad player
Flocc:Gyldfōtþōðer	Category:Association football
Flocc:1945	Category:1945
Bysen:Mod	Template:Mod
Flocc:1926	Category:1926
Bysen:NowCommons	Template:Now Commons
Bysen:Brūcend sv	Template:User sv
Flocc:1920	Category:1920
Bysen:Brūcend it	Template:User it
Bysen:Brūcend uk	Template:User uk
Bysen:Brūcend es-2	Template:User es-2
Bysen:Infobox Football club	Template:Infobox football club
Bysen:Welcome	Template:Welcome
Flocc:Bysen mid ūtweardum hlence	Category:External link templates
Bysen:Mōnþas	Template:Month header
Bysen:Country data Slovakia	Template:Country data Slovakia
Bysen:Country flagnavy	Template:Navy/core
Bysen:Country data Czech Republic	Template:Country data Czech Republic
Bysen:Country data Honduras	Template:Country data Honduras
Bysen:Country data Bolivia	Template:Country data Bolivia
Bysen:Country data Denemearc	Template:Country data Denmark
Bysen:Country data Īsland	Template:Country data Iceland
Bysen:Country data Poland	Template:Country data Poland
Bysen:Scire in Irlande	Template:Counties of Ireland
Bysen:Click	Template:Click
Bysen:Wikivar	Template:Wikivar
Flocc:Brūcend fr-1	Category:User fr-1
Bysen:Country data Norway	Template:Country data Norway
Bysen:Wikiquote	Template:Wikiquote
Bysen:Country showdata	Template:Country showdata
Bysen:Country data Mexico	Template:Country data Mexico
Bysen:Affrica	Template:Countries of Africa
Bysen:Infobox television	Template:Infobox television
Flocc:Americisc Awendung Wig	Category:American Revolution
Bysen:FWB	Template:Frankfurt Stock Exchange
Bysen:IUCN2008	Template:IUCN2008
Bysen:Geānedu Rīcu American	Template:United States political divisions
Bysen:Country data Australia	Template:Country data Australia
Bysen:Cyþþubox ieg	Template:Infobox islands
Bysen:Country data France	Template:Country data France
Flocc:Circolwyrde gamen	Category:Electronic games
Bysen:Ambox	Template:Ambox
Flocc:Americanisc stǣr	Category:History of the United States
Bysen:Fossil range/bar	Template:Fossil range/bar
Bysen:Rnd	Template:Rnd
Bysen:Infobox Country	Template:Infobox country
Bysen:Max	Template:Max
Bysen:Country data Austria	Template:Country data Austria
Bysen:Infobox Mīlitisc Gemōt	Template:Infobox military conflict
Bysen:Documentation/docname	Template:Documentation/docname
Bysen:Country data Finland	Template:Country data Finland
Wikipǣdia:Tutorial (Wikipedia links)	Wikipedia:Tutorial/Wikipedia links
Bysen:Country data Japan	Template:Country data Japan
Bysen:Start box	Template:S-start
Bysen:Infobox U.S. Scīr	Template:Infobox U.S. county
Bysen:Cleanup	Template:Cleanup
Flocc:Crabbas	Category:Crabs
Bysen:Cite journal	Template:Cite journal
Bysen:Xpd	Template:Xpd
Bysen:Lang-ar	Template:Lang-ar
Bysen:Brūcend es-0	Template:User es-0
Bysen:Cite news	Template:Cite news
Bysen:Featured article	Template:Featured article
Bysen:Country data Russia	Template:Country data Russia
Flocc:Paris	Category:Paris
Flocc:Brūcend en-4	Category:User en-4
Flocc:Brūcend en	Category:User en
Flocc:Croatia	Category:Croatia
Flocc:Brūcend en-2	Category:User en-2
Bysen:Infobox	Template:Infobox
Bysen:Main other	Template:Main other
Flocc:Francena cyningas	Category:Kings of France
Flocc:Stafas	Category:Alphabets
Bysen:Documentation/start box	Template:Documentation/start box
Bysen:Documentation/end box2	Template:Documentation/end box2
Wikipǣdia:Gecorene gemynddagas/23 Hāligmōnaþ	Wikipedia:Selected anniversaries/September 23
Bysen:Documentation/start box2	Template:Documentation/start box2
Bysen:Template other	Template:Template other
Wikipǣdia:Gecorene gemynddagas/4 Solmōnaþ	Wikipedia:Selected anniversaries/February 4
Wikipǣdia:Gecorene gemynddagas/22 Hāligmōnaþ	Wikipedia:Selected anniversaries/September 22
Bysen:Lang-da	Template:Lang-da
Wikipǣdia:Gecorene gemynddagas/30 Blōtmōnaþ	Wikipedia:Selected anniversaries/November 30
Wikipǣdia:Gecorene gemynddagas/18 Solmōnaþ	Wikipedia:Selected anniversaries/February 18
Wikipǣdia:Gecorene gemynddagas/28 Æfterra Gēola	Wikipedia:Selected anniversaries/January 28
Bysen:Legend	Template:Legend
Wikipǣdia:Gecorene gemynddagas/14 Æfterra Gēola	Wikipedia:Selected anniversaries/January 14
Bysen:Lang-got	Template:Lang-got
Wikipǣdia:Gecorene gemynddagas/25 Solmōnaþ	Wikipedia:Selected anniversaries/February 25
Wikipǣdia:Gecorene gemynddagas/10 Wēodmōnaþ	Wikipedia:Selected anniversaries/August 10
Flocc:Bryttisce wrīteras	Category:British writers
Wikipǣdia:Gecorene gemynddagas/15 Winterfylleþ	Wikipedia:Selected anniversaries/October 15
Wikipǣdia:Gecorene gemynddagas/31 Wēodmōnaþ	Wikipedia:Selected anniversaries/August 31
Wikipǣdia:Gecorene gemynddagas/12 Blōtmōnaþ	Wikipedia:Selected anniversaries/November 12
Wikipǣdia:Gecorene gemynddagas/30 Mǣdmōnaþ	Wikipedia:Selected anniversaries/July 30
Wikipǣdia:Gecorene gemynddagas/3 Wēodmōnaþ	Wikipedia:Selected anniversaries/August 3
Wikipǣdia:Gecorene gemynddagas/27 Wēodmōnaþ	Wikipedia:Selected anniversaries/August 27
Hacked up for Barbecue	Hacked up for Barbecue
Bysen:Cite web	Template:Cite web
Wikipǣdia:Gecorene gemynddagas/21 Æfterra Gēola	Wikipedia:Selected anniversaries/January 21
Wikipǣdia:Gecorene gemynddagas/8 Solmōnaþ	Wikipedia:Selected anniversaries/February 8
Bysen:Country data Italy	Template:Country data Italy
Wikipǣdia:Gecorene gemynddagas/20 Æfterra Gēola	Wikipedia:Selected anniversaries/January 20
Wikipǣdia:Gecorene gemynddagas/23 Æfterra Gēola	Wikipedia:Selected anniversaries/January 23
Wikipǣdia:Gecorene gemynddagas/28 Hāligmōnaþ	Wikipedia:Selected anniversaries/September 28
Bysen:Imdb title	Template:IMDb title
Wikipǣdia:Gecorene gemynddagas/31 Gēolmōnaþ	Wikipedia:Selected anniversaries/December 31
Wikipǣdia:Gecorene gemynddagas/1 Solmōnaþ	Wikipedia:Selected anniversaries/February 1
Wikipǣdia:Gecorene gemynddagas/14 Gēolmōnaþ	Wikipedia:Selected anniversaries/December 14
Wikipǣdia:Gecorene gemynddagas/25 Æfterra Gēola	Wikipedia:Selected anniversaries/January 25
Wikipǣdia:Gecorene gemynddagas/6 Wēodmōnaþ	Wikipedia:Selected anniversaries/August 6
Wikipǣdia:Gecorene gemynddagas/24 Wēodmōnaþ	Wikipedia:Selected anniversaries/August 24
Wikipǣdia:Gecorene gemynddagas/9 Blōtmōnaþ	Wikipedia:Selected anniversaries/November 9
Wikipǣdia:Gecorene gemynddagas/18 Æfterra Gēola	Wikipedia:Selected anniversaries/January 18
Wikipǣdia:Gecorene gemynddagas/17 Wēodmōnaþ	Wikipedia:Selected anniversaries/August 17
Wikipǣdia:Gecorene gemynddagas/27 Mǣdmōnaþ	Wikipedia:Selected anniversaries/July 27
Flocc:Stǣr þæs Geānedan Cynerīces	Category:History of the British Isles
Bysen:Country data	Template:Country data
Wikipǣdia:Gecorene gemynddagas/20 Wēodmōnaþ	Wikipedia:Selected anniversaries/August 20
Wikipǣdia:Gecorene gemynddagas/1 Winterfylleþ	Wikipedia:Selected anniversaries/October 1
Wikipǣdia:Gecorene gemynddagas/5 Winterfylleþ	Wikipedia:Selected anniversaries/October 5
Wikipǣdia:Gecorene gemynddagas/8 Winterfylleþ	Wikipedia:Selected anniversaries/October 8
Wikipǣdia:Talk page	Wikipedia:Talk page guidelines
Wikipǣdia:Gecorene gemynddagas/15 Solmōnaþ	Wikipedia:Selected anniversaries/February 15
Bysen:Coor URL	Template:Coor URL
Bysen:Notice	Template:Notice
Bysen:Pp-template	Template:Pp-template
Bysen:·	Template:·
Bysen:Brūcend nl-1	Template:User nl-1
Bysen:Min	Template:Min
Bysen:Wiktionarypar2	Template:Wiktionary
Bysen:Brūcend nl-2	Template:User nl-2
Bysen:Infobox Ice Hockey Player	Template:Infobox ice hockey player
Bysen:Lang-enm	Template:Lang-enm
Bysen:Country data Sweden	Template:Country data Sweden
Flocc:Byrig on Dēnum	Category:Cities and towns in Denmark
Bysen:Lang-ang	Template:Lang-ang
Flocc:Eorþtilþ	Category:Agriculture
Wikipǣdia:Gecorene gemynddagas/26 Blōtmōnaþ	Wikipedia:Selected anniversaries/November 26
Wikipǣdia:Gecorene gemynddagas/26 Wēodmōnaþ	Wikipedia:Selected anniversaries/August 26
Wikipǣdia:Gecorene gemynddagas/12 Gēolmōnaþ	Wikipedia:Selected anniversaries/December 12
Wikipǣdia:Gecorene gemynddagas/25 Gēolmōnaþ	Wikipedia:Selected anniversaries/December 25
Wikipǣdia:Gecorene gemynddagas/10 Æfterra Gēola	Wikipedia:Selected anniversaries/January 10
Wikipǣdia:Gecorene gemynddagas/31 Æfterra Gēola	Wikipedia:Selected anniversaries/January 31
Wikipǣdia:Gecorene gemynddagas/6 Winterfylleþ	Wikipedia:Selected anniversaries/October 6
Wikipǣdia:Gecorene gemynddagas/6 Hrēþmōnaþ	Wikipedia:Selected anniversaries/March 6
Wikipǣdia:Gecorene gemynddagas/18 Hrēþmōnaþ	Wikipedia:Selected anniversaries/March 18
Wikipǣdia:Gecorene gemynddagas/17 Winterfylleþ	Wikipedia:Selected anniversaries/October 17
Wikipǣdia:Gecorene gemynddagas/27 Hrēþmōnaþ	Wikipedia:Selected anniversaries/March 27
Wikipǣdia:Gecorene gemynddagas/19 Hrēþmōnaþ	Wikipedia:Selected anniversaries/March 19
Wikipǣdia:Gecorene gemynddagas/2 Winterfylleþ	Wikipedia:Selected anniversaries/October 2
Wikipǣdia:Gecorene gemynddagas/2 Mǣdmōnaþ	Wikipedia:Selected anniversaries/July 2
Wikipǣdia:Gecorene gemynddagas/10 Hrēþmōnaþ	Wikipedia:Selected anniversaries/March 10
Wikipǣdia:Gecorene gemynddagas/1 Ēastermōnaþ	Wikipedia:Selected anniversaries/April 1
Wikipǣdia:Gecorene gemynddagas/31 Mǣdmōnaþ	Wikipedia:Selected anniversaries/July 31
Wikipǣdia:Gecorene gemynddagas/12 Wēodmōnaþ	Wikipedia:Selected anniversaries/August 12
Wikipǣdia:Gecorene gemynddagas/26 Solmōnaþ	Wikipedia:Selected anniversaries/February 26
Wikipǣdia:Gecorene gemynddagas/17 Mǣdmōnaþ	Wikipedia:Selected anniversaries/July 17
Wikipǣdia:Gecorene gemynddagas/5 Wēodmōnaþ	Wikipedia:Selected anniversaries/August 5
Wikipǣdia:Gecorene gemynddagas/16 Hāligmōnaþ	Wikipedia:Selected anniversaries/September 16
Wikipǣdia:Gecorene gemynddagas/31 Winterfylleþ	Wikipedia:Selected anniversaries/October 31
Wikipǣdia:Gecorene gemynddagas/12 Solmōnaþ	Wikipedia:Selected anniversaries/February 12
Wikipǣdia:Gecorene gemynddagas/15 Æfterra Gēola	Wikipedia:Selected anniversaries/January 15
Wikipǣdia:Gecorene gemynddagas/19 Hāligmōnaþ	Wikipedia:Selected anniversaries/September 19
Wikipǣdia:Gecorene gemynddagas/16 Æfterra Gēola	Wikipedia:Selected anniversaries/January 16
Wikipǣdia:Gecorene gemynddagas/13 Mǣdmōnaþ	Wikipedia:Selected anniversaries/July 13
Wikipǣdia:Gecorene gemynddagas/2 Æfterra Gēola	Wikipedia:Selected anniversaries/January 2
Wikipǣdia:Gecorene gemynddagas/9 Mǣdmōnaþ	Wikipedia:Selected anniversaries/July 9
Wikipǣdia:Gecorene gemynddagas/10 Solmōnaþ	Wikipedia:Selected anniversaries/February 10
Wikipǣdia:Gecorene gemynddagas/5 Hrēþmōnaþ	Wikipedia:Selected anniversaries/March 5
Wikipǣdia:Gecorene gemynddagas/29 Sēremōnaþ	Wikipedia:Selected anniversaries/June 29
Wikipǣdia:Gecorene gemynddagas/14 Blōtmōnaþ	Wikipedia:Selected anniversaries/November 14
Wikipǣdia:Gecorene gemynddagas/6 Æfterra Gēola	Wikipedia:Selected anniversaries/January 6
Wikipǣdia:Gecorene gemynddagas/18 Mǣdmōnaþ	Wikipedia:Selected anniversaries/July 18
Wikipǣdia:Gecorene gemynddagas/23 Mǣdmōnaþ	Wikipedia:Selected anniversaries/July 23
Wikipǣdia:Gecorene gemynddagas/1 Mǣdmōnaþ	Wikipedia:Selected anniversaries/July 1
Wikipǣdia:Gecorene gemynddagas/20 Gēolmōnaþ	Wikipedia:Selected anniversaries/December 20
Wikipǣdia:Gecorene gemynddagas/30 Wēodmōnaþ	Wikipedia:Selected anniversaries/August 30
Wikipǣdia:Gecorene gemynddagas/11 Wēodmōnaþ	Wikipedia:Selected anniversaries/August 11
Wikipǣdia:Gecorene gemynddagas/9 Wēodmōnaþ	Wikipedia:Selected anniversaries/August 9
Wikipǣdia:Gecorene gemynddagas/29 Blōtmōnaþ	Wikipedia:Selected anniversaries/November 29
Wikipǣdia:Gecorene gemynddagas/2 Ēastermōnaþ	Wikipedia:Selected anniversaries/April 2
Wikipǣdia:Gecorene gemynddagas/12 Mǣdmōnaþ	Wikipedia:Selected anniversaries/July 12
Wikipǣdia:Gecorene gemynddagas/29 Wēodmōnaþ	Wikipedia:Selected anniversaries/August 29
Wikipǣdia:Gecorene gemynddagas/24 Sēremōnaþ	Wikipedia:Selected anniversaries/June 24
Wikipǣdia:Gecorene gemynddagas/25 Blōtmōnaþ	Wikipedia:Selected anniversaries/November 25
Wikipǣdia:Gecorene gemynddagas/21 Wēodmōnaþ	Wikipedia:Selected anniversaries/August 21
Wikipǣdia:Gecorene gemynddagas/29 Mǣdmōnaþ	Wikipedia:Selected anniversaries/July 29
Wikipǣdia:Gecorene gemynddagas/29 Æfterra Gēola	Wikipedia:Selected anniversaries/January 29
Wikipǣdia:Gecorene gemynddagas/5 Gēolmōnaþ	Wikipedia:Selected anniversaries/December 5
Wikipǣdia:Gecorene gemynddagas/25 Hrēþmōnaþ	Wikipedia:Selected anniversaries/March 25
Wikipǣdia:Gecorene gemynddagas/22 Hrēþmōnaþ	Wikipedia:Selected anniversaries/March 22
Wikipǣdia:Gecorene gemynddagas/9 Hrēþmōnaþ	Wikipedia:Selected anniversaries/March 9
Wikipǣdia:Gecorene gemynddagas/12 Hrēþmōnaþ	Wikipedia:Selected anniversaries/March 12
Wikipǣdia:Gecorene gemynddagas/11 Hrēþmōnaþ	Wikipedia:Selected anniversaries/March 11
Wikipǣdia:Gecorene gemynddagas/19 Gēolmōnaþ	Wikipedia:Selected anniversaries/December 19
Wikipǣdia:Gecorene gemynddagas/24 Solmōnaþ	Wikipedia:Selected anniversaries/February 24
Wikipǣdia:Gecorene gemynddagas/13 Solmōnaþ	Wikipedia:Selected anniversaries/February 13
Wikipǣdia:Gecorene gemynddagas/20 Solmōnaþ	Wikipedia:Selected anniversaries/February 20
Wikipǣdia:Gecorene gemynddagas/5 Æfterra Gēola	Wikipedia:Selected anniversaries/January 5
Wikipǣdia:Gecorene gemynddagas/15 Hrēþmōnaþ	Wikipedia:Selected anniversaries/March 15
Wikipǣdia:Gecorene gemynddagas/23 Solmōnaþ	Wikipedia:Selected anniversaries/February 23
Wikipǣdia:Gecorene gemynddagas/13 Hrēþmōnaþ	Wikipedia:Selected anniversaries/March 13
Wikipǣdia:Gecorene gemynddagas/15 Hāligmōnaþ	Wikipedia:Selected anniversaries/September 15
Wikipǣdia:Gecorene gemynddagas/15 Gēolmōnaþ	Wikipedia:Selected anniversaries/December 15
Wikipǣdia:Gecorene gemynddagas/4 Hāligmōnaþ	Wikipedia:Selected anniversaries/September 4
Wikipǣdia:Gecorene gemynddagas/8 Hāligmōnaþ	Wikipedia:Selected anniversaries/September 8
Wikipǣdia:Gecorene gemynddagas/18 Gēolmōnaþ	Wikipedia:Selected anniversaries/December 18
Wikipǣdia:Gecorene gemynddagas/4 Hrēþmōnaþ	Wikipedia:Selected anniversaries/March 4
Wikipǣdia:Gecorene gemynddagas/4 Winterfylleþ	Wikipedia:Selected anniversaries/October 4
Wikipǣdia:Gecorene gemynddagas/21 Blōtmōnaþ	Wikipedia:Selected anniversaries/November 21
Wikipǣdia:Gecorene gemynddagas/1 Hāligmōnaþ	Wikipedia:Selected anniversaries/September 1
Wikipǣdia:Gecorene gemynddagas/3 Mǣdmōnaþ	Wikipedia:Selected anniversaries/July 3
Wikipǣdia:Gecorene gemynddagas/4 Mǣdmōnaþ	Wikipedia:Selected anniversaries/July 4
Wikipǣdia:Gecorene gemynddagas/13 Æfterra Gēola	Wikipedia:Selected anniversaries/January 13
Wikipǣdia:Gecorene gemynddagas/28 Sēremōnaþ	Wikipedia:Selected anniversaries/June 28
Wikipǣdia:Gecorene gemynddagas/7 Sēremōnaþ	Wikipedia:Selected anniversaries/June 7
Wikipǣdia:Gecorene gemynddagas/6 Hāligmōnaþ	Wikipedia:Selected anniversaries/September 6
Wikipǣdia:Gecorene gemynddagas/25 Hāligmōnaþ	Wikipedia:Selected anniversaries/September 25
Wikipǣdia:Gecorene gemynddagas/27 Æfterra Gēola	Wikipedia:Selected anniversaries/January 27
Wikipǣdia:Gecorene gemynddagas/6 Mǣdmōnaþ	Wikipedia:Selected anniversaries/July 6
Wikipǣdia:Gecorene gemynddagas/15 Mǣdmōnaþ	Wikipedia:Selected anniversaries/July 15
Wikipǣdia:Gecorene gemynddagas/10 Hāligmōnaþ	Wikipedia:Selected anniversaries/September 10
Wikipǣdia:Gecorene gemynddagas/26 Hāligmōnaþ	Wikipedia:Selected anniversaries/September 26
Wikipǣdia:Gecorene gemynddagas/20 Hāligmōnaþ	Wikipedia:Selected anniversaries/September 20
Wikipǣdia:Gecorene gemynddagas/16 Mǣdmōnaþ	Wikipedia:Selected anniversaries/July 16
Wikipǣdia:Gecorene gemynddagas/14 Mǣdmōnaþ	Wikipedia:Selected anniversaries/July 14
Wikipǣdia:Gecorene gemynddagas/25 Mǣdmōnaþ	Wikipedia:Selected anniversaries/July 25
Wikipǣdia:Gecorene gemynddagas/12 Æfterra Gēola	Wikipedia:Selected anniversaries/January 12
Wikipǣdia:Gecorene gemynddagas/23 Wēodmōnaþ	Wikipedia:Selected anniversaries/August 23
Wikipǣdia:Gecorene gemynddagas/22 Sēremōnaþ	Wikipedia:Selected anniversaries/June 22
Wikipǣdia:Gecorene gemynddagas/16 Wēodmōnaþ	Wikipedia:Selected anniversaries/August 16
Wikipǣdia:Gecorene gemynddagas/30 Gēolmōnaþ	Wikipedia:Selected anniversaries/December 30
Wikipǣdia:Gecorene gemynddagas/4 Blōtmōnaþ	Wikipedia:Selected anniversaries/November 4
Wikipǣdia:Gecorene gemynddagas/3 Æfterra Gēola	Wikipedia:Selected anniversaries/January 3
Wikipǣdia:Gecorene gemynddagas/30 Hāligmōnaþ	Wikipedia:Selected anniversaries/September 30
Wikipǣdia:Gecorene gemynddagas/8 Æfterra Gēola	Wikipedia:Selected anniversaries/January 8
Wikipǣdia:Gecorene gemynddagas/1 Hrēþmōnaþ	Wikipedia:Selected anniversaries/March 1
Wikipǣdia:Gecorene gemynddagas/14 Solmōnaþ	Wikipedia:Selected anniversaries/February 14
Wikipǣdia:Gecorene gemynddagas/7 Winterfylleþ	Wikipedia:Selected anniversaries/October 7
Wikipǣdia:Gecorene gemynddagas/19 Solmōnaþ	Wikipedia:Selected anniversaries/February 19
Wikipǣdia:Gecorene gemynddagas/28 Hrēþmōnaþ	Wikipedia:Selected anniversaries/March 28
Wikipǣdia:Gecorene gemynddagas/20 Hrēþmōnaþ	Wikipedia:Selected anniversaries/March 20
Wikipǣdia:Gecorene gemynddagas/6 Solmōnaþ	Wikipedia:Selected anniversaries/February 6
Wikipǣdia:Gecorene gemynddagas/7 Solmōnaþ	Wikipedia:Selected anniversaries/February 7
Wikipǣdia:Gecorene gemynddagas/21 Solmōnaþ	Wikipedia:Selected anniversaries/February 21
Wikipǣdia:Gecorene gemynddagas/1 Wēodmōnaþ	Wikipedia:Selected anniversaries/August 1
Wikipǣdia:Gecorene gemynddagas/14 Hrēþmōnaþ	Wikipedia:Selected anniversaries/March 14
Wikipǣdia:Gecorene gemynddagas/28 Solmōnaþ	Wikipedia:Selected anniversaries/February 28
Wikipǣdia:Gecorene gemynddagas/27 Hāligmōnaþ	Wikipedia:Selected anniversaries/September 27
Wikipǣdia:Gecorene gemynddagas/8 Mǣdmōnaþ	Wikipedia:Selected anniversaries/July 8
Wikipǣdia:Gecorene gemynddagas/11 Hāligmōnaþ	Wikipedia:Selected anniversaries/September 11
Wikipǣdia:Gecorene gemynddagas/22 Mǣdmōnaþ	Wikipedia:Selected anniversaries/July 22
Wikipǣdia:Gecorene gemynddagas/28 Wēodmōnaþ	Wikipedia:Selected anniversaries/August 28
Wikipǣdia:Gecorene gemynddagas/1 Blōtmōnaþ	Wikipedia:Selected anniversaries/November 1
Wikipǣdia:Gecorene gemynddagas/2 Solmōnaþ	Wikipedia:Selected anniversaries/February 2
Wikipǣdia:Gecorene gemynddagas/4 Wēodmōnaþ	Wikipedia:Selected anniversaries/August 4
Wikipǣdia:Gecorene gemynddagas/22 Gēolmōnaþ	Wikipedia:Selected anniversaries/December 22
Wikipǣdia:Gecorene gemynddagas/20 Winterfylleþ	Wikipedia:Selected anniversaries/October 20
Wikipǣdia:Gecorene gemynddagas/28 Mǣdmōnaþ	Wikipedia:Selected anniversaries/July 28
Wikipǣdia:Gecorene gemynddagas/17 Æfterra Gēola	Wikipedia:Selected anniversaries/January 17
Wikipǣdia:Gecorene gemynddagas/3 Solmōnaþ	Wikipedia:Selected anniversaries/February 3
Bysen:Lang-sr	Template:Lang-sr
Wikipǣdia:Gecorene gemynddagas/7 Mǣdmōnaþ	Wikipedia:Selected anniversaries/July 7
Wikipǣdia:Gecorene gemynddagas/24 Mǣdmōnaþ	Wikipedia:Selected anniversaries/July 24
Wikipǣdia:Gecorene gemynddagas/21 Mǣdmōnaþ	Wikipedia:Selected anniversaries/July 21
Wikipǣdia:Gecorene gemynddagas/6 Sēremōnaþ	Wikipedia:Selected anniversaries/June 6
Wikipǣdia:Gecorene gemynddagas/11 Mǣdmōnaþ	Wikipedia:Selected anniversaries/July 11
Wikipǣdia:Gecorene gemynddagas/8 Wēodmōnaþ	Wikipedia:Selected anniversaries/August 8
Wikipǣdia:Gecorene gemynddagas/15 Wēodmōnaþ	Wikipedia:Selected anniversaries/August 15
Wikipǣdia:Gecorene gemynddagas/10 Mǣdmōnaþ	Wikipedia:Selected anniversaries/July 10
Wikipǣdia:Gecorene gemynddagas/16 Hrēþmōnaþ	Wikipedia:Selected anniversaries/March 16
Wikipǣdia:Gecorene gemynddagas/14 Winterfylleþ	Wikipedia:Selected anniversaries/October 14
Wikipǣdia:Gecorene gemynddagas/17 Hrēþmōnaþ	Wikipedia:Selected anniversaries/March 17
Wikipǣdia:Gecorene gemynddagas/24 Hrēþmōnaþ	Wikipedia:Selected anniversaries/March 24
Wikipǣdia:Gecorene gemynddagas/21 Hrēþmōnaþ	Wikipedia:Selected anniversaries/March 21
Wikipǣdia:Gecorene gemynddagas/5 Solmōnaþ	Wikipedia:Selected anniversaries/February 5
Wikipǣdia:Gecorene gemynddagas/3 Winterfylleþ	Wikipedia:Selected anniversaries/October 3
Wikipǣdia:Gecorene gemynddagas/7 Hāligmōnaþ	Wikipedia:Selected anniversaries/September 7
Wikipǣdia:Gecorene gemynddagas/26 Mǣdmōnaþ	Wikipedia:Selected anniversaries/July 26
Wikipǣdia:Gecorene gemynddagas/14 Sēremōnaþ	Wikipedia:Selected anniversaries/June 14
Hashmonah	Hashmonah
Flocc:Beorgas	Category:Mountains
Bysen:Brūcend ru	Template:User ru
Flocc:20e gēarhundred	Category:20th century
Bysen:IPA	Template:IPA
Bysen:Bēc þǣre Nīwan Gecȳþnesse	Template:Books of the New Testament
Bysen:USpresidents	Template:US Presidents
Wikipǣdia:Gecorene gemynddagas/7 Hrēþmōnaþ	Wikipedia:Selected anniversaries/March 7
Wikipǣdia:Gecorene gemynddagas/29 Hrēþmōnaþ	Wikipedia:Selected anniversaries/March 29
Flocc:Bysen Brūcend Box Spræc	Category:Language user templates
Wikipǣdia:Gecorene gemynddagas/28 Ēastermōnaþ	Wikipedia:Selected anniversaries/April 28
Bysen:LangWithName	Template:Language with name
Flocc:Hwæsingatūn	Category:Washington (state)
Flocc:Wihta	Category:Legendary creatures
Wikipǣdia:Gecorene gemynddagas/30 Hrēþmōnaþ	Wikipedia:Selected anniversaries/March 30
Wikipǣdia:Gecorene gemynddagas/22 Solmōnaþ	Wikipedia:Selected anniversaries/February 22
Wikipǣdia:Gecorene gemynddagas/31 Hrēþmōnaþ	Wikipedia:Selected anniversaries/March 31
Wikipǣdia:Gecorene gemynddagas/23 Hrēþmōnaþ	Wikipedia:Selected anniversaries/March 23
Wikipǣdia:Gecorene gemynddagas/17 Solmōnaþ	Wikipedia:Selected anniversaries/February 17
Bysen:Birth date and age	Template:Birth date and age
Bysen:MONTHNAME	Template:MONTHNAME
Wikipǣdia:Gecorene gemynddagas/30 Æfterra Gēola	Wikipedia:Selected anniversaries/January 30
Wikipǣdia:Gecorene gemynddagas/9 Solmōnaþ	Wikipedia:Selected anniversaries/February 9
Wikipǣdia:Gecorene gemynddagas/8 Hrēþmōnaþ	Wikipedia:Selected anniversaries/March 8
Bysen:Sortname	Template:Sortname
Flocc:Gebēd	Category:Prayer
Wikipǣdia:Gecorene gemynddagas/29 Solmōnaþ	Wikipedia:Selected anniversaries/February 29
Wikipǣdia:Gecorene gemynddagas/2 Hrēþmōnaþ	Wikipedia:Selected anniversaries/March 2
Bysen:Country data Ireland	Template:Country data Ireland
Wikipǣdia:Gecorene gemynddagas/27 Solmōnaþ	Wikipedia:Selected anniversaries/February 27
Wikipǣdia:Gecorene gemynddagas/26 Hrēþmōnaþ	Wikipedia:Selected anniversaries/March 26
Flocc:Country data templates	Category:Country data templates
Bysen:Namespace detect	Template:Namespace detect
Wikipǣdia:Gecorene gemynddagas/Solmōnaþ	Wikipedia:Selected anniversaries/February
Bysen:Fmbox	Template:Fmbox
Bysen:Country data England	Template:Country data England
Flocc:19e gēarhundred	Category:19th century
Bysen:Country data Republic of Ireland	Template:Country data Republic of Ireland
Flocc:Wrīteras	Category:Writers
Bysen:Country data Switzerland	Template:Country data Switzerland
Bysen:Lang-cs	Template:Lang-cs
Bysen:Lang-he	Template:Lang-he
Bysen:Infobox OS	Template:Infobox OS
Bysen:Both	Template:Both
Bysen:Brūcend pt-1	Template:User pt-1
Flocc:Æfterra Gēola	Category:January
Bysen:Lang-fa	Template:Lang-fa
Bysen:End tab	Template:End tab
Bysen:Brūcend pl	Template:User pl
Bysen:Brūcend nl	Template:User nl
Bysen:Tab	Template:Tab
Bysen:Brūcend pl-0	Template:User pl-0
Wikipǣdia:Gecorene gemynddagas/12 Winterfylleþ	Wikipedia:Selected anniversaries/October 12
Bysen:Brūcend no-2	Template:User no-2
Bysen:Start tab	Template:Start tab
Wikipǣdia:Gecorene gemynddagas/11 Solmōnaþ	Wikipedia:Selected anniversaries/February 11
Holm Park	Holm Park
Bysen:Australia	Template:States and territories of Australia
Wikipǣdia:Gecorene gemynddagas/5 Blōtmōnaþ	Wikipedia:Selected anniversaries/November 5
Wikipǣdia:Gecorene gemynddagas/11 Æfterra Gēola	Wikipedia:Selected anniversaries/January 11
Wikipǣdia:Gecorene gemynddagas/3 Hāligmōnaþ	Wikipedia:Selected anniversaries/September 3
Wikipǣdia:Gecorene gemynddagas/24 Hāligmōnaþ	Wikipedia:Selected anniversaries/September 24
Bysen:Rtl-lang	Template:Rtl-lang
Bysen:Please don't change this page	Wikipedia:Introduction 2
Bysen:Tlx	Template:Tlx
Bysen:CAN	Template:CAN
Bysen:Lang-de	Template:Lang-de
Bysen:Country data Austria-Hungary	Template:Country data Austria-Hungary
Bysen:Sæternes Bōtm	Template:Moons of Saturn
Bysen:Lang-la	Template:Lang-la
Flocc:Wucu	Category:Weeks
Bysen:Lang-af	Template:Lang-af
Wikipǣdia:Gecorene gemynddagas/Gēolmōnaþ	Wikipedia:Selected anniversaries/December
Bysen:Infobox Album	Template:Infobox album
Bysen:User	Template:User
Wikipǣdia:Gecorene gemynddagas/16 Gēolmōnaþ	Wikipedia:Selected anniversaries/December 16
Wikipǣdia:Gecorene gemynddagas/9 Æfterra Gēola	Wikipedia:Selected anniversaries/January 9
Wikipǣdia:Gecorene gemynddagas/7 Æfterra Gēola	Wikipedia:Selected anniversaries/January 7
Wikipǣdia:Gecorene gemynddagas/19 Mǣdmōnaþ	Wikipedia:Selected anniversaries/July 19
Wikipǣdia:Gecorene gemynddagas/13 Wēodmōnaþ	Wikipedia:Selected anniversaries/August 13
Wikipǣdia:Gecorene gemynddagas/12 Hāligmōnaþ	Wikipedia:Selected anniversaries/September 12
Wikipǣdia:Gecorene gemynddagas/2 Hāligmōnaþ	Wikipedia:Selected anniversaries/September 2
Wikipǣdia:Gecorene gemynddagas/7 Wēodmōnaþ	Wikipedia:Selected anniversaries/August 7
Wikipǣdia:Gecorene gemynddagas/4 Ēastermōnaþ	Wikipedia:Selected anniversaries/April 4
Wikipǣdia:Gecorene gemynddagas/22 Æfterra Gēola	Wikipedia:Selected anniversaries/January 22
Wikipǣdia:Gecorene gemynddagas/4 Æfterra Gēola	Wikipedia:Selected anniversaries/January 4
Wikipǣdia:Gecorene gemynddagas/19 Wēodmōnaþ	Wikipedia:Selected anniversaries/August 19
Wikipǣdia:Gecorene gemynddagas/18 Hāligmōnaþ	Wikipedia:Selected anniversaries/September 18
Wikipǣdia:Gecorene gemynddagas/4 Gēolmōnaþ	Wikipedia:Selected anniversaries/December 4
Wikipǣdia:Gecorene gemynddagas/2 Wēodmōnaþ	Wikipedia:Selected anniversaries/August 2
Wikipǣdia:Gecorene gemynddagas/21 Gēolmōnaþ	Wikipedia:Selected anniversaries/December 21
Wikipǣdia:Gecorene gemynddagas/20 Mǣdmōnaþ	Wikipedia:Selected anniversaries/July 20
Wikipǣdia:Gecorene gemynddagas/18 Wēodmōnaþ	Wikipedia:Selected anniversaries/August 18
Wikipǣdia:Gecorene gemynddagas/24 Æfterra Gēola	Wikipedia:Selected anniversaries/January 24
Wikipǣdia:Brōðra rǣdscēawung	Wikipedia:Peer review
Bysen:Year nav	Template:Year nav
Flocc:Flyhthæfenan on Fietname	Category:Airports in Vietnam
Bysen:Brūcend pl-1	Template:User pl-1
Flocc:Gebed	Category:Christian prayer
Flocc:Cyningas of Englalande	Category:English monarchs
Flocc:Bryttisce cyningas	Category:British monarchs
Bysen:Brūcend fr-3	Template:User fr-3
Bysen:GRA mid rīce namum	Template:USA imagemap with state names
Bysen:Imdb name	Template:IMDb name
Flocc:Tunisia	Category:Tunisia
Bysen:PD	Template:PD-because
Bysen:Wikispell	Template:Wikinews
Bysen:Brūcend lt	Template:User lt
Bysen:Cc-by-sa-2.0	Template:Cc-by-sa-2.0
Bysen:Mbox	Template:Mbox
Bysen:Oppose	Template:Disagree
Bysen:Coord/link	Template:Coord/link
Bysen:Infobox UK place	Template:Infobox UK place
Bysen:Brūcend de-5	Template:User de-5
Bysen:Brūcend is-1	Template:User is-1
Bysen:Brūcend is-2	Template:User is-2
Bysen:Brūcend is	Template:User is
Bysen:Brūcend de-0	Template:User de-0
Bysen:Brūcend fr-5	Template:User fr-5
Bysen:Brūcend en-5	Template:User en-5
Bysen:Dagas þǣre wuce	Template:Days of the week
Flocc:Þēodisc burg	Category:Populated places in Germany
Bysen:Brūcend fr-0	Template:User fr-0
Flocc:Norþ Carolīna	Category:North Carolina
Flocc:Puerto Rico	Category:Puerto Rico
Bysen:ColBreak	Template:Multicol-break
Flocc:Byrig þāra Geāndena Rīca American	Category:Cities in the United States
Bysen:Country data West Germany	Template:Country data West Germany
Bysen:Lang-ru	Template:Lang-ru
James Doolittle	James Doolittle
Bysen:Country data East Germany	Template:Country data East Germany
Bysen:Infobox Aircraft Begin	Template:Infobox aircraft begin
Bysen:Brūcend it-0	Template:User it-0
Bysen:Browsebar	Template:Portals browsebar
Bysen:Timeline Temperature Conversion	Template:Timeline Temperature Conversion
Jami Sieber	Jami Sieber
Flocc:Brittisca Here	Category:British Army
Bysen:Disambig	Template:Disambiguation
Flocc:Byrig on Israhēlum	Category:Populated places in Israel
Bysen:Country data Nazi Germany	Template:Country data Nazi Germany
Bysen:Selectskin	Template:Select skin
Bysen:Doi	Template:Doi
Bysen:Country data German Empire	Template:Country data German Empire
Flocc:Coreanisc stǣr	Category:History of Korea
Bysen:Fb	Template:Fb
Bysen:Elisabeþericiu	Template:Commonwealth realms
Bysen:Lang-grc	Template:Lang-grc
Bysen:Brūcend ksh	Template:User ksh
Bysen:Infobox Film	Template:Infobox film
Bysen:Lang-en	Template:Lang-en
Bysen:Flag template documentation	Template:Flag template documentation
Bysen:Fix	Template:Fix
Flocc:Byrig on Oklahoman	Category:Populated places in Oklahoma
Bysen:Lang-id	Template:Lang-id
Bysen:Monþes lengþ	Template:MONTHDAYS
Bysen:Period end	Template:Period end
Bysen:Tn	Template:Tn
Flocc:Byrig on Belgum	Category:Populated places in Belgium
Bysen:Brūcend sv-2	Template:User sv-2
Bysen:Brūcend it-2	Template:User it-2
Bysen:Lang-fr	Template:Lang-fr
Flocc:Angelseaxisc Englaland	Category:Anglo-Saxon England
Bysen:Fossil range	Template:Geological range
Bysen:Australia Labelled Map	Template:Australia Labelled Map
Bysen:Brūcend pt-0	Template:User pt-0
Bysen:Editnotice	Template:Editnotice
Bysen:Betwuxwici	Template:InterWiki
Flocc:Byrig in þǣm Niðerlandum	Category:Cities in the Netherlands
Wikipǣdia:Gecorene gemynddagas/Hāligmōnaþ	Wikipedia:Selected anniversaries/September
Bysen:Coord	Template:Coord
Bysen:Brūcend pt-3	Template:User pt-3
Flocc:Byrig on Lincolnscīre	Category:Towns in Lincolnshire
Bysen:TemplatePAGENAME	Template:TemplatePAGENAME
Bysen:Country data Kalmar Union	Template:Country data Kalmar Union
Bysen:Brūcend pt-2	Template:User pt-2
Flocc:Wyoming	Category:Wyoming
Wikipǣdia:Gecorene gemynddagas/14 Hāligmōnaþ	Wikipedia:Selected anniversaries/September 14
Wikipǣdia:Gecorene gemynddagas/20 Sēremōnaþ	Wikipedia:Selected anniversaries/June 20
Wikipǣdia:Gecorene gemynddagas/22 Wēodmōnaþ	Wikipedia:Selected anniversaries/August 22
Wikipǣdia:Gecorene gemynddagas/9 Hāligmōnaþ	Wikipedia:Selected anniversaries/September 9
Wikipǣdia:Gecorene gemynddagas/13 Hāligmōnaþ	Wikipedia:Selected anniversaries/September 13
Wikipǣdia:Gecorene gemynddagas/1 Æfterra Gēola	Wikipedia:Selected anniversaries/January 1
Wikipǣdia:Gecorene gemynddagas/14 Wēodmōnaþ	Wikipedia:Selected anniversaries/August 14
Wikipǣdia:Gecorene gemynddagas/6 Gēolmōnaþ	Wikipedia:Selected anniversaries/December 6
Bysen:Brūcend fr-4	Template:User fr-4
Flocc:Grēneland	Category:Greenland
Wikipǣdia:Gecorene gemynddagas/Winterfylleþ	Wikipedia:Selected anniversaries/October
Bysen:Brūcend la-1	Template:User la-1
Bysen:Land on Europan	Template:Sovereign states of Europe
Bysen:Brūcend is-0	Template:User is-0
Bysen:Brūcend el-0	Template:User el-0
Flocc:User sk	Category:User sk
Flocc:Brūcend eo	Category:User eo
Flocc:Brūcend fr	Category:User fr
Flocc:Brūcend cy	Category:User cy
Flocc:Brūcend got	Category:User got
Flocc:Brūcend ang	Category:User ang
Flocc:Brūcend la	Category:User la
Flocc:Brūcend lt	Category:User lt
Flocc:Brūcend pt	Category:User pt
Flocc:Brūcend sv	Category:User sv
Flocc:Brūcend fr-3	Category:User fr-3
Flocc:Brūcend cy-3	Category:User cy-3
Flocc:Brūcend ang-3	Category:User ang-3
Flocc:Brūcend it-3	Category:User it-3
Flocc:Brūcend pl-3	Category:User pl-3
Flocc:Brūcend fi-1	Category:User fi-1
Flocc:Brūcend cy-1	Category:User cy-1
Flocc:Brūcend ang-1	Category:User ang-1
Flocc:Brūcend nl-1	Category:User nl-1
Flocc:Brūcend pl-1	Category:User pl-1
Flocc:Brūcend fr-4	Category:User fr-4
Flocc:Brūcend cy-4	Category:User cy-4
Flocc:Brūcend ang-4	Category:User ang-4
Flocc:Brūcend it-4	Category:User it-4
Flocc:Brūcend pl-4	Category:User pl-4
Flocc:Brūcend fr-2	Category:User fr-2
Flocc:Brūcend cy-2	Category:User cy-2
Flocc:Brūcend ang-2	Category:User ang-2
Flocc:Brūcend it-2	Category:User it-2
Flocc:Brūcend la-2	Category:User la-2
Flocc:Brūcend pl-2	Category:User pl-2
Flocc:Brūcend sv-2	Category:User sv-2
Flocc:Brūcend fr-M	Category:User fr-N
Flocc:Brūcend cy-M	Category:User cy-N
Flocc:Brūcend ang-N	Category:User ang-N
Flocc:Brūcend is-M	Category:User is-N
Flocc:Brūcend lt-N	Category:User lt-N
Flocc:Brūcend nl-M	Category:User nl-N
Flocc:Brūcend ru-M	Category:User ru-N
Flocc:Brūcend fr-5	Category:User fr-5
Flocc:Brūcend cy-5	Category:User cy-5
Flocc:Brūcend ang-5	Category:User ang-5
Flocc:Brūcend it-5	Category:User it-5
Flocc:Brūcend la-5	Category:User la-5
Flocc:Brūcend pl-5	Category:User pl-5
Flocc:Feormung	Category:Entertainment
Flocc:Hēafodstōlas þæs Sericus Gārsecges	Category:Capitals in Oceania
Flocc:Law & Order	Category:Law & Order (franchise)
Flocc:Turcas and Caicos Īegland	Category:Turks and Caicos Islands
Flocc:Tudoryld	Category:Tudor England
Bysen:Sūþhjaltland	Template:South Shetlands
Flocc:Byrig on Canadan	Category:Populated places in Canada
Flocc:Īega	Category:Islands
Flocc:Sericus Garsecg	Category:Pacific Ocean
Flocc:User sk-N	Category:User sk-N
Flocc:Brūcend de	Category:User de
Flocc:Brūcend de-2	Category:User de-2
Flocc:Brūcend de-3	Category:User de-3
Flocc:Brūcend de-4	Category:User de-4
Flocc:Brūcend dum	Category:User dum
Flocc:Brūcend el	Category:User el
Flocc:Brūcend el-1	Category:User el-1
Flocc:Brūcend el-2	Category:User el-2
Bysen:SelAnnivFooter ȝƿ	Template:SelAnnivFooter
Flocc:Brūcend el-3	Category:User el-3
Flocc:Brūcend el-4	Category:User el-4
Flocc:Brūcend el-5	Category:User el-5
Flocc:Brūcend el-N	Category:User el-N
Flocc:Sūþgeorgia and þā Sūþsandwic Īegland	Category:South Georgia and the South Sandwich Islands
Flocc:Brūcend en-3	Category:User en-3
Flocc:Brūcend en-5	Category:User en-5
Flocc:Brūcend en-M	Category:User en-N
Flocc:Brūcend eo-2	Category:User eo-2
Flocc:Brūcend es	Category:User es
Flocc:Brūcend es-1	Category:User es-1
Flocc:Brūcend es-2	Category:User es-2
Flocc:Puilla	Category:Apulia
Flocc:Brūcend es-3	Category:User es-3
Flocc:Brūcend es-4	Category:User es-4
Bysen:Brūcend es-5	Template:User es-5
Flocc:Brūcend es-N	Category:User es-N
Flocc:Brūcend fi	Category:User fi
Flocc:Brūcend fi-M	Category:User fi-N
Flocc:Brūcend fo	Category:User fo
Flocc:Brūcend fo-1	Category:User fo-1
Flocc:Brūcend fo-2	Category:User fo-2
Flocc:Brūcend fo-4	Category:User fo-4
Flocc:Brūcend fo-M	Category:User fo-N
Cynedōmtīd	Kingdomtide
Flocc:Brūcend is	Category:User is
Flocc:Brūcend is-1	Category:User is-1
Flocc:Brūcend is-2	Category:User is-2
Flocc:Brūcend is-3	Category:User is-3
Flocc:Brūcend is-4	Category:User is-4
Flocc:Brūcend is-5	Category:User is-5
Flocc:Byrig on Mexican	Category:Populated places in Mexico
Flocc:Mexiciscu rīce	Category:Subdivisions of Mexico
Bysen:Brūcend la-3	Template:User la-3
Flocc:Frencisc Guiana	Category:French Guiana
Ǣht	Property
Flocc:Hebrēisc sprǣc	Category:Hebrew language
Flocc:Brūcend pt-3	Category:User pt-3
Flocc:Bryttisc bōccræft	Category:British literature
Flocc:Brūcend pl-N	Category:User pl-N
Flocc:Brūcend pt-1	Category:User pt-1
Flocc:Byrig on Feneswelan	Category:Populated places in Venezuela
Bysen:Country data Germany	Template:Country data Germany
Bysen:Country data Geāned Cynerīce	Template:Country data United Kingdom
Wikipǣdia:Gecorene gemynddagas/17 Gēolmōnaþ	Wikipedia:Selected anniversaries/December 17
Wikipǣdia:Gecorene gemynddagas/Mǣdmōnaþ	Wikipedia:Selected anniversaries/July
Bysen:Lang-be	Template:Lang-be
Bysen:Cite encyclopedia	Template:Cite encyclopedia
Bysen:Country data Scotland	Template:Country data Scotland
Wikipǣdia:Tutorial (Formatting)	Wikipedia:Tutorial/Formatting
Flocc:Brūcend it	Category:User it
Flocc:Brūcend it-1	Category:User it-1
Flocc:Rīcu þāra Geāndena Rīca American	Category:States of the United States
Flocc:Brūcend ksh	Category:User ksh
Bysen:Mpl	Template:Mpl
Flocc:Brūcend la-1	Category:User la-1
Wikipǣdia:Gecorene gemynddagas/29 Hāligmōnaþ	Wikipedia:Selected anniversaries/September 29
Flocc:Brūcend la-3	Category:User la-3
Flocc:Brūcend la-4	Category:User la-4
Flocc:Brūcend la-N	Category:User la-N
Wikipǣdia:Gecorene gemynddagas/5 Hāligmōnaþ	Wikipedia:Selected anniversaries/September 5
Flocc:Byrig on Īslande	Category:Populated places in Iceland
Bysen:Cite doi	Template:Cite doi
Flocc:Pulgara cyningas	Category:Bulgarian monarchs
Flocc:Fȳrbeorgas	Category:Volcanoes
Flocc:Dēorabyscīr	Category:Derbyshire
Flocc:Byrig on Latie	Category:Cities and towns in Lazio
Bysen:Englaland Scīra	Template:England counties
Flocc:Feohtan	Category:Martial arts
Bysen:Country data Australasia	Template:Country data Australasia
Flocc:Blōtmōnaþ	Category:November
Flocc:Difelinscīr	Category:County Dublin
Wikipǣdia:Babel	Wikipedia:Babel
Bysen:Help contents back	Template:Help contents back
Flocc:Lēodweard	Category:Positions of authority
Flocc:Byrig on Australie	Category:Populated places in Australia
Flocc:Scopas	Category:Poets
Flocc:Hāligmōnaþ	Category:September
Flocc:Byrig on Norþdakotan	Category:Populated places in North Dakota
Flocc:Winterfylleþ	Category:October
Flocc:Sǣ	Category:Seas
Flocc:Gēolmōnaþ	Category:December
Flocc:Wēodmōnaþ	Category:August
Flocc:Þrimilcemōnaþ	Category:May
Flocc:Brandenburg	Category:Brandenburg
Flocc:Englaland	Category:England
Seringas	Chinese people
Wikipǣdia:Gecorene gemynddagas/22 Blōtmōnaþ	Wikipedia:Selected anniversaries/November 22
Flocc:Ēastermōnaþ	Category:April
Bysen:IPA2	Template:IPA-all
Flocc:Līfnamrǣden	Category:Taxonomy
Bysen:Lang-it	Template:Lang-it
Bysen:Coord/dms2dec	Template:Coord/dms2dec
Flocc:Brūcend es-5	Category:User es-5
Bysen:Country data Brazil	Template:Country data Brazil
Flocc:Gestorfen in 988	Category:988 deaths
Flocc:Wæter	Category:Water
Leslie E. Robertson	Leslie E. Robertson
Flocc:Hēafod and swēor	Category:Human head and neck
Flocc:Geboren in 121	Category:121 births
Wikipǣdia:MediaWiki namespace	Help:MediaWiki namespace
Bysen:Lang-mi	Template:Lang-mi
Flocc:180	Category:180
Flocc:Gestorfen in 180	Category:180 deaths
Flocc:Drincas	Category:Beverages
Flocc:Gestorfen in 2005	Category:2005 deaths
Flocc:450	Category:450
Wikipǣdia:Administrators' how-to guide	Wikipedia:Administrators' how-to guide
Bysen:Start date and age	Template:Start date and age
Wikipǣdia:Manigsprǣclicu samodwyrcung	Wikipedia:Multilingual coordination
Flocc:Geboren in 1974	Category:1974 births
Flocc:Geboren in 1899	Category:1899 births
Flocc:Oklahoma	Category:Oklahoma
Flocc:Iapanisc sangeras	Category:Japanese singers
Flocc:Forman Þegnas	Category:Prime ministers
Flocc:Geboren in 1954	Category:1954 births
Flocc:850	Category:850
Flocc:Geboren in 850	Category:850 births
Bysen:Cyþþubox Æþel	Template:Infobox royalty
Flocc:Hwītrussland	Category:Belarus
Flocc:Alberta	Category:Alberta
Flocc:Ontario	Category:Ontario
Flocc:Nīwe Scotland	Category:Nova Scotia
Flocc:899	Category:899
Flocc:Gestorfen in 899	Category:899 deaths
Flocc:Geocon Landscipe	Category:Yukon
Flocc:Massachusetts	Category:Massachusetts
Flocc:924	Category:924
Flocc:Gestorfen in 924	Category:924 deaths
Bysen:Editprotected	Template:Edit protected
Bysen:Brūcend ang-0	Template:User ang-0
Bysen:Country data Ungerland	Template:Country data Hungary
Flocc:Land on Affrice	Category:Countries in Africa
Bysen:Canadan underrīce	Template:Provinces and territories of Canada
Bysen:Template reference list	Template:Template reference list
Flocc:Geboren in 1239	Category:1239 births
Flocc:1249	Category:1249
Bysen:Brūcend la-0	Template:User la-0
Flocc:1289	Category:1289
Flocc:1305	Category:1305
Flocc:Gestorfen in 1305	Category:1305 deaths
Flocc:1307	Category:1307
Wikipǣdia:Gecorene gemynddagas/Blōtmōnaþ	Wikipedia:Selected anniversaries/November
Bysen:Brūcend pt-4	Template:User pt-4
Bysen:Country data New Zealand	Template:Country data New Zealand
Bysen:Brūcend es-3	Template:User es-3
Flocc:Ēa Franclandes	Category:Rivers of France
Flocc:Brūcend pt-2	Category:User pt-2
Flocc:Brūcend pt-4	Category:User pt-4
Flocc:Brūcend pt-5	Category:User pt-5
Flocc:Brūcend pt-N	Category:User pt-N
Flocc:Brūcend ru	Category:User ru
Flocc:Brūcend sv-M	Category:User sv-N
Flocc:1634	Category:1634
Flocc:1638	Category:1638
Bysen:En icon	Template:En icon
Flocc:1719	Category:1719
Flocc:Gestorfen in 1719	Category:1719 deaths
Dæmonium	List of Tokyopop publications
Getalu Dreamwaves Transformera	List of Transformers comics characters
Bysen:Country data Faroe Islands	Template:Country data Faroe Islands
Flocc:121	Category:121
Bysen:Lang	Template:Lang
Wikipǣdia:Gecorene gemynddagas/21 Hāligmōnaþ	Wikipedia:Selected anniversaries/September 21
Bysen:Country data Americanisc	Template:Country data United States
Bysen:Template example row	Template:Template example row
Bysen:Next period	Template:Next period
Getalu sycedēora mid ilcgecyndiscum gebǣrum	List of mammals displaying homosexual behavior
Flocc:Trēowu	Category:Trees
Bysen:Infobox ea	Template:Infobox river
Flocc:Geboren in 1634	Category:1634 births
Flocc:Geboren in 1638	Category:1638 births
Flocc:Geboren in 1852	Category:1852 births
Flocc:Geboren in 1892	Category:1892 births
Flocc:Geboren in 1918	Category:1918 births
Flocc:Geboren in 1945	Category:1945 births
Flocc:Geboren in 1949	Category:1949 births
Flocc:Geboren in 1981	Category:1981 births
Flocc:Geboren in 1993	Category:1993 births
Flocc:1715	Category:1715
Wikipǣdia:Gecorene gemynddagas/Ēastermōnaþ	Wikipedia:Selected anniversaries/April
Bysen:Period color	Template:Period color
Flocc:11e gēarhundred	Category:11th century
Flocc:988	Category:988
Flocc:10e gēarhundred	Category:10th century
Flocc:7e gēarhundred	Category:7th century
Flocc:1239	Category:1239
Flocc:Gestorfen in 1307	Category:1307 deaths
Flocc:Corsica	Category:Corsica
Manitoban Fær 31	Manitoba Highway 31
Flocc:Gestorfen in 1715	Category:1715 deaths
Flocc:Australisce hēafodstōlas	Category:Australian capital cities
Flocc:Russisce bōccræft	Category:Russian literature
Flocc:Sardinia	Category:Sardinia
Mars wiþ Mars (Veronica Mars hēafodweard)	Mars vs. Mars
Bysen:Lang-hi	Template:Lang-hi
Flocc:Florida	Category:Florida
Flocc:Normandig	Category:Normandy
Bysen:Convert/And0	Template:Convert/And0
Bysen:Coord/dec2dms/dm	Template:Coord/dec2dms/dm
Flocc:Francena caseras	Category:French emperors
Bysen:Elementbox isotopes stable	Template:Infobox element/isotopes stable
Flocc:Nevada	Category:Nevada
Flocc:Nebraska	Category:Nebraska
Flocc:Norþ Dakota	Category:North Dakota
Flocc:Nīwe Eoforwīc	Category:New York
Flocc:Rhode Īeg	Category:Rhode Island
Flocc:Louisiāna	Category:Louisiana
Flocc:Marianland	Category:Maryland
Flocc:Maine	Category:Maine
Flocc:Minnesota	Category:Minnesota
Flocc:Michigan	Category:Michigan
Flocc:Mississippi	Category:Mississippi
Flocc:Missouri	Category:Missouri
Flocc:Vermont	Category:Vermont
Flocc:Virginia	Category:Virginia
Flocc:Idaho	Category:Idaho
Flocc:Iowa	Category:Iowa
Flocc:Arkansas	Category:Arkansas
Flocc:Alaska	Category:Alaska
Flocc:Arizona	Category:Arizona
Flocc:Alabama	Category:Alabama
Flocc:Ohio	Category:Ohio
Flocc:Westvirginia	Category:West Virginia
Flocc:Wisconsin	Category:Wisconsin
Flocc:Indiāna	Category:Indiana
Flocc:Illinois	Category:Illinois
Flocc:Kansas	Category:Kansas
Flocc:California	Category:California
Flocc:Kentucky	Category:Kentucky
Flocc:Connecticut	Category:Connecticut
Flocc:Colorado	Category:Colorado
Flocc:Texas	Category:Texas
Flocc:Hawaii	Category:Hawaii
Bysen:Fs end	Template:Football squad end
Bysen:Fs start	Template:Football squad start
Melampyrum lineare	Melampyrum lineare
Bysen:WPMILHIST Infobox style	Template:WPMILHIST Infobox style
Flocc:Ōðru Woruldgūþ	Category:World War II
Flocc:Nīwes Sǣlandes byrig	Category:Populated places in New Zealand
Bysen:Fossil range/marker	Template:Fossil range/marker
Flocc:Hundas	Category:Dogs
Flocc:OS X gamen	Category:OS X games
Flocc:Cattas	Category:Felids
Wikipǣdia:Gecorene gemynddagas/16 Solmōnaþ	Wikipedia:Selected anniversaries/February 16
Wikipǣdia:Gecorene gemynddagas/25 Wēodmōnaþ	Wikipedia:Selected anniversaries/August 25
Flocc:Russisce wrīteras	Category:Russian writers
Bysen:•	Template:•
Flocc:1066	Category:1066
Flocc:Gestorfen in 1066	Category:1066 deaths
Flocc:Angola	Category:Angola
Flocc:Botswana	Category:Botswana
Flocc:Elpendbānrima	Category:Ivory Coast
Flocc:Æriþrea	Category:Eritrea
Flocc:Gabon	Category:Gabon
Flocc:Gambia	Category:The Gambia
Flocc:Guinea	Category:Guinea
Flocc:Camerun	Category:Cameroon
Flocc:Grēnenæs Īega	Category:Cape Verde
Flocc:Cenia	Category:Kenya
Flocc:Liberia	Category:Liberia
Flocc:Libia	Category:Libya
Flocc:Morocco	Category:Morocco
Flocc:Mauritania	Category:Mauritania
Flocc:1451	Category:1451
Flocc:Namibia	Category:Namibia
Flocc:Caribisc Sǣ	Category:Caribbean Sea
Flocc:Delaware	Category:Delaware
Flocc:Georgia (America)	Category:Georgia (U.S. state)
Flocc:Montāna	Category:Montana
Flocc:Eall gewritu þe hlȳtrunge þurfaþ	Category:All pages needing cleanup
Bysen:Merge	Template:Merge
Flocc:Tennessee	Category:Tennessee
Bysen:Sūðamerica	Template:Countries of South America
Flocc:Baden-Wyrttemberg	Category:Baden-Württemberg
Flocc:1852	Category:1852
Flocc:1892	Category:1892
Flocc:Gestorfen in 1926	Category:1926 deaths
Flocc:1973	Category:1973
Flocc:Gestorfen in 1973	Category:1973 deaths
Flocc:1975	Category:1975
Flocc:1981	Category:1981
Flocc:Gestorfen in 1982	Category:1982 deaths
Flocc:2004	Category:2004
Flocc:Gestorfen in 2004	Category:2004 deaths
Flocc:2005	Category:2005
Flocc:2006	Category:2006
Flocc:2007	Category:2007
Flocc:2008	Category:2008
Flocc:Ēa	Category:Rivers
Bysen:Brūcend el-2	Template:User el-2
Bysen:Brūcend fo-1	Template:User fo-1
Bysen:Brūcend fo-3	Template:User fo-3
Bysen:Brūcend la-2	Template:User la-2
Bysen:Brūcend no-1	Template:User no-1
Bysen:Brūcend pl-2	Template:User pl-2
Bysen:Brūcend pt	Template:User pt
Flocc:Sūþsudan	Category:South Sudan
Flocc:Cead	Category:Chad
Flocc:Uganda	Category:Uganda
Flocc:Rōmānisce Cāseras	Category:Roman emperors
Flocc:Brūcend nl	Category:User nl
Flocc:Sūþhjaltland	Category:South Shetland Islands
Flocc:Brūcend no-1	Category:User no-1
Flocc:Brūcend no-2	Category:User no-2
Flocc:Brūcend no	Category:User no
Flocc:Niðerlanda Cyningas	Category:Dutch monarchs
Flocc:Norrena cyningas	Category:Norwegian monarchs
Flocc:Swēona cyningas	Category:Swedish monarchs
Flocc:Armenia	Category:Armenia
Flocc:Bahrain	Category:Bahrain
Flocc:Mennisc bodiȝlār	Category:Human anatomy
Flocc:Feorrsīen	Category:Television
Flocc:Angelcirice	Category:Church of England
Flocc:14e gēarhundred	Category:14th century
Flocc:13e gēarhundred	Category:13th century
Flocc:2e gēarhundred	Category:2nd century
Flocc:4e gēarhundred	Category:4th century
Flocc:5e gēarhundred	Category:5th century
Flocc:18e gēarhundred	Category:18th century
Flocc:6e gēarhundred	Category:6th century
Flocc:Arabea	Category:Arabian Peninsula
Flocc:Nīwlicu Word	Category:Neologisms
Flocc:Nīwesǣlendisce wrīteras	Category:New Zealand writers
Flocc:Seaxland-Anhalt	Category:Saxony-Anhalt
Flocc:Niðerseaxland	Category:Lower Saxony
Flocc:Russe	Category:Russian people
Flocc:Unƿǣre lēode	Category:Fictional characters
Flocc:Crēcisc ūtwitan	Category:Greek philosophers
Flocc:Sūþseaxe	Category:Sussex
Flocc:Bægwaraland	Category:Bavaria
Flocc:Superman	Category:Superman
Flocc:Ēage	Category:Eye
Flocc:Corn	Category:Cereals
Flocc:Nīweoforwīcburg	Category:New York City
Flocc:Norþfolc	Category:Norfolk
Flocc:Norþhāmtūnescīr	Category:Northamptonshire
Flocc:NBC	Category:National Broadcasting Company
Flocc:Gamen	Category:Recreation
Flocc:Snotingahāmscīr	Category:Nottinghamshire
Flocc:15e gēarhundred	Category:15th century
Flocc:Georgia (land)	Category:Georgia (country)
Flocc:Cambodia	Category:Cambodia
Flocc:Americanisc sangeras	Category:American singers
Flocc:Bryttisce scopas	Category:British poets
Flocc:Stǣr þæs Cynerices Greatbryttenes	Category:History of the United Kingdom
Flocc:Iamaica	Category:Jamaica
Bysen:Lang-hy	Template:Lang-hy
Flocc:Scotta cyningas	Category:Scottish monarchs
Flocc:Bryttiscan Fæmne Īegland	Category:British Virgin Islands
Flocc:Corēa	Category:Korea
Flocc:Burma	Category:Burma
Flocc:Taprabane	Category:Sri Lanka
Bysen:Col-3	Template:Col-3
Flocc:Tacgicastan	Category:Tajikistan
Flocc:Ēasttimor	Category:East Timor
Flocc:Turcmenistan	Category:Turkmenistan
Flocc:Usbecastan	Category:Uzbekistan
Flocc:Geānedan Arabiscan Bregorīce	Category:United Arab Emirates
Flocc:9e gēarhundred	Category:9th century
Flocc:Sofiet Gesamnung	Category:Soviet Union
Wikipǣdia:Sēðung þurfed	Wikipedia:Citation needed
Otago Underrīcelic Læppa	Otago Province
Bysen:Brūcend de-4	Template:User de-4
Flocc:Searwa stycce	Category:Technology stubs
Flocc:Wēalas	Category:Wales
Flocc:Blizzard Entertainment	Category:Blizzard Entertainment
Flocc:Foresittendas þāra Geāndena Rīca American	Category:Presidents of the United States
Flocc:Europisc stǣr	Category:History of Europe
Flocc:Hascemisce Cynerīce þæs Iordanes	Category:Jordan
Flocc:Bosnia and Herzegovina	Category:Bosnia and Herzegovina
Flocc:Norþweg	Category:Norway
Flocc:Barbados	Category:Barbados
Flocc:Paraguay	Category:Paraguay
Flocc:Ficgiege	Category:Fiji
Flocc:Lēohtenstān	Category:Liechtenstein
Flocc:Uruguay	Category:Uruguay
Flocc:Andorra	Category:Andorra
Flocc:Serbia	Category:Serbia
Flocc:Ecuador	Category:Ecuador
Flocc:Peru	Category:Peru
Flocc:Bolifia	Category:Bolivia
Flocc:Albania	Category:Albania
Flocc:Monaco	Category:Monaco
Flocc:Land on Norðamerican	Category:Countries in North America
Flocc:Fiscas	Category:Fish
Flocc:Mūþ	Category:Mouth
Flocc:Wyrta	Category:Vegetables
Flocc:Ofet	Category:Fruit
Flocc:Nīwu Gecȳþnes	Category:New Testament
Flocc:Musea	Category:Museums
Flocc:Rímcræft	Category:Functions and mappings
Flocc:Landscipas Swēolandes	Category:Counties of Sweden
Flocc:Stǣrlice Sprǣccræft	Category:Historical linguistics
Flocc:Dūnholmscīr	Category:County Durham
Flocc:Manga	Category:Manga
Flocc:Eoferwicscīr	Category:Yorkshire
Flocc:Oferhæleðas	Category:Superheroes
Flocc:Calpis	Category:Gibraltar
Flocc:Beadwe	Category:Battles
Flocc:Weorcendebyrdnessa	Category:Operating systems
Flocc:Mexicorīce	Category:States of Mexico
Flocc:Hidalgo Rīce	Category:Hidalgo (state)
Flocc:Hetwaraland	Category:Hesse
Flocc:Canadan underrīce and landscipas	Category:Provinces and territories of Canada
Flocc:Lunden	Category:London
Flocc:Lincolnscīr	Category:Lincolnshire
Flocc:Hēafodstōlas in American	Category:Cities in the Americas
Bysen:Incubator	Template:Incubator
Flocc:Dæg þæs gēares	Category:Days
Flocc:Wikimedian geweorc	Category:Wikimedia Foundation
Flocc:Byrig on Buccingahamscīre	Category:Towns in Buckinghamshire
Flocc:Help	Category:Help
Flocc:Wiltūnscīr	Category:Wiltshire
Flocc:Wigreceastrescīr	Category:Worcestershire
Flocc:Haran	Category:Lepus
Flocc:Americanisce Ingefeoht	Category:American Civil War
Flocc:Byrig on Tuscanie	Category:Cities and towns in Tuscany
Flocc:Wyrt	Category:Herbs
Flocc:Dēor	Category:Animals
Flocc:Hweorfdēor	Category:Vertebrates
Flocc:Pitcearnīega	Category:Pitcairn Islands
Flocc:Cægman Īegland	Category:Cayman Islands
Flocc:Folcland Īegland	Category:Falkland Islands
Flocc:Land on Sūðamerican	Category:Countries in South America
Flocc:Colombia	Category:Colombia
Bysen:End box	Template:S-end
Peonhōh	Pinhoe
Bysen:Contents pages (header bar)	Template:Contents pages (header bar)
Flocc:Anime	Category:Anime
Flocc:Oxnafordscīr	Category:Oxfordshire
Flocc:Hociȝ	Category:Hockey
Flocc:Heortfordscīr	Category:Hertfordshire
Flocc:Sicilia	Category:Sicily
Flocc:Grantabrycgscīr	Category:Cambridgeshire
Flocc:Þēodacynewīse	Category:Commonwealth of Nations
Flocc:Līþ	Category:Alcoholic beverages
Flocc:Spearctellas	Category:Video game consoles
Flocc:Englisc scīr	Category:Counties of England
Flocc:Æþelingas	Category:Princes
Flocc:Ceasterscīr	Category:Cheshire
Flocc:Sūþrige	Category:Surrey
Flocc:Defenascīr	Category:Devon
Flocc:Se Hlāford þāra Hringa	Category:The Lord of the Rings
Flocc:Rōmāniscu Folclār	Category:Roman mythology
Flocc:Beadanfordscīr	Category:Bedfordshire
Flocc:Bergan	Category:Berries
Flocc:Bēor	Category:Beer
Flocc:Sang	Category:Songs
Flocc:Eormengyld byrig	Category:University towns
Flocc:Hēafodstōlas	Category:Capitals
Flocc:Byrig on Paraguay	Category:Populated places in Paraguay
Flocc:Stōwlice hēafodstōlas Canadan	Category:Cities in Canada
Flocc:Ēastseaxe	Category:Essex
Flocc:Middelasia	Category:Central Asia
Flocc:Indisca Underworulddǣl	Category:South Asia
Flocc:NFL	Category:National Football League
Flocc:Tuscania	Category:Tuscany
Flocc:Latium	Category:Lazio
Flocc:Lonceasterscīr	Category:Lancashire
Flocc:Hāmtūnescīr	Category:Hampshire
Flocc:Brūcend pl	Category:User pl
Flocc:Gleawcesterscīr	Category:Gloucestershire
Flocc:Rōmānisca sprǣca	Category:Romance languages
Flocc:Fōr	Category:Transport
Flocc:Sund	Category:Swimming
Flocc:Hēapplegan	Category:Team sports
Flocc:Toys	Category:Toys
Flocc:Hīwscipe	Category:Family
Flocc:Cornweall	Category:Cornwall
Flocc:Tūnas on Sūþfolce	Category:Villages in Suffolk
Flocc:Antarctica	Category:Antarctica
Flocc:Norðamerica	Category:North America
Flocc:Sangestre	Category:Singers
Flocc:Euxinus	Category:Black Sea
Flocc:Meras	Category:Lakes
Bysen:Elementbox isotopes decay2	Template:Infobox element/isotopes decay2
Bysen:Flagcountry	Template:Flagcountry
Flocc:Byrig on Virginie	Category:Populated places in Virginia
Bysen:Country data Weimar Republic	Template:Country data Weimar Republic
Flocc:Sweartbeorg	Category:Montenegro
Flocc:Indisc Gārsecg	Category:Indian Ocean
Flocc:Wægnas	Category:Automobiles
Bysen:Brūcend af-2	Template:User af-2
Wealhmoru	Carrot
Flocc:Byrig on Francum	Category:Populated places in France
Flocc:Cent	Category:Kent
Flocc:Byrig on Fietname	Category:Cities in Vietnam
Flocc:Byrig on þǣm Ucrægnan	Category:Cities in Ukraine
Flocc:Byrig on Eotolwarum	Category:Cities and towns in Italy
Flocc:Beorgas on Brettum	Category:Mountains and hills of the United Kingdom
Hrānhuntoþ in Grēnelande	Reindeer hunting in Greenland
Flocc:Scotland	Category:Scotland
Flocc:Spēonisc bōccræft	Category:Spanish literature
Flocc:Cumbraland	Category:Cumberland
Flocc:Hēafodstōlas in Europe	Category:Capitals in Europe
Flocc:Hēafodstōlas in Asie	Category:Capitals in Asia
Flocc:Þēodisc Hǣðenscipe	Category:Germanic paganism
Flocc:Norðerne Īrland	Category:Northern Ireland
Sadolīeg, Sūþgeorgia	Saddle Island, South Georgia
Flocc:Nīwesǣlendisc bōccræft	Category:New Zealand literature
Flocc:Īrisc bōccræft	Category:Irish literature
Mearhsēaw	Sausage gravy
Bysen:CompactTOC	Template:Compact ToC
Flocc:Geāsparedu līc	Category:Mummies
Flocc:Wendelsǣ	Category:Mediterranean
Bysen:Dmbox	Template:Dmbox
Flocc:Byrig on Californie	Category:Populated places in California
Flocc:Byrig on Uermonte	Category:Populated places in Vermont
Flocc:Byrig on Finnum	Category:Populated places in Finland
Flocc:Byrig on Floridan	Category:Populated places in Florida
Flocc:Byrig on Cile	Category:Populated places in Chile
Flocc:Wikipedia tutorial	Category:Wikipedia tutorials
Flocc:Byrig on Illinoise	Category:Populated places in Illinois
Flocc:Byrig on Īrum	Category:Populated places in the Republic of Ireland
Bysen:Wikia	Template:Wikia
Flocc:World Trade Center	Category:World Trade Center
Bysen:Rounddown	Template:Rounddown
Flocc:Loidis	Category:Leeds
Flocc:Hafocas	Category:Hawks
Flocc:Australisc Hēafodburg Landscipe	Category:Australian Capital Territory
Sinner (lēasspell Dekkeres)	Sinner (Dekker novel)
Flocc:Brūcend de-5	Category:User de-5
Bysen:Country data Cænada	Template:Country data Canada
Bysen:Col-begin-small	Template:Col-begin-small
Bysen:Color box	Template:Color box
Flocc:Angleseg	Category:Anglesey
Bysen:Coord/dec2dms	Template:Coord/dec2dms
Bysen:Coord/dec2dms/dms	Template:Coord/dec2dms/dms
Bysen:Coord/display/inline	Template:Coord/display/inline
Bysen:Coord/input/d	Template:Coord/input/d
Bysen:Coord/input/dec	Template:Coord/input/dec
Bysen:Coord/input/dm	Template:Coord/input/dm
Bysen:Coord/input/dms	Template:Coord/input/dms
Bysen:Coord/prec dec	Template:Coord/prec dec
Flocc:Cyþþubox	Category:Sidebar templates
Bysen:Flag	Template:Flag
Bysen:Country data Barbados	Template:Country data Barbados
Bysen:Country data Empire of Japan	Template:Country data Empire of Japan
Bysen:Country data Free French	Template:Country data Free France
Bysen:Country data Martinique	Template:Country data Martinique
Bysen:Country data Åland Islands	Template:Country data Åland Islands
Bysen:Lang-pl	Template:Lang-pl
Bysen:Brūcend pl-3	Template:User pl-3
Bysen:Brūcend pl-4	Template:User pl-4
Flocc:Flæmingaland	Category:Flanders
The Narrative	The Narrative
Flocc:Byrig on Difelinscīre	Category:Towns and villages in County Dublin
The Price of Paradise	The Price of Paradise
The Wind and the Wheat	The Wind and the Wheat
Flocc:Ēastengla cyningas	Category:East Anglian monarchs
Flocc:Miercna cyningas	Category:Mercian monarchs
Flocc:Norþhymbra cyningas	Category:Northumbrian monarchs
Flocc:Westseaxna cyningas	Category:West Saxon monarchs
Transformers (Dreamwave)	Transformers: Generation One (Dreamwave)
Trojany (Masovian Voivodship)	Trojany, Masovian Voivodeship
Flocc:Willelm Shakespeare	Category:William Shakespeare
Flocc:Byrig þāra Faroiscan Īegena	Category:Populated places in the Faroe Islands
Who Loves You (gesang)	Who Loves You (song)
Flocc:Sigelhearwena Cāseras	Category:Emperors of Ethiopia
Flocc:Land on Asie	Category:Countries in Asia
Bysen:Fapages	Template:Fapages
Flocc:Windows gamen	Category:Windows games
Bysen:Dispute-resolution	Template:Dispute-resolution
Bysen:Landskap	Template:Provinces of Sweden
Flocc:Wicibōceras in þǣm Geānlǣhtum Rīcum American	Category:Wikipedians in the United States
Bysen:Plegere-stycce	Template:Actor-stub
Bysen:Nigerie Rīce	Template:States of Nigeria
Flocc:Wikipedia protected edit requests	Category:Wikipedia protected edit requests
Bysen:Brūcend la-4	Template:User la-4
Bysen:Brūcend la	Template:User la
Bysen:Brūcend it-4	Template:User it-4
Bysen:Brūcend is-4	Template:User is-4
Bysen:Brūcend is-3	Template:User is-3
Bysen:Brūcend fo-2	Template:User fo-2
Bysen:Brūcend fo	Template:User fo
Bysen:Brūcend el-4	Template:User el-4
Bysen:Brūcend el-3	Template:User el-3
Bysen:Brūcend cy-3	Template:User cy-3
Bysen:Brūcend cy-2	Template:User cy-2
Bysen:Brūcend cy-1	Template:User cy-1
Bysen:Brūcend cy	Template:User cy
Bysen:Brūcend ang	Template:User ang
Bysen:Szl icon	Template:Szl icon
Bysen:Lang-ty	Template:Lang-ty
Bysen:Lang-ti	Template:Lang-ti
Bysen:Lang-sq	Template:Lang-sq
Bysen:Lang-ro	Template:Lang-ro
Bysen:Lang-kl	Template:Lang-kl
Bysen:IPAc-en	Template:IPAc-en
Bysen:Lang-es	Template:Lang-es
Bysen:Lang-cy	Template:Lang-cy
Bysen:Lang-bn	Template:Lang-bn
Flocc:Westmoringaland	Category:Westmorland
Flocc:Westmidlandscīr	Category:West Midlands (county)
Flocc:West Loðene	Category:West Lothian
Bysen:ISO 639 name de	Template:ISO 639 name de
Bysen:StarCraft endebyrdnes	Template:StarCraft series
Bysen:Country data Ryūkyū Kingdom	Template:Country data Ryūkyū Kingdom
Flocc:Wæringscīr	Category:Warwickshire
Flocc:Tūnas on Norþhāmtūnescīre	Category:Villages in Northamptonshire
Flocc:Tūnas on Beadanfordscīre	Category:Villages in Bedfordshire
Flocc:Wīcinga Ieldu	Category:Viking Age
Wikipǣdia:Gecorene gemynddagas/Wēodmōnaþ	Wikipedia:Selected anniversaries/August
Flocc:Seolh	Category:Pinnipeds
Flocc:Engla cyningas	Category:Anglo-Saxon monarchs
Flocc:Quebec	Category:Quebec
Flocc:Bryttisce ofersǣ landscipas	Category:British Overseas Territories
Flocc:Ostsǣ	Category:Baltic Sea
Flocc:Banffscīr	Category:Banffshire
Flocc:Bysen Brūcend Box	Category:Userboxes
Flocc:Brecenscīr	Category:Brecknockshire
Flocc:Brūcend Cartespil	Category:Card game user templates
Flocc:Dēaþstīele glīwdrēame clīwene	Category:Death metal musical groups
Flocc:Clackmannanscīr	Category:Clackmannanshire
Flocc:Lefenax	Category:Dunbartonshire
Flocc:Gūþ	Category:War
Flocc:Ēastgermanisca sprǣca	Category:East Germanic languages
Flocc:Ēast Loðene	Category:East Lothian
Flocc:Elisabeþ II	Category:Elizabeth II
Flocc:Elisabeþyld	Category:Elizabethan era
Flocc:Fermanagh	Category:County Fermanagh
Flocc:Tirowen	Category:County Tyrone
Flocc:Fif Scīr	Category:Fife
Flocc:Lēoðlic scātung	Category:Figure skating
Bysen:Lang-zh	Template:Lang-zh
Bysen:Lang-mn	Template:Lang-mn
Bysen:Lang-fi	Template:Lang-fi
Bysen:Lang-sv	Template:Lang-sv
Flocc:Fotbox	Category:Footer templates
Flocc:Frencisc Polynesia	Category:French Polynesia
Bysen:Brūcend it-5	Template:User it-5
Flocc:Germanisca sprǣca	Category:Germanic languages
Flocc:Glamorgan	Category:Glamorgan
Bysen:Precision1	Template:Precision1
Bysen:Precision/tz	Template:Precision/tz
Bysen:Precision/tz/1	Template:Precision/tz/1
Flocc:Hāmtūnscīr Scīr, West Virginia	Category:Hampshire County, West Virginia
Flocc:Herefordscīr	Category:Herefordshire
Flocc:Monmuþscīr	Category:History of Monmouthshire
Flocc:Rōmānisc stǣr	Category:History of Rome
Flocc:Huntandunscīr	Category:Huntingdonshire
Flocc:Īshocig	Category:Ice hockey
Wikipǣdia:Edit conflicts	Help:Edit conflict
Flocc:Īrland	Category:Ireland
Flocc:Constantinopolis	Category:Istanbul
Wikipǣdia:Page history	Help:Page history
Flocc:Kwara Rīce	Category:Kwara State
Flocc:Mintan	Category:Lamiaceae
Flocc:Lanercscīr	Category:Lanarkshire
Flocc:Bysen Sprǣc	Category:Lang-x templates
Flocc:Lægreceastrescīr	Category:Leicestershire
Flocc:Langbeardnaland	Category:Lombardy
Wikipǣdia:Snellbred	Help:Cheatsheet
Wikipǣdia:This page is protected	Help:Protection
Wikipǣdia:Show preview	Help:Show preview
Wikipǣdia:Sundortácnu	Help:Special characters
Flocc:Midloðene	Category:Midlothian
Flocc:Muntgumniscīr	Category:Montgomeryshire
Flocc:Rōwrenoc on Virginie	Category:Roanoke, Virginia
Flocc:Rōm	Category:Rome
Flocc:Norþhymbraland	Category:Northumberland
Flocc:Rūncræft	Category:Runes
Flocc:Roteland	Category:Rutland
Flocc:Sancte Elene Īeg, Upstigeīeg and Tristan da Cunha	Category:Saint Helena, Ascension and Tristan da Cunha
Flocc:Seaxe	Category:Saxons
Flocc:Brūcend Hǣðen	Category:Pagan Wikipedians
Flocc:Seleciricescīr	Category:Selkirkshire
Flocc:Hjaltland	Category:Shetland
Flocc:Scipu	Category:Ships
Flocc:Scrobbesbyrigscīr	Category:Shropshire
Flocc:Byrig on Seringum	Category:Populated places in China
Flocc:Byrig on Marianlande	Category:Populated places in Maryland
Flocc:Byrig on Pennsyluanie	Category:Populated places in Pennsylvania
Flocc:Byrig on Wyominge	Category:Populated places in Wyoming
Flocc:Byrig on Gleawcesterscīre	Category:Towns in Gloucestershire
Flocc:Napoleon I Francena Casere	Category:Napoleon
Flocc:NHL	Category:National Hockey League
Flocc:Byrig on Nīwum Hāmtūnscīre	Category:Cities in New Hampshire
Flocc:Byrig on Dūnholmscīre	Category:Towns in County Durham
Flocc:Byrig on Dēorabyscīre	Category:Towns in Derbyshire
Flocc:Byrig on Defenum	Category:Towns in Devon
Sīðemestan dēaðas	Lists of deaths by year
Flocc:Byrig on Lonceasterscīre	Category:Towns in Lancashire
Flocc:Americanisc fōtball	Category:American football
Flocc:Stæffordscīr	Category:Staffordshire
Flocc:Bermuda	Category:Bermuda
Flocc:Bearrucscīr	Category:Berkshire
Flocc:Byrig on Bearrucscīre	Category:Towns in Berkshire
Flocc:Norþgermanisca sprǣca	Category:North Germanic languages
Flocc:Striuelinscīr	Category:Stirlingshire
Flocc:São Paulo	Category:São Paulo (city)
Flocc:Ucrægnisc sprǣc	Category:Ukrainian language
Flocc:Westgermanisca sprǣca	Category:West Germanic languages
Flocc:Byrig on Sūþrigum	Category:Towns in Surrey
Flocc:Byrig on Grantabrycgscīre	Category:Towns in Cambridgeshire
Flocc:Byrig on Cornweallum	Category:Towns in Cornwall
Flocc:Byrig on Cent	Category:Towns in Kent
Flocc:Byrig on Midloðene	Category:Towns in Midlothian
Flocc:Byrig on Oxnafordscīre	Category:Towns in Oxfordshire
Flocc:Byrig on Westmidlandscīre	Category:Towns in the West Midlands (county)
Flocc:Dȳfung	Category:Underwater diving
Flocc:Byrig on Scrobbesbyrigscīre	Category:Towns in Shropshire
Flocc:Byrig on Stæffordscīre	Category:Towns in Staffordshire
Flocc:Ardmachusscīr	Category:County Armagh
Flocc:Brūcend fo-5	Category:User fo-5
Flocc:Tūnas on Ceasterscīre	Category:Villages in Cheshire
Flocc:Tūnas on West Loðene	Category:Villages in West Lothian
Flocc:Byrig on Wigreceastrescīre	Category:Towns in Worcestershire
Flocc:Byrig on Wæringscīre	Category:Towns in Warwickshire
Flocc:Wichlawscīr	Category:County Wicklow
Flocc:Byrig on Wiltūnscīre	Category:Towns in Wiltshire
Flocc:Nīwre Gecȳþnesse bōc	Category:New Testament books
Flocc:Antrimscīr	Category:County Antrim
Flocc:Mageoscīr	Category:County Mayo
Flocc:Celtisc sprǣc	Category:Celtic languages
Flocc:Coritiba Foot Ball Club	Category:Coritiba Foot Ball Club
Flocc:Fōtþōðer	Category:Football
Flocc:Bryttisce Scīre	Category:Counties of the United Kingdom
Flocc:Landscipas Denemearce	Category:Peninsulas of Denmark
Flocc:Wendelsǣs īega	Category:Mediterranean islands
Flocc:Orcanege	Category:Orkney
Flocc:Byrig on Brasile	Category:Populated places in Brazil
Flocc:Byrig on Ēastseaxum	Category:Towns in East Sussex
Flocc:Byrig on Perwe	Category:Populated places in Peru
Flocc:Byrig on Polum	Category:Populated places in Poland
Flocc:Byrig on Russum	Category:Populated places in Russia
Flocc:Tūnas on Mageoscīre	Category:Towns and villages in County Mayo
Flocc:Gyldfōtþōðres styccelicu gewritu	Category:Association football stubs
Flocc:Byrig	Category:Cities
Flocc:Brūcend fo-3	Category:User fo-3
Flocc:Byrig on Hjaltlande	Category:Populated places in Shetland
Flocc:Englisc sprǣc	Category:Old English language
Flocc:Bretta Æþelingas	Category:Princes of the United Kingdom
Wikipǣdia:Tutorial (External links)	Wikipedia:Tutorial/Citing sources
Flocc:Personal life	Category:Personal life
Flocc:Byrig on Idahon	Category:Populated places in Idaho
Flocc:Byrig on Mississippi	Category:Populated places in Mississippi
Flocc:Byrig on Westvirginie	Category:Populated places in West Virginia
Flocc:WPS	Category:Women's Professional Soccer players by team
Flocc:Nīwbyrig on Brettum	Category:New towns in the United Kingdom
Flocc:Byrig on Nīwum Eoforwīce	Category:Cities in New York
Flocc:Middelseaxe	Category:Middlesex
Flocc:Byrig on Brettum	Category:Cities in the United Kingdom
Bysen:Coord/display/title	Template:Coord/display/title
Bysen:Year in other calendars	Template:Year in other calendars
Bysen:Ombox/core	Template:Ombox/core
Wikipǣdia:Site support	Wikipedia:Site support
Flocc:Byrig on Grēnelande	Category:Cities and towns in Greenland
Flocc:Brūcend en-1	Category:User en-1
Flocc:Geboren in 1946	Category:1946 births
Flocc:Brūcend de-1	Category:User de-1
Flocc:Geboren in 1920	Category:1920 births
Flocc:Byrig on Spēnum	Category:Towns in Spain
Flocc:Germanisc mægþ	Category:Germanic peoples
Flocc:Īrisce Scīre	Category:Counties of Ireland
Flocc:Skrælingcynn	Category:Indigenous peoples of the Americas
Flocc:Byrig on Turcum	Category:Populated places in Turkey
Flocc:Byrig on Eoferwicscīre	Category:Towns in Yorkshire
Flocc:Byrig on Cumbralande	Category:Towns in Cumbria
Flocc:Byrig on Heortfordscīre	Category:Towns in Hertfordshire
Hunna Rīce	Hunnic Empire
Universidade Fundação Mineira de Educação e Cultura	FUMEC University
Bysen:Virginia	Template:Virginia
Bysen:Brūcend pl-5	Template:User pl-5
Bysen:Bo	Template:Bo
Bysen:Kylie Minogue	Template:Kylie Minogue
Bysen:Mennisc bodiglārlicu ansīen	Template:Human regional anatomy
Wikipǣdia:Gecorene gemynddagas/Sēremōnaþ	Wikipedia:Selected anniversaries/June
Wikipǣdia:Gecorene gemynddagas/Æfterra Gēola	Wikipedia:Selected anniversaries/January
Wikipǣdia:Gecorene gemynddagas/Hrēþmōnaþ	Wikipedia:Selected anniversaries/March
Wikipǣdia:Gecorene gemynddagas/Þrimilcemōnaþ	Wikipedia:Selected anniversaries/May
Wikipǣdia:Tutorial (Talk pages)	Wikipedia:Tutorial/Talk pages
Wikipǣdia:Tutorial (Related site links)	Wikipedia:Tutorial/Keep in mind
Bysen:Start date	Template:Start date
Bysen:Portas	Template:Portals
Wikipǣdia:Inlǽdung 3	Wikipedia:Introduction 3
Janice Rogers Brown	Janice Rogers Brown
Bysen:Brūcend fo-0	Template:User fo-0
Meore	Møre
Bysen:WPS Labelled Map	Template:WPS Labelled Map
Wikipǣdia:New User Welcome	Wikipedia:Welcoming committee/Standard user greeting
Bysen:WPS	Template:Women's Professional Soccer
Bysen:FPO number	Template:FPO number
Wikipǣdia:10 þing þe þu nāst ymbe Wicipǣdian	Wikipedia:Ten things you may not know about Wikipedia
Bysen:Brūcend cy-0	Template:User cy-0
Bysen:Brūcend ang-2	Template:User ang-2
Bysen:Brūcend ang-1	Template:User ang-1
Bysen:Brūcend ang-3	Template:User ang-3
Bysen:Editor toc	Template:Editor toc
Bysen:Species	Template:Species
Bysen:Nama	Template:Given name
Bysen:Elementbox isotopes decay	Template:Infobox element/isotopes decay
Bysen:Brūcend cy-4	Template:User cy-4
Bysen:SGSSI	Template:South Georgia and the South Sandwich Islands
Bleohcrāwe	Jay
Bysen:Italy-hist-stub	Template:Italy-hist-stub
Bysen:Brūcend fo-4	Template:User fo-4
Bysen:Lang-kw	Template:Lang-kw
Bysen:Eald-Rōm-stycce	Template:AncientRome-stub
Bysen:Infobox/row	Template:Infobox/row
Bysen:Brūcend pt-5	Template:User pt-5
Wikipǣdia:Tutorial (Wrap-up and more info)	Wikipedia:Tutorial/Wrap-up and more info
Bysen:Brūcend la-5	Template:User la-5
Bysen:Lang-sco	Template:Lang-sco
Wikipǣdia:Tutorial (Registration)	Wikipedia:Tutorial/Registration
Bysen:Scotlandes Scire	Template:Scotland counties
Bysen:Brūcend is-5	Template:User is-5
Bysen:Beadu-stycce	Template:Battle-stub
Bysen:Seriesbox Aircraft Categories	Template:Seriesbox aircraft categories
Bysen:Editabuselinks	Template:Noticeboard links
Wikipǣdia:Ádihtoðes FAQ	Wikipedia:FAQ/Editing
Bysen:Hǣðenscipe stycce	Template:Paganism-stub
Moseroþ	Moseroth
Bysen:Brūcend el-5	Template:User el-5
2013 FA Cup Final	2013 FA Cup Final
Wikipǣdia:In the news section on the Main Page	Wikipedia:In the news
Wikipǣdia:Lārcwide/TabsHeader	Wikipedia:Tutorial/TabsHeader
Swǣfe	Swabia
Wikipǣdia:Templates	Wikipedia:Templates
Wikipǣdia:IPA for Nīƿenglisce	Help:IPA for English
Wikipǣdia:Protection log	Wikipedia:Protection log
Wikipǣdia:Block log	Wikipedia:Block log
Wikipǣdia:Deletion log	Wikipedia:Deletion log
Hindberge	Rubus idaeus
Inclosure Act 1773	Inclosure Act 1773
Bysen:End	Template:End
Tirzah	Tirzah
Bysen:Syndrigebocstafas	Template:Contains special characters
Bysen:Xpda	Template:Xpda
Wikipǣdia:Upload log	Wikipedia:Upload log
Bysen:Imdb	Template:IMDb
Bysen:Ice hockey team roster	Template:Ice hockey team roster
Bysen:Country flagairforce	Template:Air force/core
Wikipǣdia:How to rename (move) a page	Help:How to move a page
Bysen:Image label verysmall	Template:Image label verysmall
Þyrscrūc	Troll cross
Lorde	Lorde
Georgius Grantanbrycge Æþeling	Prince George of Cambridge
Bysen:Lang-osx	Template:Lang-osx
Flocc:Wæstmas	Category:Crops
Scif-castenere	Chest of drawers
Bysen:Brūcend wunaþ on Nīwum Sǣlande	Template:User NZ res
Bysen:Donate	Template:Donate
Portal:Box-header/1	Template:Box-header/1
Woruldhandelstede	List of World Trade Centers
Portal:Contents/Types TOC	Portal:Contents/Types TOC
Wikipǣdia:Administrators' reading list	Wikipedia:Administrators' reading list
Wikipǣdia:Lārcwide/Tabs	Wikipedia:Tutorial/Tabs
Wikipǣdia:Lārcwide/Tab1	Wikipedia:Tutorial/Tab1
Wikipǣdia:Lārcwide/Tab2	Wikipedia:Tutorial/Tab2
Port:Syndrigu innung/Portas	Portal:Featured content/Portals
Port:Innoþ/Cynd heafod	Portal:Contents/Types header
Wikipǣdia:Vandalism in progress	Wikipedia:Vandalism in progress
Wikipǣdia:Lārcwide/TabsBottom	Wikipedia:Tutorial/TabsBottom
Bysen:Brūcend cy-5	Template:User cy-5
Module:Yesno	Module:Yesno
Module:Category handler	Module:Category handler
Yun Hyon-seok	Yun Hyon-seok
Flocc:Byrig on Orcanegum	Category:Populated places in Orkney
Broods	Broods
Module:Arguments	Module:Arguments
Syndrig:RecentChanges	Special:RecentChanges
Flocc:Byrig on Langbeardum	Category:Cities and towns in Lombardy
Module:Namespace detect	Module:Namespace detect
Flocc:Gestorfen in 1975	Category:1975 deaths
Bysen:Malpighiales-stycce	Template:Malpighiales-stub
Bysen:Yamanashi-geo-stub	Template:Yamanashi-geo-stub
Module:Namespace detect/data	Module:Namespace detect/data
Module:Namespace detect/config	Module:Namespace detect/config
