ܐܦܪܝܩܐ	Africa
ܝܦܢ	Japan
ܐܡܪܝܩܐ ܬܝܡܢܝܬܐ	South America
ܢܘܪܒܝܓ	Norway
ܩܘܛܢܝܘܬܐ ܕܐܝܪܠܢܕ	Republic of Ireland
ܡܓܪ	Hungary
ܐܣܦܢܝܐ	Spain
ܐܘܚܕܢܐ ܡܚܝܕܐ	United States
ܒܠܓܝܩܐ	Belgium
ܠܘܟܣܡܒܘܪܓ	Luxembourg
ܬܒܝܠ	Universe
ܐܪܥܐ	Earth
ܡܘܬܐ	Death
ܒܪ ܐܢܫܐ	Human
ܓܘܪܓ ܘܐܫܝܢܓܛܘܢ	George Washington
ܦܝܢܠܢܕ	Finland
ܣܘܝܕ	Sweden
ܕܐܢܡܐܪܩ	Denmark
ܦܘܠܢܕ	Poland
ܠܬܘܢܝܐ	Lithuania
ܐܝܛܠܝܐ	Italy
ܣܘܝܣܪܐ	Switzerland
ܢܡܣܐ	Austria
ܝܘܢ	Greece
ܛܘܪܩܝܐ	Turkey
ܦܘܪܛܘܓܠ	Portugal
ܐܘܪܘܦܐ (ܝܒܫܬܐ)	Europe
ܐܣܝܐ (ܝܒܫܬܐ)	Asia
ܐܡܪܝܩܐ ܓܪܒܝܝܬܐ	North America
ܐܢܛܐܪܩܛܝܩܐ	Antarctica
ܘܝܩܝܦܕܝܐ	Wikipedia
ܗܘܠܢܕܐ	Netherlands
ܢܝܘ ܝܘܪܩ (ܡܕܝܢܬܐ)	New York City
ܘܐܫܢܓܛܘܢ (ܐܪܫܟܝܬܐ)	Washington, D.C.
ܒܪܠܝܢ	Berlin
ܚܫܘܒܐ (ܡܐܟܢܐ)	Computer
ܒܪܢ	Bern
ܬܣܝܪܝܟ	Zürich
ܐܢܛܪܢܛ	Internet
ܒܪܐܩ ܐܘܒܐܡܐ	Barack Obama
ܠܘܢܕܘܢ	London
ܐܠܟܣܢܕܪܝܐ	Alexandria
ܚܙܘܪܐ	Apple
ܦܐܪܝܣ	Paris
ܡܟܣܝܩܘ	Mexico
ܐܘܩܝܢܘܣ ܐܛܠܢܛܝܐ	Atlantic Ocean
ܐܘܩܝܢܘܣ ܫܝܢܝܐ	Pacific Ocean
ܒܘܣܛܘܢ	Boston
ܬܪܝܢܒܫܒܐ	Monday
ܟܢܘܢ ܒ	January
ܫܒܛ	February
ܐܕܪ	March
ܟܘܫ	Ethiopia
ܢܝܣܢ	April
ܐܝܪ	May
ܚܙܝܪܢ	June
ܬܡܘܙ	July
ܐܒ	August
ܐܝܠܘܠ	September
ܬܫܪܝܢ ܐ	October
ܬܫܪܝܢ ܒ	November
ܟܢܘܢ ܐ	December
ܬܠܬܒܫܒܐ	Tuesday
ܐܪܒܥܒܫܒܐ	Wednesday
ܚܡܫܒܫܒܐ	Thursday
ܥܪܘܒܬܐ	Friday
ܫܒܬܐ (ܙܒܢܐ)	Saturday
ܚܕܒܫܒܐ	Sunday
ܐܪܝܐ	Lion
ܦܪܢܣܐ	France
ܟܠܒܐ	Dog
ܡܠܟܘܬܐ ܡܚܝܕܬܐ	United Kingdom
ܩܛܐ	Cat
ܩܘܛܢܝܘܬܐ ܥܡܡܝܬܐ ܕܨܝܢ	China
ܠܫܢܐ ܦܪܢܣܝܐ	French language
ܒܪܐܙܝܠ	Brazil
ܪܘܣܝܐ	Russia
ܝܡܐ	Sea
ܝܡܐ ܐܘܟܡܐ	Black Sea
Π	Pi (letter)
ܐܠܒܐܡܐ	Alabama
ܣܐܘ ܦܐܘܠܘ	São Paulo
ܩܝܒܩ (ܗܘܦܪܟܝܐ)	Quebec
ܓܪܡܢ	Germany
ܒܠܐܪܘܣ	Belarus
ܠܫܢܐ ܓܪܡܢܝܐ	German language
ܐܠܗܐ	God
ܐܣܛܘܢܝܐ	Estonia
ܛܝܣܬܐ	Airplane
ܩܪܒܐ	War
1 (ܡܢܝܢܐ)	1 (number)
2 (ܡܢܝܢܐ)	2 (number)
3 (ܡܢܝܢܐ)	3 (number)
4 (ܡܢܝܢܐ)	4 (number)
5 (ܡܢܝܢܐ)	5 (number)
ܠܐܛܒܝܐ	Latvia
ܐܘܩܪܐܝܢܐ	Ukraine
ܬܫܝܟ	Czech Republic
ܣܠܘܒܩܝܐ	Slovakia
ܣܠܘܒܢܝܐ	Slovenia
ܡܘܠܕܘܒܐ	Moldova
ܪܘܡܢܝܐ	Romania
ܒܘܠܓܐܪܝܐ	Bulgaria
ܪܗܘܡܐ (ܡܕܝܢܬܐ)	Rome
ܩܘܛܢܝܘܬܐ ܕܡܩܕܘܢܝܐ	Republic of Macedonia
ܐܠܒܢܝܐ	Albania
ܩܪܘܐܛܝܐ	Croatia
ܒܘܣܢܐ ܘܗܪܬܣܓܘܒܝܢܐ	Bosnia and Herzegovina
ܐܙܪܒܝܓܐܢ	Azerbaijan
ܐܢܕܘܪܐ	Andorra
ܩܘܦܪܘܣ	Cyprus
ܓܘܪܓܝܐ (ܐܬܪܐ)	Georgia (country)
ܩܙܩܣܛܐܢ	Kazakhstan
ܡܝܠܛܐ	Malta
ܡܘܢܐܩܘ	Monaco
ܛܘܪܐ ܐܘܟܡܐ	Montenegro
ܡܕܝܢܬܐ ܕܘܛܝܩܢ	Vatican City
ܣܢ ܡܪܝܢܘ	San Marino
ܒܪܘܟܣܠ	Brussels
ܠܘܕܒܝܓ ܒܐܢ ܒܝܛܗܘܒܢ	Ludwig van Beethoven
ܠܫܢܐ ܛܘܪܩܝܐ	Turkish language
ܓܙܐܐܪ	Algeria
ܐܘܙܒܩܣܛܐܢ	Uzbekistan
ܘܐܪܣܘ	Warsaw
ܚܡܪܐ (ܫܬܝܐ)	Wine
ܡܝܐ	Water
ܦܪܣ ܚܙܘܐ	Television
ܬܫܝܠܝ	Chile
ܐܠ ܓܪܝܩܘ	El Greco
ܝܫܘܥ	Jesus
ܠܫܢܐ (ܡܡܠܠܐ)	Language
ܫܘܠܛܢ ܛܪܘܢܘܬܐ	Dictatorship
ܡܡܠܠܘܬ ܟܘܟܒܐ	Astronomy
ܡܪܝܡ (ܐܡܗ ܕܝܫܘܥ)	Mary (mother of Jesus)
ܠܝܟܛܢܫܛܝܢ	Liechtenstein
ܐܕܘܠܦ ܗܝܛܠܪ	Adolf Hitler
ܠܝܢܘܟܣ	Linux
ܠܫܢܐ ܠܐܛܝܢܝܐ	Latin
ܒܚܪܝܢ	Bahrain
ܐܪܡܢܝܐ	Armenia
ܣܪܒܝܐ	Serbia
ܣܗܪܐ	Moon
ܐܝܣܛܢܒܘܠ (ܡܕܝܢܬܐ)	Istanbul
ܐܘܣܛܪܠܝܐ (ܐܬܪܐ)	Australia
ܦܝܣܝܟ	Physics
ܩܘܪܐܢ	Quran
ܐܣܠܐܡ	Islam
ܟܡܬܪܐ	Pear
ܠܟ ܒܐܘܢܣܐ	Lech Wałęsa
ܫܠܡܐ (ܫܝܢܐ)	Peace
ܚܘܝܕܐ ܐܘܪܘܦܝܐ	European Union
ܐܢܬܬܐ	Woman
ܛܝܙܐ	Anus
ܫܚܬܐ (ܝܘܠܦܢ ܨܪܘܝܘܬܐ)	Axilla
ܗܒܒܐ	Flower
ܝܘܠܦܢ ܨܪܘܝܘܬܐ	Anatomy
ܡܕܝܢܬܐ	City
ܢܐܦܠܝܘܢ ܒܘܢܐܦܪܛ	Napoleon
ܟܘܟܒܐ	Star
ܫܡܫܐ	Sun
ܩܪܝܬܐ	Village
ܝܡܐ ܕܡܕܢܚܐ	Baltic Sea
ܫܢܐ	Tooth
ܘܝܩܝܡܝܕܝܐ ܩܘܡܡܘܢܣ	Wikimedia Commons
ܟܬܒܐ (ܣܦܪܐ)	Book
ܝܘܡܐ	Day
ܠܠܝܐ	Night
ܫܢܬܐ (ܙܒܢܐ)	Year
ܕܪܐ	Century
ܐܘܣܠܘ	Oslo
ܠܫܒܘܢܐ	Lisbon
ܦܠܝܛܐ	Planet
ܙܡܪܘܬܐ	Music
ܡܘܣܩܒܐ	Moscow
ܠܫܢܐ ܐܝܛܠܝܐ	Italian language
ܬܫܐܕ	Chad
ܬܝܡܢܐ	North
ܢܝܘ ܙܝܠܢܕ	New Zealand
ܓܪܒܝܐ	South
ܗܢܕܘ	India
ܦܪܙܠܐ	Iron
ܡܥܪܒܐ	West
ܡܕܢܚܐ	East
ܒܢܙܘܝܠܐ	Venezuela
ܛܠܦܣܢܐ	Chess
ܡܝܢ	Maine
ܣܘܣܝܐ	Horse
ܐܡܣܛܪܕܐܡ	Amsterdam
ܙܝܢܐ	Weapon
ܚܝܘܬܐ	Animal
ܩܘܠܘܡܒܝܐ	Colombia
ܢܝܘ ܗܐܡܦܫܪ	New Hampshire
ܠܝܘܢܪܕܘ ܕܗ ܒܢܬܫܝ	Leonardo da Vinci
ܡܐܣܐܬܫܘܣܬܣ	Massachusetts
ܐܘܛܪܝܟܛ (ܗܘܦܪܟܝܐ)	Utrecht (province)
ܟܘܢܝܬܝܟܬ	Connecticut
ܐܝܪܐܢ	Iran
ܥܝܪܐܩ	Iraq
ܐܠܐܣܟܐ	Alaska
ܐܝܣܪܐܝܠ	Israel
ܐܘܛܪܝܟܛ (ܡܕܝܢܬܐ)	Utrecht
ܝܡܢ	Yemen
ܠܫܢܐ ܦܘܠܢܕܝܐ	Polish language
ܝܘܪܕܢܢ	Jordan
ܩܝܪܓܝܙܣܛܐܢ	Kyrgyzstan
ܐܪܝܙܘܢܐ	Arizona
ܟܘܘܝܬ (ܐܬܪܐ)	Kuwait
ܠܒܢܢ	Lebanon
ܐܘܪܝܓܘܢ	Oregon
ܐܡܪܝܩܐ	Americas
ܝܘܬܐ	Utah
ܫܠܡܐ (ܦܬܓܡܐ)	Ciao
ܥܘܡܐܢ	Oman
ܦܐܩܣܛܐܢ	Pakistan
ܩܛܪ	Qatar
ܣܥܘܕܝܐ	Saudi Arabia
ܝܘܣܦ ܣܛܐܠܝܢ	Joseph Stalin
ܣܘܪܝܐ	Syria
ܛܐܓܝܩܣܛܐܢ	Tajikistan
ܦܪܣ ܩܠܐ	Radio
ܛܘܪܩܡܢܣܛܐܢ	Turkmenistan
ܐܡܝܪܘܬܐ ܥܪܒܝܬܐ ܡܚܝܕܬܐ	United Arab Emirates
ܐܦܓܐܢܣܛܐܢ	Afghanistan
ܕܗܒܐ	Gold
ܡܠܝ	Mali
ܦܝܠܝܦܝܢܝܐ	Philippines
ܩܘܛܢܝܘܬܐ ܕܐܦܪܝܩܐ ܡܨܥܝܬܐ	Central African Republic
ܐܝܣܚܩ ܢܝܘܛܢ	Isaac Newton
ܫܥܘܬܐ (ܓܘܢܐ)	Yellow
ܬܘܢܣ (ܐܬܪܐ)	Tunisia
ܬܝܡܢܐ ܕܣܘܕܐܢ	South Sudan
ܩܘܛܢܝܘܬܐ ܕܩܘܢܓܘ	Republic of the Congo
ܩܘܛܢܝܘܬܐ ܕܩܘܢܓܘ ܕܝܡܘܩܪܛܝܬܐ	Democratic Republic of the Congo
ܦܐܦܐ ܝܘܚܢܢ ܦܘܠܘܣ ܬܪܝܢܐ	Pope John Paul II
ܛܒܝܠܝܣܝ	Tbilisi
ܩܐܡܪܘܢ	Cameroon
ܠܘܒܐ	Libya
ܡܘܪܝܛܢܝܐ	Mauritania
ܡܓܪܒ	Morocco
ܢܝܓܪ	Niger
ܣܘܕܐܢ	Sudan
ܩܫܬܐ ܕܡܪܢ	Rainbow
ܗܐܡܒܘܪܓ	Hamburg
ܝܡܬܐ ܕܐܘܢܛܪܝܘ	Lake Ontario
ܝܡܬܐ ܕܣܘܦܝܪܝܘܪ	Lake Superior
ܓܐܘܓܪܦܝܐ	Geography
ܠܒܐ	Heart
ܡܘܚܐ	Brain
ܓܠܕܐ	Skin
ܓܘܢܐ	Color
ܦܪܐܓ	Prague
ܙܪܩܐ	Blue
ܟܣܦܐ (ܣܐܡܐ)	Silver
ܡܫܝܓܢ	Michigan
ܝܡܬܐ ܕܡܝܫܝܓܢ	Lake Michigan
ܐܠܝܢܘܝ	Illinois
ܢܘܪܬ ܕܐܟܘܬܐ	North Dakota
ܣܐܘܬ ܕܐܟܘܬܐ	South Dakota
ܡܘܢܬܐܢܐ	Montana
ܘܐܝܘܡܝܢܓ	Wyoming
ܐܘܪܫܠܡ	Jerusalem
ܐܝܕܐܗܘ	Idaho
ܢܝܒܐܕܐ	Nevada
ܐܘܩܝܢܘܣ ܗܢܕܘܝܐ	Indian Ocean
ܟܘܠܘܪܐܕܘ	Colorado
ܫܝܩܓܘ	Chicago
ܣܬܘܐ	Winter
ܬܕܐܐ	Spring (season)
ܩܝܛܐ	Summer
ܬܫܪܝܬܐ	Autumn
ܨܕܐܡ ܚܘܣܝܢ	Saddam Hussein
ܠܫܢܐ ܐܣܦܢܝܐ	Spanish language
ܓܘܓܝ	Spider
ܐܒܐ (ܦܐܪܐ)	Fruit
ܩܘܦܐ	Monkey
ܒܪܓܝܢܝܐ	Virginia
ܝܡܬܐ ܕܝܘܪܘܢ	Lake Huron
ܢܝܘ ܝܘܪܩ (ܐܘܚܕܢܐ ܡܚܝܕܐ)	New York
ܪܘܕ ܐܝܠܐܢܕ	Rhode Island
ܪܚܫܐ	Insect
ܡܐܪܝܠܐܢܕ	Maryland
ܕܝܠܐܘܝܪ	Delaware
ܐܘܗܐܝܘ	Ohio
ܦܢܣܝܠܒܐܢܝܐ	Pennsylvania
ܐܝܛܙܢ	Uetersen
ܐܓܘܣܛܘܣ ܩܣܪ	Augustus
ܢܝܘ ܓܝܪܣܝ	New Jersey
ܐܢܕܝܐܢܐ	Indiana
ܪܕܝܬܐ	Car
ܓܘܪܓܝܐ (ܐܘܚܕܢܐ ܡܚܝܕܐ)	Georgia (U.S. state)
ܣܩܠܝܐ	Sicily
ܣܢ (ܢܗܪܐ)	Seine
ܛܘܩܝܘ	Tokyo
ܦܪܕܝܢܢܕ ܡܓܝܠܢ	Ferdinand Magellan
ܢܝܘ ܡܝܟܣܝܟܘ	New Mexico
ܐܬܢܘܣ	Athens
ܡܢܝܣܘܬܐ	Minnesota
ܒܓܕܐܕ (ܡܕܝܢܬܐ)	Baghdad
ܘܝܣܟܘܢܣܢ	Wisconsin
ܐܝܐܘܐ	Iowa
ܢܝܒܪܐܣܟܐ	Nebraska
ܟܐܢܣܐܣ	Kansas
ܡܝܙܘܪܝ	Missouri
ܐܪܟܢܣܐܣ	Arkansas
ܠܫܢܐ ܕܐܘܪܕܘ	Urdu
ܐܘܟܠܐܗܘܡܐ	Oklahoma
ܝܡܐ ܕܓܪܒܝܐ	North Sea
ܒܝܝܢܐ	Vienna
ܩܘܦܢܗܐܓܢ	Copenhagen
ܣܛܘܩܗܘܠܡ	Stockholm
ܗܠܣܢܩܝ	Helsinki
ܕܒܠܢ	Dublin
ܒܪܛܝܣܠܐܒܐ	Bratislava
ܟܬܒܐ ܩܕܝܫܐ	Bible
ܥܕܬܐ ܫܪܝܪܬܐ ܕܝܫܘܥ	True Jesus Church
ܠܫܢܐ ܐܢܓܠܝܐ	English language
ܩܘܢܣܦܣܝܘܢ (ܬܫܝܠܝ)	Concepción, Chile
ܐܘܢܛܐܪܝܘ	Ontario
ܡܐܢܝܛܘܒܐ	Manitoba
ܐܠܒܪܛܐ	Alberta
ܢܘܒܐ ܣܩܘܛܝܐ	Nova Scotia
ܩܘܢܣܩܘܒܘܠܐ	Końskowola
ܢܝܘ ܒܪܘܢܙܘܝܩ	New Brunswick
ܩܘܠܘܡܒܝܐ ܒܪܝܛܝܬܐ	British Columbia
ܓܙܪܬܐ ܕܐܡܝܪܐ ܐܕܘܐܪܕ	Prince Edward Island
ܣܐܣܩܐܬܫܘܐܢ	Saskatchewan
2012	2012
2011	2011
2010	2010
2009	2009
ܢܝܘܦܐܘܢܕܠܢܕ ܘܠܐܒܪܐܕܘܪ	Newfoundland and Labrador
2008	2008
ܐܘܚܕܢܐ ܓܪܒܝܝܐ-ܡܥܪܒܝܐ	Northwest Territories
ܝܘܩܘܢ	Yukon
2005	2005
2006	2006
ܢܘܢܐܒܘܛ	Nunavut
2007	2007
ܡܐܟܘܠܬܐ	Food
ܚܘܝܐ	Snake
ܩܘܪܘܦ	Kurów
ܟܝܡܝܐ	Chemistry
1968	1968
ܩܛܠܥܡܐ ܝܗܘܕܝܐ	The Holocaust
ܡܕܪܝܕ (ܡܕܝܢܬܐ)	Madrid
ܗܘܦܪܟܝܣ ܘܐܘܚܕܢܐ ܕܩܢܕܐ	Provinces and territories of Canada
ܣܢܛܝܐܓܘ ܕܐ ܬܫܝܠܝ	Santiago
ܚܐܪܘܬܐ	Liberty
ܣܝܕܢܝ	Sydney
ܝܪܘܩܐ	Green
ܡܠܒܘܪܢ	Melbourne
ܣܘܡܩܐ	Red
ܢܘܪܐ (ܕܠܩܐ)	Fire
ܢܝܠܘܣ	Nile
ܓܙܐܐܪ (ܡܕܝܢܬܐ)	Algiers
ܬܘܢܣ (ܡܕܝܢܬܐ)	Tunis
ܛܗܪܐܢ	Tehran
ܐܢܩܪܐ	Ankara
ܢܝܐܡܝ	Niamey
ܒܡܩܘ	Bamako
ܕܪܡܣܘܩ	Damascus
ܥܡܐܢ	Amman
ܒܝܪܘܬ	Beirut
ܒܝܬ ܨܘܒܐ	University
ܒܝܬܐ (ܒܢܝܢܐ)	House
ܐܘܣܛܪܠܝܐ (ܝܒܫܬܐ)	Australia (continent)
ܢܗܪܐ	River
ܪܝܫܐ ܕܣܒܪܐ ܛܒܐ	Cape of Good Hope
ܫܘܚܡܠܐ	Investment
ܩܘܪܝܛܝܒܐ	Curitiba
ܥܒܐ	Forest
ܩܘܢܦܘܫܝܘܣ	Confucius
ܩܢܐ	Nest
ܐܘܪܘ	Euro
ܝܡܐ ܚܘܪܐ ܡܨܥܝܐ	Mediterranean Sea
ܓܘܪܓܝܐ	Georgia
ܡܫܝܚܝܘܬܐ	Christianity
ܩܠܒܐ:ܐܘܝܐ	Template:Agree
ܪܘܙܐ	Rice
ܝܒܫܬܐ	Continent
ܛܝܪܐ	Bird
ܐܪܫܟܝܬܐ	Capital city
ܠܫܢܐ ܦܘܪܛܘܓܠܝܐ	Portuguese language
ܝܪܚܐ	Month
ܡܘܨܛܦܐ ܟܡܐܠ ܐܛܐܛܘܪܩ	Mustafa Kemal Atatürk
ܐܠܡܐܙܢ	Almazán
ܠܫܢܐ ܝܦܢܝܐ	Japanese language
ܦܐܬܐ ܪܝܫܝܬܐ	Main Page
ܦܪܢܣܝܣܩܘ ܓܘܝܐ	Francisco Goya
ܝܡܐ ܐܚܪܝܐ	Caspian Sea
ܝܡܬܐ ܕܐܝܪܝ	Lake Erie
ܣܠܒܐܕܘܪ ܕܐܠܝ	Salvador Dalí
ܒܢܣܢܬ ܦܢ ܟܘܟ	Vincent van Gogh
ܦܪܝܕܐ ܩܐܠܘ	Frida Kahlo
ܗܢܪܝ ܡܐܛܝܣ	Henri Matisse
ܡܝܟܠܐܢܓܠܘ	Michelangelo
ܦܒܠܘ ܦܝܩܐܣܘ	Pablo Picasso
ܪܡܒܪܢܛ	Rembrandt
ܐܢܕܝ ܘܘܪܗܘܠ	Andy Warhol
ܢܝܢܘܐ (ܡܕܝܢܬܐ)	Nineveh
ܒܒܠ	Babylon
ܐܝܪܝܚܘ	Jericho
ܩܛܠܘܢܝܐ	Catalonia
ܡܕܪܝܕ (ܗܘܦܪܟܝܐ)	Community of Madrid
ܒܝܬ ܠܚܡ	Bethlehem
ܣܕܪܐ:Candidates for speedy deletion	Category:Candidates for speedy deletion
ܪܫܡܠܘܬܐ	Capitalism
ܐܘܡܬܐ	Nation
ܩܪܬܐܓܘ	Carthage
ܣܕܪܐ:ܐܣܛܪܘܢܘܡܝܐ	Category:Astronomy
ܨܚܪܐܐ	Sahara
ܫܐܕܐ	Devil
ܒܝܬ ܟܬܒܐ	Library
ܫܘܠܛܢܘܬܐ (ܫܘܬܐܣܐ)	Government
ܬܫܝܢ ܫܝ ܗܘܐܢܓ	Qin Shi Huang
ܡܕܢܚܐ ܡܨܥܝܬܐ	Middle East
ܡܠܟܘܬܐ	Monarchy
ܩܘܛܢܝܘܬܐ	Republic
ܐܬܪܐ	State (polity)
ܓܒܐ	Political party
ܝܗܘܕܝܐ	Jews
ܝܡܡܬܐ ܪܘܪܒܬܐ	Great Lakes
ܐܘܩܝܢܘܣ ܬܝܡܢܝܐ	Southern Ocean
ܐܕܢܐ (ܝܘܠܦܢ ܨܪܘܝܘܬܐ)	Ear
ܢܚܝܪܐ	Nose
ܥܝܢܐ (ܝܘܠܦܢ ܨܪܘܝܘܬܐ)	Eye
ܥܘܩܒܪܬܐ	Muscle
ܙܡܝܪܬܐ	Song
ܓܡܠܐ	Camel
ܫܘܫܡܢܐ	Ant
ܕܒܫܬܐ	Bee
ܠܫܢܐ ܗܘܠܢܕܝܐ	Dutch language
ܐܡܐ (ܒܝܬܝܘܬܐ)	Mother
ܐܒܐ (ܒܝܬܝܘܬܐ)	Father
1847	1847
ܨܦܪܐ (ܙܒܢܐ)	Morning
ܪܡܫܐ	Evening
ܩܛܝܢܬܐ	Minute
ܠܫܢܐ ܪܘܣܝܐ	Russian language
ܩܢܘܢܐ	Law
ܠܫܢܐ ܨܝܢܝܐ	Chinese language
ܕܡܐ	Blood
ܬܓܪܘܡܬܐ	Skeleton
ܪܐܬܐ	Lung
ܠܫܢܐ ܪܘܡܢܝܐ	Romanian language
ܡܛܪܐ	Rain
ܢܠܣܘܢ ܡܐܢܕܝܠܐ	Nelson Mandela
ܐܒܢܐ	Rock (geology)
ܥܢܢܐ	Cloud
ܩܢܘܢܐ ܕܠܥܙܐ	Grammar
ܠܫܢܐ ܓܘܪܓܝܐ	Georgian language
ܝܘܠܦܢ ܡܡܫܚܘܬܐ	Economics
ܙܘܙܐ	Currency
ܡܕܐܬܐ	Tax
ܐܠܦܒܝܬ ܥܪܒܝܐ	Arabic alphabet
ܐܠܦܒܝܬ ܝܘܢܝܐ	Greek alphabet
ܐܠܦܒܝܬ ܠܐܛܝܢܝܐ	Latin script
ܣܕܪܐ:ܦܪܢܣܐ	Category:France
ܟܢܫܐ	Society
ܓܒܪܐ	Man
ܙܘܘܓܐ	Marriage
ܙܕܩܐ ܕܒܪܢܫܐ	Human rights
ܩܪܒܐ ܓܘܝܐ	Civil war
ܓܪܡܐ ܕܣܢܘܢܝܬܐ	Sternum
ܬܪܝܢܐ	Juice
ܚܠܒܐ (ܕܝܘܒܐ)	Milk
ܛܘܪܐ	Mountain
ܡܕܒܪܐ	Desert
ܠܫܢܐ ܐܠܒܢܝܐ	Albanian language
ܠܫܢܐ ܐܪܡܢܝܐ	Armenian language
ܝܘܗܐܢ ܓܘܛܢܒܪܓ	Johannes Gutenberg
ܠܫܢܐ ܣܘܝܕܝܐ	Swedish language
ܢܝܩܘܠܐ ܛܣܠܐ	Nikola Tesla
ܡܘܫܐ	Moses
ܬܕܐ	Breast
ܢܘܗܪܐ (ܚܙܝܬܐ)	Light
ܠܫܢܐ ܝܘܢܝܐ	Greek language
ܠܫܢܐ ܦܪܣܝܐ	Persian language
ܬܘܕܝܬܐ	Religion
ܐܒܪܗܡ	Abraham
ܣܦܪܐ ܕܒܪܝܬܐ	Book of Genesis
ܠܫܢܐ ܩܢܛܘܢܝܐ	Cantonese
ܠܫܢܐ ܡܢܕܪܝܢܝܐ	Mandarin Chinese
ܦܘܠܘܣ ܫܠܝܚܐ	Paul the Apostle
ܙܝܓܡܘܢܕ ܦܪܘܝܕ	Sigmund Freud
ܙܠܛܐ	Salad
ܝܗܘܕܝܘܬܐ	Judaism
ܠܫܢܐ ܥܒܪܝܐ	Hebrew language
ܟܒܕܐ	Liver
ܛܚܠܐ	Spleen
ܟܘܠܝܬܐ	Kidney
ܫܠܦܘܚܬܐ	Urinary bladder
ܐܫܟܐ	Testicle
ܐܘܩܝܢܘܣ	Ocean
ܒܘܕܗܐ	Gautama Buddha
ܡܘܚܡܕ	Muhammad
ܟܪܣܐ	Abdomen
ܚܒܠܐ ܟܘܒܝܐ	Spinal cord
ܘܪܝܕܐ	Vein
ܡܪܒܥܐ	Uterus
ܠܫܢܐ (ܗܕܡܐ)	Tongue
ܓܝܕܐ	Nerve
ܨܘܪܐ (ܝܘܠܦܢ ܨܪܘܝܘܬܐ)	Neck
ܦܘܡܐ	Mouth
ܓܓܪܬܐ	Larynx
ܡܥܝܐ	Intestine
ܫܪܝܬܐ	Joint
ܬܝܪܬܐ	Gland
ܚܠܒܐ (ܝܘܠܦܢ ܨܪܘܝܘܬܐ)	Thoracic diaphragm
ܫܪܝܢܐ	Artery
A	A
B	B
ܢܘܛܦܬܐ	Semen
G	G
U	U
Z	Z
F	F
J	J
ܐܠܦܒܝܬ	Alphabet
T	T
C	C
R	R
D	D
Α	Alpha
Ω	Omega
I	I
Μ	Mu (letter)
E	E
H	H
ܗܐܪܠܡ (ܗܘܠܢܕܐ)	Haarlem
K	K
L	L
M	M
N	N
O	O
Q	Q
S	S
V	V
W	W
X	X
Y	Y
ܐܢܫܟܕܐ	Enschede
ܗܢܓܠܘ	Hengelo
Φ	Phi
ܝܘܢܐ	Columbidae
ܐܝܠܢܐ	Tree
Λ	Lambda
ܓܒܬܐ	Cheese
ܥܢܒܬܐ	Grape
ܕܒܫܐ	Honey
ܒܣܪܐ	Meat
ܫܟܪ	Sugar
ܣܦܪܙܒܢܐ	Newspaper
ܙܥܘܩܐ	Telephone
ܡܪܕܘܬܐ	Culture
ܡܥܝܐ ܥܒܝܐ	Large intestine
ܡܥܝܐ ܩܛܝܢܐ	Small intestine
ܣܘܪܓܕܐ ܝܘܠܝܝܐ	Julian calendar
ܐܣܝܘܬܐ	Medicine
ܡܠܚܐ (ܐܨܪܐ)	Salt
ܣܕܪܐ:ܒܪܐܙܝܠ	Category:Brazil
ܙܘܝܬܐ (ܡܚܪܘܬܐ)	Angle
ܬܘܩܦܐ	Energy
ܣܦܝܢܬܐ	Ship
ܩܠܐ (ܨܘܬܐ)	Sound
ܙܓܘܓܝܬܐ	Glass
ܫܛܝܚܘܬܐ	Area
ܡܢܝܢܐ	Number
ܪܦܦܐ	Second
ܣܥܪܬܐ	Barley
ܘܘܗܐܢ	Wuhan
ܡܟܬܒܢܘܬܐ ܕܐܬܪܘܬܐ	List of sovereign states
ܒܝܬ ܢܗܪܝܢ	Mesopotamia
ܕܒܐ	Bear
ܬܠܗܝܐ	Cancer
ܡܠܟܐ	King
ܚܛܬܐ	Wheat
ܣܘܪܓܕܐ	Calendar
ܟܘܪܗܢܐ	Disease
ܣܘܪܓܕܐ ܓܪܝܓܘܪܝܐ	Gregorian calendar
ܟܦܣܐ	Menstruation
ܥܡܐ ܩܪܕܘܝܐ	Kurds
ܓܫܪܐ	Bridge
ܡܓܕܠܐ (ܒܢܝܢܐ)	Tower
ܐܡܪܝܩܐ ܠܐܛܝܢܝܬܐ	Latin America
ܟܗܪܒܐ	Electricity
ܡܙܝܥܢܐ ܕܩܝܕܐ ܓܘܝܐ	Internal combustion engine
ܣܝܦܐ (ܙܝܢܐ)	Sword
ܫܡܥܘܢ ܩܢܢܝܐ	Simon the Zealot
ܩܪܩܦܬܐ	Skull
ܓܘܡܠܐ!	Joomla
ܐܦܫܬܐ	Raisin
ܠܫܢܐ ܕܗܣܝܐܢܓ	Xiang Chinese
ܠܫܢܐ ܥܪܒܝܐ	Arabic language
ܠܫܢܐ ܐܦܪܝܩܐܢܝܐ	Afrikaans
Β	Beta
Γ	Gamma
Δ	Delta (letter)
Ε	Epsilon
Ζ	Zeta
Η	Eta
Θ	Theta
Ι	Iota
Κ	Kappa
Ν	Nu (letter)
Ξ	Xi (letter)
Ο	Omicron
Ρ	Rho
Σ	Sigma
Τ	Tau
Υ	Upsilon
Χ	Chi (letter)
Ψ	Psi (letter)
ܐܬܐ	Flag
ܟܪܦܬܐ	Furniture
ܟܘܪܣܝܐ	Chair
ܣܦܬܐ	Lip
ܦܣܡܐ	Moustache
ܥܩܠܐ	Foot
1000000000 (ܡܢܝܢܐ)	1,000,000,000
ܓܪܡܐ ܕܨܕܥܐ	Temporal bone
ܩܠܝܕܐ (ܓܪܡܐ)	Clavicle
ܟܬܦܐ	Shoulder
ܦܟܐ ܬܚܬܝܐ	Human mandible
ܥܠܡܐ (ܐܪܥܐ)	World
ܘܝܩܝܦܕܝܐ:ܬܪܥܐ ܕܟܢܫܐ	Wikipedia:Village pump
ܒܝܪܡܘܢܬ	Vermont
ܩܘܣܛܢܛܝܢܘܦܘܠܝܣ	Constantinople
ܒܝܬ ܟܪܝܗܐ	Hospital
ܥܕܬܐ	Church (building)
ܕܝܬܝܩܝ ܚܕܬܐ	New Testament
9 (ܡܢܝܢܐ)	9 (number)
1002	1002
ܦܘܕܘܠܣܟ	Podolsk
ܦܐܦܐ	Pope
5	5
4	4
ܢܝܒܐ	Canine tooth
3	3
2	2
ܒܝܬ ܥܬܩܐ ܕܠܘܒܪ	Louvre
ܓܒܐ ܕܚܐܪܘܬܐ ܕܦܘܐܪܛܘ ܪܝܩܘ	Puerto Rican Independence Party
6	6
ܕܝܬܝܩܝ ܥܬܝܩܬܐ	Old Testament
ܥܐܕܐ ܕܒܝܬ ܝܠܕܐ	Christmas
ܠܫܢܐ ܪܘܡܐܢܣܝܐ	Romance languages
ܡܬܠܬܐ	Triangle
ܫܢܬܐ ܟܒܝܫܬܐ	Leap year
ܡܘܥܡܪ ܐܠܩܕܐܦܝ	Muammar Gaddafi
ܥܐܕܐ ܕܩܝܡܬܐ	Easter
ܢܝܘ ܝܘܪܩ	New York (disambiguation)
ܢܦܛܐ	Petroleum
ܣܐܘܢܐ	Shoe
ܒܝܬ ܥܘܪܦܢܐ	Bank
ܟܪܡܐ	Vineyard
ܐܝܪܠܢܕ (ܓܙܪܬܐ)	Ireland
1	1
ܠܘ ܫܘܢ	Lu Xun
10	10
20	20
9	9
7	7
8	8
7 (ܡܢܝܢܐ)	7 (number)
8 (ܡܢܝܢܐ)	8 (number)
12	12
ܡܠܐܐ ܘܬܘܒܐ	Tide
ܫܒܘܥܐ	Week
ܓܠܝܕܐ	Ice
ܨܠܘܬܐ ܡܪܢܝܬܐ	Lord's Prayer
ܝܡܬܐ	Lake
ܝܡܐ ܣܘܡܩܐ	Red Sea
13	13
ܩܛܘܬܐ (ܝܥܝܬܐ)	Cucumber
ܓܙܪܬܐ	Island
ܚܘܪܐ	White
ܐܘܟܡܐ	Black
6 (ܡܢܝܢܐ)	6 (number)
ܠܫܢܐ ܪܘܫܡܝܐ	Official language
11	11
15	15
14	14
17	17
ܣܦܪ ܡܠܐ	Dictionary
18	18
19	19
16	16
21	21
ܦܠܣܛܝܢ	Palestine
10 (ܡܢܝܢܐ)	10 (number)
ܡܣܘܪܩܐ (ܡܐܢܐ)	Comb
ܠܝܠܐ ܕܘܢܤ	Lila Downs
ܝܡܐ ܕܡܠܚܐ	Dead Sea
ܫܘܚܠܦܐ ܕܫܢܬܐ	Season
ܠܝܒܪܦܘܠ	Liverpool
ܩܘܦܬܐ (ܛܝܪܐ)	Owl
ܫܥܬܐ	Hour
ܢܐܘܝ ܕܘܪ ܟܪܘܠܣܟܝ	Nowy Dwór Królewski
ܐܪܙܦܬܐ	Hammer
ܝܘܢܫܘܦܝܢ	Jönköping
ܥܘܠܐ ܚܝܐ	Fetus
ܐܠܦܒܝܬ ܣܘܪܝܝܐ	Syriac alphabet
ܐܠܦܒܝܬ ܐܪܡܝܐ	Aramaic alphabet
ܐܣܝܐ ܡܥܪܒܝܬܐ	Western Asia
ܙܡܪܐ	Singing
ܫܓܠܐ	Hopscotch
ܩܠܦܬܐ ܕܒܣܡܐ	Cinnamon
ܡܙܬܐ	Hair
ܠܫܢܐ ܐܪܡܝܐ	Aramaic language
ܨܦܪܐ (ܛܝܪܐ)	Sparrow
ܐܦܣܩܘܦܐ	Bishop
ܓܒܐ ܕܝܡܘܩܪܛܝܐ (ܐܘܚܕܢܐ ܡܚܝܕܐ)	Democratic Party (United States)
ܒܝܐܛܪܝܟܣ ܕܒܝܬ ܗܘܠܢܕܝܐ	Beatrix of the Netherlands
ܡܠܟܘܬܐ ܕܗܘܠܢܕܐ	Kingdom of the Netherlands
ܐܒܪܝܠ ܠܐܒܝܢ	Avril Lavigne
ܪܝܫ ܩܘܛܢܝܘܬܐ	President
ܐܚܐ (ܒܝܬܝܘܬܐ)	Sibling
ܐܪܒܝܐ	Arabian Peninsula
ܡܪܩܘܣ ܐܘܢܓܠܣܛܐ	Mark the Evangelist
ܥܘܠܐ	Embryo
ܠܫܢܐ ܕܗܟܐ	Hakka Chinese
ܐܪܡܝܐ ܕܒܬܠܡܘܕ ܒܒܠܝܐ	Jewish Babylonian Aramaic
ܫܘܫܡܢܝܬܐ (ܝܥܝܬܐ)	Elettaria cardamomum
ܠܫܢܐ ܕܓܐܢ	Gan Chinese
ܒܝܬ ܥܬܩܐ	Museum
ܐܠܦܒܝܬ ܥܒܪܝܐ	Hebrew alphabet
ܠܫܢܐ ܣܘܪܝܝܐ	Syriac language
ܒܪܩܐ	Lightning
ܐܝܕܐ	Hand
ܫܡܥܘܢ ܟܐܦܐ	Saint Peter
ܬܠ ܐܒܝܒ	Tel Aviv
ܒܐܠܦܐܪܐܝܣܘ	Valparaíso
ܛܘܪܝܐ	Turoyo language
ܠܫܢܐ ܫܝܡܝܐ	Semitic languages
ܚܘܣܢܝ ܡܘܒܐܪܟ	Hosni Mubarak
ܘܐܟܐܩܐ	Oaxaca
ܚܐܘܬܐ	Butter
ܐܘܢܓܠܝܘܢ	Gospel
ܠܫܢܐ ܕܘܘ	Wu Chinese
ܪܘܛܪܕܐܡ	Rotterdam
ܩܪܛܐ	Crete
ܐܘܪܚܐ	Road
ܩܘܪܨܐ ܚܠܝܨܐ	Compact disc
ܨܒܥܐ	Digit (anatomy)
ܦܪܬ	Euphrates
ܩܝܘܛܘ	Kyoto
ܥܣܪܐ ܦܘܩܕܢܐ	Ten Commandments
ܒܪܩܩܐ ܦܪܣܝܐ	Persian Gulf
ܚܠܐ (ܕܚܝܚܐ)	Sand
ܘܪܕܐ	Rose
ܓܙܪܬܐ ܝܒܫܢܝܬܐ	Peninsula
ܐܘܪܝܬܐ	Torah
ܟܘܘܝܬ (ܡܕܝܢܬܐ)	Kuwait City
ܡܚܙܝܬܐ	Mirror
ܥܡܐ ܥܪܒܝܐ	Arabs
ܟܘܬܐ	Window
ܠܫܢܐ ܝܘܢܝܐ ܥܬܝܩܐ	Ancient Greek
ܠܫܢܐ ܐܟܕܝܐ	Akkadian language
ܕܩܠܬ	Tigris
ܐܬܪܘܬܐ ܕܐܬܪܘܬܐ ܡܚܝܕܐ ܕܐܡܪܝܩܐ	U.S. state
ܡܥܡܘܕܝܬܐ	Baptism
ܩܘܢܓܘ	Congo
ܐܝܢܛܪܠܝܢܓܘܐ	Interlingua
ܐܘܪܟܐ	Length
ܚܠܡܐ	Dream
ܠܫܢܐ ܩܪܕܘܝܐ	Kurdish languages
ܩܡܚܐ	Flour
ܕܢ ܗܐܟ	The Hague
ܠܫܢܐ ܦܘܢܝܩܝܐ	Phoenician language
ܣܝܢܝ (ܓܙܪܬܐ ܝܒܫܢܝܬܐ)	Sinai Peninsula
ܟܪܘܙܘܬܐ ܕܝܘܚܢܢ	Gospel of John
ܬܪܥܐ (ܒܒܐ)	Door
ܪܝܗܐܢܐ	Rihanna
ܛܦܪܐ	Nail (anatomy)
ܐܦܐ	Face
ܨܨܐ (ܨܢܥܬܐ)	Nail (fastener)
ܙܝܬܐ	Olive
ܬܠܝܬܝܘܬܐ	Trinity
ܓܠܠܐ	Wave
ܟܬܒܬܐ	Writing
ܪܘܚܐ ܕܩܘܕܫܐ	Holy Spirit
100 (ܡܢܝܢܐ)	100 (number)
ܒܘܪܟܐ	Knee
ܫܘܩܐ (ܬܐܓܪܘܬܐ)	Market (economics)
ܠܫܢܐ ܥܪܒܝܐ ܝܗܘܕܝܐ	Judeo-Arabic languages
ܒܠܛܝ	Bălți
1000000 (ܡܢܝܢܐ)	Million
ܛܐܒܐ	News
ܐܫܬܐ (ܐܣܝܘܬܐ)	Fever
ܩܫܬܐ ܓܪܒܝܝܬܐ ܕܐܪܥܐ	Northern Hemisphere
ܡܡܘܢܐ ܕܡܝܟܪܐ	Microeconomics
ܠܝܕܣ	Leeds
ܥܘܩܒܪܐ	Mouse
ܦܘܪܬܩܠܐ	Orange (colour)
ܒܪܩܩܐ	Bay
ܒܝܬ ܩܒܘܪܐ	Cemetery
ܐܣܝܐ (ܫܕܬܐ)	Physician
ܡܩܕܘܢܝܐ	Macedonia
ܦܢܛܝܩܘܣܛܝ	Pentecost
ܫܓܕܬܐ	Almond
ܟܪܘܙܘܬܐ ܕܠܘܩܐ	Gospel of Luke
ܩܘܢܣܦܣܝܘܢ (ܗܘܦܪܟܝܐ)	Concepción Province, Chile
ܢܗܪܐ ܕܝܘܪܕܢܢ	Jordan River
ܣܦܪ ܝܡܐ	Beach
ܐܢܛܐܠܝܐ (ܗܘܦܪܟܝܐ)	Antalya Province
ܦܪܟܣܝܣ ܕܫܠܝܚܐ	Acts of the Apostles
ܥܪܘܒܬܐ ܕܚܫܐ	Good Friday
ܚܒܘܫܝܐ	Prison
ܐܕܢܐ (ܗܘܦܪܟܝܐ)	Adana Province
ܝܘܚܢܢ ܡܥܡܕܢܐ	John the Baptist
ܨܠܝܒܐ	Cross
ܚܙܒܐܠܠܗ	Hezbollah
ܒܝܬ ܓܒܝܢܐ	Forehead
ܡܙܡܘܪܐ	Psalms
ܐܬܘܪ	Assyria
ܒܢܝܢܐ	Building
ܚܠܒ (ܡܕܝܢܬܐ)	Aleppo
ܩܫܬܐ ܬܝܡܢܝܬܐ ܕܐܪܥܐ	Southern Hemisphere
ܚܠܐ (ܚܡܪܐ)	Vinegar
ܒܝܬ ܕܝܢܐ	Court
ܚܝܦܐ	Haifa
ܪܡܕܐܢ	Ramadan
ܫܛܪܐ ܬܐܒܝܠܝܐ ܕܓܝܢܝܣ	Guinness World Records
ܟܘܕܢܝܐ	Mule
ܒܪܩܩܐ ܕܥܕܢ	Gulf of Aden
ܓܠܝܢܐ ܕܝܘܚܢܢ	Book of Revelation
ܐܫܬܐ (ܝܘܠܦܢ ܨܪܘܝܘܬܐ)	Buttocks
ܨܠܘܬܐ ܡܪܝܡܝܬܐ	Hail Mary
ܝܩܕܐ	Fuel
ܝܨܝܠܐ	Elbow
ܟܗܢܐ	Priest
ܕܩܢܐ	Beard
ܢܒܝܐ	Prophet
ܐܘܪܟܝܣܛܪܐ	Orchestra
1000 (ܡܢܝܢܐ)	1000 (number)
ܣܘܦܝܐ ܪܘܛܐܪܘ	Sofia Rotaru
ܬܫܢܝܬܐ	Insurance
ܛܘܟܣܐ	Organization
ܣܦܪܓܠܐ	Quince
ܐܢܕܪܐܘܣ ܫܠܝܚܐ	Andrew the Apostle
ܬܪܥܣܪ ܫܠܝܚܐ	Apostle (Christian)
ܢܩܒܬܐ	Female
ܕܪܥܐ (ܗܕܡܐ)	Arm
ܡܬܝ ܡܟܣܐ	Matthew the Apostle
ܬܐܘܡܐ ܫܠܝܚܐ	Thomas the Apostle
ܦܝܠܝܦܘܣ ܫܠܝܚܐ	Philip the Apostle
ܒܘܪܨܐ (ܗܘܦܪܟܝܐ)	Bursa Province
ܐܝܘܐܢܢܝܣ ܦܘܡܐ ܕܕܗܒܐ	John Chrysostom
ܒܢܝܡܝܢ ܢܬܢܝܗܘ	Benjamin Netanyahu
ܐܪܬܒܝܢ (ܗܘܦܪܟܝܐ)	Artvin Province
ܓܒܝܢܐ	Eyebrow
ܫܘܪܬܐ	Navel
ܐܕܝܐܡܐܢ (ܗܘܦܪܟܝܐ)	Adıyaman Province
ܝܗܘܕܐ ܫܠܝܚܐ	Jude the Apostle
ܒܪܬܘܠܡܝ ܫܠܝܚܐ	Bartholomew the Apostle
ܝܥܩܘܒ ܒܪ ܙܒܕܝ	James, son of Zebedee
ܝܘܚܢܢ ܫܠܝܚܐ	John the Apostle
ܡܬܝܐ ܫܠܝܚܐ	Saint Matthias
ܝܥܩܘܒ ܒܪ ܚܠܦܝ	James, son of Alphaeus
ܕܟܪܐ	Male
ܐܝܓܢܐܛܝܘܣ ܢܘܪܢܐ	Ignatius of Antioch
ܪܕܝܘܗܕ	Radiohead
ܒܫܐܪ ܐܠܐܣܕ	Bashar al-Assad
ܪܚܝܐ	Mill (grinding)
ܨܘܡܐ	Fasting
ܕܝܪܐ	Monastery
ܠܡܐܢܐ	Port
ܡܠܚܐ (ܢܘܛܐ)	Sailor
ܐܦܝܘܢ (ܗܘܦܪܟܝܐ)	Afyonkarahisar Province
ܡܝܟܐܝܠ (ܡܠܐܟܐ)	Michael (archangel)
ܒܝܠܓܝܟ (ܗܘܦܪܟܝܐ)	Bilecik Province
ܒܝܬ ܥܬܩܐ ܕܐܣܪܐܝܠ	Israel Museum
ܒܐܠܝܟܣܝܪ (ܗܘܦܪܟܝܐ)	Balıkesir Province
ܒܝܬ ܝܠܕܐ	Birthday
ܬܘܠܥܐ	Worm
ܬܘܩܢ ܓܝܕܝܐ ܩܢܛܪܘܢܝܐ	Central nervous system
ܛܘܪܐ ܕܓܠܝܕܐ	Iceberg
ܡܫܠܡܢܐ	Muslim
ܢܢܥܐ	Mentha
ܩܠܒܐ:Commonscat	Template:Commons category
ܒܨܪܐ (ܡܕܝܢܬܐ)	Basra
ܐܓܪܬܐ ܕܠܘܬ ܪܗܘܡܝܐ	Epistle to the Romans
ܬܡܪܐ ܕܥܝܢܐ	Eyelid
ܗܘܦܪܟܝܣ ܕܛܘܪܩܝܐ	Provinces of Turkey
ܡܪܝ ܓܝܘܪܓܝܣ ܣܗܕܐ	Saint George
ܐܣܘܬܐ ܕܠܐ ܬܚܘܡܐ	Médecins Sans Frontières
ܐܪܙܐ (ܡܫܝܚܝܘܬܐ)	Sacrament
ܐܓܪܬܐ ܕܠܘܬ ܦܝܠܝܦܣܝܐ	Epistle to the Philippians
ܐܢܛܘܠܝܐ	Anatolia
ܡܫܝܚܐ	Messiah
ܚܫܡܝܬܐ ܐܚܪܝܬܐ	Last Supper
ܩܢܘܢܐ ܕܗܝܡܢܘܬܐ	Apostles' Creed
ܒܢܝ ܐܝܣܪܐܝܠ	Israelites
ܡܓܘܫܐ ܬܠܬܐ	Biblical Magi
ܝܘܚܢܢ ܕܪܡܣܘܩܝܐ	John of Damascus
ܒܒܐ (ܬܪܥܐ)	Gate
ܣܕܪܐ:ܡܠܟܐ	Category:Kings
ܠܫܢܐ ܕܡܝܢ	Min Chinese
ܥܘܪܡܫܐ	Pollution
ܒܒܠ (ܗܘܦܪܟܝܐ)	Babil Governorate
ܫܘܡܪܐ	Soot
ܐܫܩܠܘܢ	Ashkelon
ܕܘܢܒܐ	Tail
ܩܐܕܣܝܐ (ܗܘܦܪܟܝܐ)	Al-Qādisiyyah Governorate
ܡܪܝܡ ܡܓܕܠܝܬܐ	Mary Magdalene
ܡܪܪܬܐ	Gallbladder
ܥܕܬܐ ܟܠܕܝܬܐ ܩܬܘܠܝܩܝܬܐ	Chaldean Catholic Church
ܥܕܬܐ ܡܪܘܢܝܬܐ	Maronite Church
ܡܪܬܐ	Bile
ܩܘܪܒܢܐ	Eucharist
ܐܕܡ	Adam
ܐܘܘܫܐ	Earwax
ܕܡܥܬܐ	Tears
ܥܡܬܐ (ܒܝܬܝܘܬܐ)	Aunt
ܥܡܐ (ܒܝܬܝܘܬܐ)	Uncle
ܟܘܬܝܢܐ	Shirt
ܝܘܗܐܢ ܐܠܙܪ	Johann Georg Elser
ܒܝܢܓܘܠ (ܗܘܦܪܟܝܐ)	Bingöl Province
ܥܡܐ ܐܪܡܢܝܐ	Armenians
ܐܝܕܝܢ (ܗܘܦܪܟܝܐ)	Aydın Province
ܩܛܠܥܡܐ ܐܪܡܢܝܐ	Armenian Genocide
ܐܡܐܣܝܐ (ܗܘܦܪܟܝܐ)	Amasya Province
ܦܪܝܙܘܢ ܒܪܝܟ	Prison Break
ܐܓܪܝ (ܗܘܦܪܟܝܐ)	Ağrı Province
ܒܘܪܕܘܪ (ܗܘܦܪܟܝܐ)	Burdur Province
ܐܓܪܬܐ ܩܕܡܝܬܐ ܕܠܘܬ ܩܘܪܢܬܝܐ	First Epistle to the Corinthians
ܝܗܘܕܐ ܣܟܪܝܘܛܐ	Judas Iscariot
ܐܒܪܐ	Feather
ܡܚܪܐ	Engineer
ܚܪܛܘܡܢܐ	Chickpea
ܐܬܪܘܬܐ ܕܫܐܡ	Levant
ܬܪܘܕܐ	Spoon
ܓܒܪܐܝܠ (ܡܠܐܟܐ)	Gabriel
ܓܪܡܦܝܠܐ	Ivory
ܨܘܪ	Tyre, Lebanon
ܒܘܠܘ (ܗܘܦܪܟܝܐ)	Bolu Province
ܙܢܩܐ	Chin
ܨܘܡܐ ܕܐܪܒܥܝܢ	Lent
ܐܓܪܐ ܕܒܢܝܢܐ	Roof
ܒܝܛܠܝܣ (ܗܘܦܪܟܝܐ)	Bitlis Province
ܓܠܝܠܐ	Galilee
ܪܥܡܐ	Thunder
ܡܘܨܠ	Mosul
ܟܪܬܐ	Thumb
ܥܡܐ ܛܘܪܩܝܐ	Turkish people
ܦܐܦܐ ܫܢܘܕܐ ܬܠܝܬܝܐ	Pope Shenouda III of Alexandria
ܒܝܬ ܓܘܣܐ	Bunker
ܒܝܥܬܐ	Egg (food)
ܒܣܕܝܐ	Pillow
ܙܓܐ (ܢܩܘܫܐ)	Bell (instrument)
ܫܒܬܐ (ܝܗܘܕܝܘܬܐ)	Shabbat
ܫܡܝܪܡ	Semiramis
ܫܝܓܪܐ	Gingiva
ܝܗ	Tetragrammaton
ܡܫܝܚܝܐ	Christian
ܟܪܘܙܘܬܐ ܕܡܪܩܘܣ	Gospel of Mark
ܟܟܪܝܬܐ ܕܕܒܫܐ	Honeycomb
ܐܓܪܬܐ ܕܠܘܬ ܩܘܪܢܬܝܐ ܕܬܪܬܝܢ	Second Epistle to the Corinthians
ܫܥܘܬܐ (ܡܠܘܐܐ)	Wax
ܛܥܡܐ	Taste
ܓܢܬ ܫܒܪܐ	Kindergarten
ܝܡܬܐ ܕܓܠܝܠܐ	Sea of Galilee
ܕܝܘܬܐ	Ink
ܡܪܝ ܝܘܣܦ	Saint Joseph
ܠܘܩܐ ܐܘܢܓܠܣܛܐ	Luke the Evangelist
ܐܓܪܬܐ ܕܠܘܬ ܥܒܪܝܐ	Epistle to the Hebrews
ܐܓܪܬܐ ܕܠܘܬ ܓܠܛܝܐ	Epistle to the Galatians
ܡܪܝ ܡܝܟܐܝܠ ܪܒܐ	Michael the Syrian
Ϝ	Digamma
Ϙ	Koppa (letter)
ܥܛܡܐ	Thigh
ܬܢܢܐ	Smoke
ܡܘܚܘܢܐ	Cerebellum
ܐܓܪܬܐ ܕܠܘܬ ܩܘܠܣܝܐ	Epistle to the Colossians
ܐܓܪܬܐ ܕܝܥܩܘܒ	Epistle of James
ܐܓܪܬܐ ܩܕܡܝܬܐ ܕܝܘܚܢܢ	First Epistle of John
ܐܓܪܬܐ ܕܠܘܬ ܦܝܠܡܘܢ	Epistle to Philemon
ܐܓܪܬܐ ܕܠܘܬ ܬܣܠܘܢܝܩܝܐ ܕܬܪܬܝܢ	Second Epistle to the Thessalonians
ܐܓܪܬܐ ܩܕܡܝܬܐ ܕܠܘܬ ܬܣܠܘܢܝܩܝܐ	First Epistle to the Thessalonians
ܐܓܪܬܐ ܩܕܡܝܬܐ ܕܦܛܪܘܣ	First Epistle of Peter
ܐܓܪܬܐ ܕܬܪܬܝܢ ܕܦܛܪܘܣ	Second Epistle of Peter
ܐܓܪܬܐ ܩܕܡܝܬܐ ܕܠܘܬ ܛܝܡܬܐܘܣ	First Epistle to Timothy
Ϛ	Stigma (letter)
ܡܪܕܝܢ (ܗܘܦܪܟܝܐ)	Mardin Province
ܚܡܨ (ܡܕܝܢܬܐ)	Homs
Ͳ	Sampi
ܘܐܟܐܩܐ ܕܝ ܟܘܐܪܝܣ	Oaxaca, Oaxaca
ܐܓܪܬܐ ܕܬܪܬܝܢ ܕܝܘܚܢܢ	Second Epistle of John
ܐܓܪܬܐ ܕܬܠܬ ܕܝܘܚܢܢ	Third Epistle of John
ܐܓܪܬܐ ܕܝܗܘܕܐ	Epistle of Jude
ܐܓܪܬܐ ܕܠܘܬ ܛܝܡܬܐܘܣ ܕܬܪܬܝܢ	Second Epistle to Timothy
ܐܓܪܬܐ ܕܠܘܬ ܛܛܘܣ	Epistle to Titus
ܫܝܪܢܐܟ (ܡܕܝܢܬܐ)	Şırnak
ܐܟܪܐ	Farmer
ܓܘܣܢܐ	Refugee
Ϻ	San (letter)
ܩܠܝܕܐ (ܡܐܢܐ)	Key (lock)
ܥܕܥܐܕܐ	Festival
ܐܪܒܝܠ (ܡܕܝܢܬܐ)	Erbil
ܪܓܠܐ	Leg
ܚܨܐ	Human back
ܐܠܝܐ ܢܒܝܐ	Elijah
ܙܚܘܪܝܬܐ (ܬܘܠܥܬܐ)	Bombyx mori
ܚܘܦܝܐ	Eclipse
ܡܚܛܐ	Sewing needle
ܥܠܡܐ ܥܪܒܝܐ	Arab world
ܦܓܘܕܬܐ	Bridle
ܩܛܡܐ	Ash (analytical chemistry)
ܢܘܗܕܪܐ (ܡܕܝܢܬܐ)	Dohuk
ܨܒܥܐ ܕܪܓܠܐ	Toe
ܠܘܚܐ (ܚܫܘܒܬܐ)	Tablet computer
ܪܒܝܬܐ	Usury
ܡܟܝܪܘܬܐ	Engagement
ܫܘܪܡܐ	Rectum
ܐܪܡܝܐ (ܢܒܝܐ)	Jeremiah
ܬܐܡܐ	Twin
ܬܠܝܦܐ	Eyelash
ܫܥܬܐ ܕܐܪܥܐ	Earth Hour
ܦܪܡܝܬܐ	Button
ܟܘܟܒܐ ܕܕܘܝܕ	Star of David
ܡܪܝ ܐܣܛܦܢܘܣ	Saint Stephen
ܡܫܡܫܢܐ	Deacon
ܢܓܒ	Negev
ܟܢܥܢ	Canaan
ܢܘܨܦܐ	Twilight
ܒܝܢܐ	Tamarix
ܬܓܪܝܬ	Tikrit
ܚܠܐ (ܥܦܪܐ)	Dust
ܬܪܥܐ ܕܕܡܐ	Bleeding
ܥܪܒܐ ܕܫܡܫܐ	Sunset
ܐܡܝܫܐ	Swamp
ܡܨܥܝܬܐ (ܨܒܥܐ)	Middle finger
ܣܒܐ (ܒܝܬܝܘܬܐ)	Grandparent
ܩܘܪܨܠܐ	Ankle
ܒܪ ܐܝܕܐ	Glove
ܢܫܒܐ ܕܥܝܢܐ	Retina
ܬܘܩܢ ܓܝܕܝܐ ܡܚܕܘܪܝܐ	Peripheral nervous system
ܛܝܢܐ	Mud
ܓܓܘܠܬܐ	Calvary
ܗܢܝܢܐ (ܡܡܫܚܘܬܐ)	Interest
ܐܫܘܪ ܒܢܐܦܠ	Ashurbanipal
ܓܕܫܐ	Accident
ܦܛܪܝܪܟܐ	Patriarch
ܚܟܐ	Palate
ت	Taw
ث	Ṯāʾ
خ	Ḫāʾ
ذ	Ḏāl
ܪܓܫܐ	Sense
ܟܪܟ ܣܠܘܟ (ܡܕܝܢܬܐ)	Kirkuk
ܒܒܬܐ	Pupil
ܩܒܪܐ	Grave
ܠܒܘܢܬܐ	Frankincense
ܚܡܬ (ܡܕܝܢܬܐ)	Hama
ܝܫܛܐ	Esophagus
ܟܝܣܐ ܕܐܫܟܐ	Scrotum
ܕܒܪܐ	Rural area
ܚܪܘܫܬܐ	Trachea
ܓܪܡܐ ܕܥܛܡܐ	Femur
ܒܪܐ (ܒܝܬܝܘܬܐ)	Son
ܫܚܘܪܐ	Charcoal
ܐܘܟܡܐ ܕܥܝܢܐ	Iris (anatomy)
ܫܦܠܘܗܝ ܕܢܝܠܘܣ	Nile Delta
ܐܘܪܡܝܐ	Urmia
Ϸ	Sho (letter)
ܓܙܪܬܐ ܐܝܘܠܝܬܐ	Aeolian Islands
ܓܒܐ ܕܒܥܬ	Ba'ath Party
ܦܩܪܐ	Spinal vertebra
ܒܪ ܩܠܐ	Echo
ܟܝܡܪܐ	Chimera (mythology)
ܠܘܓܡܐ	Maxilla
ܛܪܘܢܐ	Dictator
ܬܝܒܘܬܐ	Sacrament of Penance (Catholic Church)
ܡܛܘܚܬܐ	Index finger
ܩܒܠܘܬܐ	Midwife
ܐܪܙܝܪܐ	Starling
ܣܦܪܐ (ܩܢܘܢܝܐ)	Jurist
Ͱ	Heta
ܥܡܐ ܐܪܡܝܐ	Arameans
ܟܢܘܢܬܐ (ܫܪܝܬܐ)	Wrist
ܐܒܐ (ܐܠܗܐ)	God the Father
ܐܢܒܐܪ (ܗܘܦܪܟܝܐ)	Al Anbar Governorate
ܡܪܕܝܢ (ܡܕܝܢܬܐ)	Mardin
ܣܪܛܢܐ	Cancer (disambiguation)
ܡܘܪܘܢ	Confirmation
ܚܠܡܬܐ	Nipple
ܢܘܠܐ ܕܓܘܓܝ	Spider web
ܐܫܥܝܐ	Isaiah
ܒܪܬ ܙܘܓܐ (ܒܝܬܝܘܬܐ)	Wife
ܒܝܬ ܟܬܒܐ ܐܬܪܝܐ ܕܐܣܪܐܝܠ	National Library of Israel
ܥܪܫܐ	Molar (tooth)
ܢܝܢܘܐ (ܗܘܦܪܟܝܐ)	Nineveh Governorate
ܢܘܗܕܪܐ (ܗܘܦܪܟܝܐ)	Dohuk Governorate
ܘܐܣܛ (ܗܘܦܪܟܝܐ)	Wasit Governorate
ܨܠܐܚ ܐܠܕܝܢ (ܗܘܦܪܟܝܐ)	Saladin Governorate
ܟܢܘܫܝܐ ܕܠܫܢܐ ܥܒܪܝܐ	Academy of the Hebrew Language
ܥܘܕ	Oud
ܒܓܕܐܕ (ܗܘܦܪܟܝܐ)	Baghdad Governorate
ܣܪܓܐ	Saddle
ܒܨܪܐ (ܨܒܥܐ)	Ring finger
ܩܛܝܣܦܘܢ	Ctesiphon
ܟܒܘܫܐ	Nightmare
ܢܓܦ (ܗܘܦܪܟܝܐ)	Najaf Governorate
ܟܪܟ ܣܠܘܟ (ܗܘܦܪܟܝܐ)	Kirkuk Governorate
ܕܢܚܐ ܕܫܡܫܐ	Sunrise
ܬܐܪܬܐ	Conscience
ܒܨܪܐ (ܗܘܦܪܟܝܐ)	Basra Governorate
ܡܫܚܐ ܕܟܪܝܗܐ	Anointing of the Sick
ܦܠܫܬ	Philistines
ܐܠܥܐ (ܝܘܠܦܢ ܨܪܘܝܘܬܐ)	Rib
ܥܕܬܐ ܐܝܓܘܦܛܝܬܐ	Coptic Orthodox Church of Alexandria
ܐܢܛܝܘܟܝܐ	Antioch
ܐܦܪܝܡ ܣܘܪܝܝܐ	Ephrem the Syrian
ܐܝܙܝܕܝܐ	Yazidis
ܪܝܫܘܢ ܠܬܣܝܘܢ	Rishon LeZion
ܟܢܪܐ	Lyre
ܥܕܬܐ ܕܡܕܢܚܐ ܕܐܬܘܪܝܐ	Assyrian Church of the East
ܬܠܐ ܕܚܕ ܐܝܠܢ	One Tree Hill (TV series)
ܡܘܪܐ	Myrrh
ܦܕܪܠܝܐ	Federalism
ܐܠܝܫܥ	Elisha
ܗܟܐܪܝ (ܡܕܝܢܬܐ)	Hakkâri
ܣܢܚܪܝܒ	Sennacherib
ܩܘܪܝܐܠܝܣܘܢ	Kyrie
ܟܢܘܫܝܐ ܕܐܣܪܐܝܠ ܕܝܘܠܦܢܐ ܘܐܢܫܝܬܐ	Israel Academy of Sciences and Humanities
ܣܘܟܢܐ	Rudder
ܥܕܬܐ ܣܘܪܝܝܬܐ ܐܪܬܘܕܟܣܝܬܐ	Syriac Orthodox Church
ܟܣܬܐ	Fodder
ܩܡܫܠܝ	Qamishli
ܡܘܬܢܐ (ܗܘܦܪܟܝܐ)	Muthanna Governorate
ܒܪ ܙܘܓܐ (ܒܝܬܝܘܬܐ)	Husband
ܡܝܫܢ (ܗܘܦܪܟܝܐ)	Maysan Governorate
ܣܘܠܝܡܐܢܝܐ (ܗܘܦܪܟܝܐ)	Sulaymaniyah Governorate
ܐܪܒܝܠ (ܗܘܦܪܟܝܐ)	Erbil Governorate
ܚܠܒ (ܗܘܦܪܟܝܐ)	Aleppo Governorate
ܟܪܒܠܐܐ (ܗܘܦܪܟܝܐ)	Karbala Governorate
ܦܪܨܘܦܐ	Person
ܕܝ ܩܐܪ (ܗܘܦܪܟܝܐ)	Dhi Qar Governorate
ܐܢܕܪܢܝܩ ܡܐܪܓܐܪܝܐܢ	Andranik Margaryan
ܡܡܠܠܘܬ ܐܠܗܘܬܐ	Christian theology
ܓܘܙܐ	Juglandaceae
ܕܝܐܠܐ (ܗܘܦܪܟܝܐ)	Diyala Governorate
ܟܒܒ	Khabab
ܩܪܫܬܐ	Ceiling
ض	Ḍād
ظ	Ẓāʾ
غ	Ghayn
ܚܨܪܐ	Little finger
ܐܡܬܐ (ܝܘܠܦܢ ܨܪܘܝܘܬܐ)	Forearm
ܣܝܢܝ	Sinai (disambiguation)
ܬܐܘܡܐ	Thomas
ܐܝܒܪܝܐ	Iberia (disambiguation)
ܚܡܬ (ܗܘܦܪܟܝܐ)	Hama Governorate
ܟܢܘܢܬܐ ܕܐܝܕܐ	Carpus
ܐܝܣܪܐܝܠ (ܬܘܚܡܐ ܐܚܪܢܐ)	Israel (disambiguation)
ܡܠܐܟܐ	Angel
ܫܢܬܐ ܦܫܝܛܬܐ	Common year
ܡܣܘܪܩܐ ܕܐܝܕܐ	Metacarpus
ܡܠܟܘܬܐ ܕܒܝܬ ܥܣܪ ܥܝܢܐ	Osroene
ܕܪܥܐ (ܡܕܝܢܬܐ)	Daraa
ܨܕܥܐ	Temple (anatomy)
ܣܘܣܝܐ ܐܝܣܠܢܕܝܐ	Icelandic horse
ܩܠܐ	Note
ܛܘܘܝܐ	Grilling
ܓܪܡܐ	Bone
ܒܪܝܐܢܝ	Biryani
ܠܒܠܒܬܐ	Palatine uvula
ܙܓܐ ܕܣܦܝܢܬܐ	Ship's bell
ي	Yodh
ܥܪܒܝܐ	Arab (disambiguation)
ܓܝܕܐ ܕܓܢܫܝܐ	Sciatic nerve
ܒܪܬܐ (ܒܝܬܝܘܬܐ)	Daughter
ܗܪܗܪܐ	Mirage
ܚܣܟܗ (ܡܕܝܢܬܐ)	Al-Hasakah
ܒܝܬ ܢܗܪܝܢ ܥܠܝܬܐ	Upper Mesopotamia
ܛܐܪܩ ܥܙܝܙ	Tariq Aziz
ܡܣܘܪܩܐ ܕܪܓܠܐ	Metatarsus
ܥܪܩ	Arak (drink)
ܫܠܦܐ	Blade
ܛܘܪ ܠܒܢܢ	Mount Lebanon
ܐܙܟ	İdil
ܐܘܛܪܝܟܛ	Utrecht (disambiguation)
ܟܝܢܐ	Nature (disambiguation)
ܡܪܝ ܐܕܝ ܬܪܝܢܐ	Addai II Giwargis
ܪܗܘܡܐ	Rum (disambiguation)
ܓܐܝܘܣ	Gaius
ܩܝܒܩ	Quebec (disambiguation)
ܩܕܠܐ	Nape
ܥܡܐ ܐܬܘܪܝܐ/ܣܘܪܝܝܐ	Assyrian people
ܛܘܪܐ ܕܣܝܢܝ	Mount Sinai
ܬܐܘܡܐ ܐܘܕܘ	Toma Audo
ܦܘܪܬܥܢܐ	Flea
ܫܡܣܕܝܢ	Şemdinli
ܟܪܘܙܘܬܐ ܕܡܬܝ	Gospel of Matthew
ܡܕܝܢܬܐ ܡܝܬܬܐ	Dead Cities
ܐܬܘܪܝܐ	Assyrian
ܢܘܗܕܪܐ	Dohuk (disambiguation)
ܐܓܪܬܐ ܕܠܘܬ ܐܦܣܝܐ	Epistle to the Ephesians
ܚܡܬ	Hama (disambiguation)
10000 (ܡܢܝܢܐ)	10000 (number)
ܒܢܦܫܐ	Violet (color)
ܢܨܪܬ	Nazareth
ܥܕܬܐ ܥܬܝܩܬܐ ܕܡܕܢܚܐ	Ancient Church of the East
ܟܬܒܐ ܕܡܘܪܡܘܢ	Book of Mormon
ܠܝܢܕܐ ܓܘܪܓ	Linda George (Assyrian singer)
ܐܝܓܢܐܛܝܘܣ ܡܘܫܐ ܩܕܡܝܐ ܕܐܘܕ	Ignatius Moses I Daoud
ܒܫܐܪܐ ܦܛܪܘܣ ܐܠܪܐܥܝ	Bechara Boutros al-Rahi
ܡܪܝ ܦܘܠܝܩܪܦܘܣ ܐܘܓܝܢ ܐܝܕܝܢ	Polycarpus Augin Aydin
ܥܡܢܘܐܝܠ ܬܠܝܬܝܐ ܕܠܝ	Emmanuel III Delly
ܥܡܘ ܒܒܐ	Ammo Baba
ܥܡܘܕܐ ܦܩܪܝܐ	Vertebral column
ܒܝܬ ܫܥܝܐ	Stadium
ܓܘܕ ܫܪܠܘܛ	Good Charlotte
ܒܪ ܨܘܪܐ	Collar (clothing)
ܚܣܚܘܣܐ	Cartilage
ܛܘܪ ܥܒܕܝܢ	Tur Abdin
ܡܪܝ ܩܘܪܝܩܘܣ ܣܗܕܐ ܘܕܝܘܠܝܛܐ ܝܡܗ	Quriaqos and Julietta
ܐܝܣܛܢܒܘܠ (ܗܘܦܪܟܝܐ)	Istanbul Province
ܝܘܢܝܐ	Greeks
ܥܢܟܒܐ	Ankawa
ܓܗܢܐ	Gehenna
ܝܥܩܘܒ ܒܘܪܕܥܢܐ	Jacob Baradaeus
ܐܓܢܛܝܘܣ ܝܘܣܦ ܬܠܝܬܝܐ ܝܘܢܢ	Ignatius Joseph III Yonan
ܡܪܝ ܕܢܚܐ ܪܒܝܥܝܐ	Dinkha IV
ܬܠܫܝܬܐ ܕܩܛܠܐ ܕܐܕܘܠܦ ܗܝܛܠܪ	Assassination attempts on Adolf Hitler
ܚܟܐܪܝ	Hakkari
ܬܐܓܘܪܬܐ	Trade
ܡܛܟܣܬܐ ܐܬܘܪܝܬܐ ܕܝܡܩܪܛܝܬܐ	Assyrian Democratic Organization
ܡܪܝ ܐܦܪܝܡ	Aprem Mooken
ܐܪܕܢ	Araden
ܡܬܐ	Heimat
ܫܝܪܢܐܟ (ܗܘܦܪܟܝܐ)	Şırnak Province
ܥܘܩܣܐ	Stinger
ܟܗܢܘܬܐ	Holy orders
ܚܒܘܪ	Khabur River
ܗܕܡܐ ܓܘܝܐ	Organ (anatomy)
ܡܥܠܘܠܐ	Ma'loula
ܐܘܪܘܦܐ	Europa
ܡܕܝܕ	Midyat
ܙܘܥܐ ܕܝܡܘܩܪܛܝܐ ܐܬܘܪܝܐ	Assyrian Democratic Movement
ܐܣܝܪܝܣܩܐ	Assyriska FF
ܥܕܬܐ ܣܘܪܝܝܬܐ ܩܬܘܠܝܩܝܬܐ	Syriac Catholic Church
ܡܘܕܟܐ	Seasoning
ܥܨܘܒܐ	Surgeon
ܐܘܣܛܪܠܝܐ	Australia (disambiguation)
ܡܦܩܬܐ ܦܫܝܛܬܐ	Peshitta
ܐܪܚܘܬܐ	Hospitality
ܫܪܓܐ ܕܢܦܛܐ	Oil lamp
ܚܘܐ	Eve
ܗܘܦܪܟܝܣ ܕܥܝܪܐܩ	Governorates of Iraq
ܪܘܡܪܡܐ	Roomrama
ܩܛܠܥܡܐ ܐܬܘܪܝܐ	Assyrian genocide
ܚܬܢܐ (ܒܝܬܝܘܬܐ)	Bridegroom
ܒܝܬ ܟܬܒܐ ܕܐܫܘܪ ܒܢܐܦܠ	Library of Ashurbanipal
ܣܪܦܝܘܢ	Sacramentary of Serapion of Thmuis
ܒܕܘܩܐ	Scouting
ܥܘܕܪܢܐ:ܚܒܝܫܬ̈ܐ	Help:Contents
ܓܦܬܐ	Vine
ܡܝܟܐܝܠ	Michael (disambiguation)
ܙܒܐ	Little Zab
ܣܢܐܓܪܘܬܐ ܕܩܕܝܫܐ	Intercession of saints
ܐܝܓܢܐܛܝܘܣ ܙܟܝ ܩܕܡܝܐ ܥܝܘܐܨ	Ignatius Zakka I Iwas
ܐܣܛܘܡܟܐ	Stomach
ܟܢܘܢܬܐ ܕܪܓܠܐ	Tarsus (skeleton)
ܓܢܬܐ	Garden
ܕܪܓܘܫܬܐ	Bassinet
ܒܪܐ (ܐܠܗܐ)	God the Son
ܚܝܠܐ ܠܒܢܝܐ	Lebanese Forces
ܐܠܩܘܫ	Alqosh
ܐܘܪܗܝ	Edessa
ܢܩܘܫܐ	Semantron
ܘܝܩܝܦܕܝܐ:ܐܝܙܓܕܘܬܐ	Wikipedia:Embassy
ܫܠܝܬܐ	Placenta
ܕܘܢܝ ܓܘܪܓ ܝܘܚܢܢ	Donny George Youkhanna
ܒܝܬ ܛܘܣܐ	Airport
ܒܝܬ ܫܡܪܝܐ	Samaria
ܐܓܢܣ ܡܘ	Agnez Mo
ܡܪܝ ܝܘܣܦ ܚܢܢܝܫܘܥ	Yosip Khnanisho
ܪܘܦܐܝܠ ܩܕܡܝܐ ܒܝܬ ܕܘܝܕ	Raphael I Bidawid
ܦܪܢܣܘ ܗܪܝܪܝ	Franso Hariri
ܓܝܠܒܪܛܘ ܩܘܢܣܦܣܝܘܢ ܕܗ ܓܪܣܝܐ	Gilberto Concepción de Gracia
ܣܕܪܐ:ܓܪܡܢ	Category:Germany
ܣܕܪܐ:ܐܝܛܠܝܐ	Category:Italy
ܣܕܪܐ:ܐܬܪܘܬܐ ܡܚܝܕܐ ܕܐܡܪܝܩܐ	Category:United States
ܣܕܪܐ:ܪܘܣܝܐ	Category:Russia
ܣܕܪܐ:ܩܢܕܐ	Category:Canada
ܣܕܪܐ:ܐܝܣܪܐܝܠ	Category:Israel
ܣܕܪܐ:ܛܘܪܩܝܐ	Category:Turkey
ܣܕܪܐ:ܡܨܪܝܢ	Category:Egypt
ܣܕܪܐ:ܐܝܪܐܢ	Category:Iran
ܕܝܪܐ ܕܡܪܝ ܓܒܪܐܝܠ	Mor Gabriel Monastery
ܥܐܕܐ	Holiday
ܣܕܪܐ:ܥܝܪܐܩ	Category:Iraq
ܣܕܪܐ:ܗܘܠܢܕܐ	Category:Netherlands
ܣܕܪܐ:ܦܘܠܢܕ	Category:Poland
ܣܕܪܐ:ܛܝܪܐ	Category:Birds
ܣܕܪܐ:ܝܥܝܬܐ	Category:Plants
ܣܕܪܐ:ܬܘܕܝܬܐ	Category:Religion
ܣܕܪܐ:ܝܕܥܬܐ	Category:Science
ܩܘܠ ܬܘܪܗ	Kol Torah
ܦܪܡܬܐ ܕܣܡܠܐ	Simele massacre
ܓܪܫܘܢܝ	Garshuni
ܕܝܢܐ (ܡܬܐ)	Diana, Iraq
ܨܘܒܐ	Nusaybin
ܕܪܥܐ (ܗܘܦܪܟܝܐ)	Daraa Governorate
ܢܥܘܡ ܦܐܝܩ	Naum Faiq
ܣܕܪܐ ܕܦܛܪܝܪܟܐ ܕܥܕܬܐ ܕܡܕܢܚܐ	List of Patriarchs of the Church of the East
ܩܠܒܐ:Box-footer	Template:Box-footer
ܕܝܪܐ ܕܟܘܪܟܡܐ	Mor Hananyo Monastery
ܢܩܘܕ	Niqqud
ܚܝܠܐ	Physical strength
ܝܘܠ ܦܘܪܕܒܢܕ	Joël Voordewind
ܡܪܝ ܢܪܣܝ ܕܒܙ	Mar Narsai D'Baz
ܡܪܝܡ (ܚܬܗ ܕܡܘܫܐ)	Miriam
ܨܡܘܪܬܐ	Fang
ܡܪܝ ܬܐܘܡܐ ܕܪܡܘ	Thoma Darmo
ܣܕܪܐ:ܬܘܚܡܐ ܐܚܪܢܐ	Category:Disambiguation pages
ܣܕܪܐ:ܡܫܝܚܝܘܬܐ	Category:Christianity
ܣܕܪܐ:ܐܣܠܐܡ	Category:Islam
ܣܕܪܐ:ܝܗܘܕܝܘܬܐ	Category:Judaism
ܦܩܥܬܐ ܕܢܝܢܘܐ	Nineveh plains
ܠܩܐ ܕܣܦܝܢܬܐ	Oar
ܚܪܒܘܩܬܐ	Buttonhole
ܝܘܚܢܢ ܕܘܠܒܢܝ	Philoxenos Yuhanon Dolabani
ܫܡܥܘܢ ܒܪܨܒܥܐ	Shemon Bar Sabbae
ܬܪܢܓܠܐ	Rooster
ܟܦܫܢܐ	Kefshenne
ܗܠܢܐ	Halana
ܫܩܠܒܕ	Shaqlawa
ܙܚܘܪܝܬܐ (ܓܘܢܐ)	Scarlet (color)
ܐܢܩܪܐ (ܗܘܦܪܟܝܐ)	Ankara Province
ܐܢܕܪܐܘܣ	Andre
ܐܝܪܠܢܕ	Ireland (disambiguation)
ܟܬܒܬ ܐܝܕܐ	Handwriting
ܬܠ ܟܐܦܐ	Tel Keppe
ܝܘܢܢ	Jonah
ܫܡܐ ܕܝܠܝܕܘܬܐ	Name at birth
ܐܨܪܐ	Condiment
ܕܝܪܝܟ	Al-Malikiyah
ܒܪܛܠܐ	Bartella
ܡܪܩܩܐ	Hypochondrium
ܐܓܐ ܦܛܪܘܣ	Agha Petros
ܥܝܒܐ	Nimbus cloud
ܫܘܫܡܬܐ	Sesame
ܣܕܪܐ:ܘܝܩܝܦܕܝܐ	Category:Wikipedia categories
ܣܕܪܐ:ܝܒܫܬܐ	Category:Continents
ܒܓܕܝܕܐ	Bakhdida
ܦܘܙܝ ܗܪܝܪܝ	Fawzi Hariri
ܝܙܦܬܐ	Debt
ܟܠܕܝܐ	Chaldean Christians
ܦܨܝܕܐ	Pond
ܐܪܓܘܢܐ	Purple
ܢܘܪܢܝܐ	Pyramid (geometry)
ܘܝܩܝܦܕܝܐ:HotCat	Wikipedia:HotCat
ܡܪܝ ܓܒܪܐܝܠ	Mor Gabriel
ܓܒܐ ܕܚܐܪܘܬܐ ܕܒܝܬ ܢܗܪܝܢ	European Syriac Union
ܒܛܐ	Duck
ܚܘܝܕܐ ܬܒܝܠܝܐ ܐܬܘܪܝܐ	Assyrian Universal Alliance
ܓܒܐ ܕܦܘܪܩܢܐ ܕܐܬܘܪ	Assyria Liberation Party
ܒܗܪܐ (ܓܠܝܘܢܐ)	Bahra
ܗܝܟܠܐ ܕܫܠܝܡܘܢ	Temple in Jerusalem
ܠܘܝܣ ܪܘܦܐܝܠ ܩܕܡܝܐ ܣܟܘ	Louis Raphael I Sako
ܩܠܒܐ:ܓܕܫܐ ܗܫܝܐ	Template:In the news
ܣܕܪܐ:ܡܟܬܒܢܘܬܐ ܕܐܬܪܘܬܐ	Category:Countries
ܘܝܩܝܦܕܝܐ:ܡܕܒܪܢܐ	Wikipedia:Administrators
ܣܕܪܐ:ܫܕܬܐ	Category:Occupations
ܘܝܩܝܦܕܝܐ:ܒܘܬ̈ܐ	Wikipedia:Bots
ܣܕܪܐ:ܙܒܢܐ	Category:Time
ܣܕܪܐ:ܙܘܙܐ	Category:Money
ܣܕܪܐ:ܝܘܠܦܢ ܨܪܘܝܘܬܐ	Category:Anatomy
ܣܕܪܐ:ܐܣܝܘܬܐ	Category:Medicine
ܬܠܐ ܙܩܝܦܐ	Tesqopa
ܓܘܠܝܢܐ ܓܢܕܐ	Juliana Jendo
ܟܪܡܠܫ	Karamlish
ܫܡܥܘܢ (ܫܡܐ)	Simon (given name)
ܦܪܝܕܘܢ ܐܬܘܪܝܐ	Freydun Atturaya
ܓܒܪܐܝܠ ܐܣܥܕ	Gabriel Asaad
ܡܪܝ ܢܪܣܝ ܬܐܘܡܐ	Narsai Toma
ܗܪܡܙܕ ܐܒܘܢܐ	Hirmis Aboona
ܝܘܢܕܡ ܝܘܣܦ ܟܢܐ	Yonadam Kanna
ܐܫܘܪ ܒܝܬ ܣܪܓܝܣ	Ashur Bet Sargis
ܝܥܩܘܒ ܐܘܓܝܢ ܡܢܢܐ	Eugene Manna
ܡܪܝ ܥܒܕܝܝܫܘܥ ܕܨܘܒܐ	Abdisho bar Berika
ܗܪܝܪ	Harir
ܡܨܪܝܢ	Egypt
ܓܒܥܕܝܢ	Jubb'adin
ܩܠܒܐ:Bot	Template:Bot
ܩܢܕܐ	Canada
ܣܕܪܐ:ܝܘܢ	Category:Greece
ܣܕܪܐ:ܣܘܝܕ	Category:Sweden
ܡܝܟܐܝܠ ܒܝܬ ܣܗܕܐ	Mikhail Sado
ܩܠܒܐ:ܐܫܛܪܘܬܐ	Template:Documentation
ܣܕܪܐ:User languages	Category:Wikipedians by language
ܡܪܝ ܐܦܪܝܡ ܢܬܢܝܐܝܠ	Aprem Natniel
ܐܫܘܪ ܝܘܣܦ	Ashur Yousif
ܦܘܠܚܢܐ	Business
ܩܠܒܐ:Softredirect	Template:Soft redirect
ܩܠܒܐ:Delete	Template:Db
ܒܪܒܥܫܡܝܢ	Barba'shmin
ܡܓܕܠܐ (ܩܪܝܬܐ)	Magdala
ܣܕܪܐ:ܛܟܢܘܠܘܓܝܐ	Category:Technology
ܓܒܪܐܝܠ (ܫܡܐ)	Gabriel (name)
ܡܝܟܐܝܠ (ܫܡܐ)	Michael
ܣܕܪܐ:ܠܫܢܐ	Category:Languages
ܣܕܪܐ:ܩܢܘܢܐ ܕܠܥܙܐ	Category:Grammar
ܘܝܩܝܦܕܝܐ:General disclaimer	Wikipedia:General disclaimer
ܡܪܘܢܝܐ	Maronites
ܣܕܪܐ:Noindexed pages	Category:Noindexed pages
ܘܝܩܝܦܕܝܐ:ܕܘܒܪܐ	Wikipedia:Manual of Style
ܩܠܒܐ:Navbox	Template:Navbox
ܐܝܓܢܐܛܝܘܣ ܐܦܪܝܡ ܬܪܝܢܐ	Ignatius Aphrem II
ܕܪܒܢܕܘܟܐ	Darbandokeh
ܣܕܪܐ:ܩܠܒܐ ܐܬܘܬܐ ܕܐܝܣܘ	Category:Flag templates
ܩܠܒܐ:ܡܦܐܬܐ ܩܠܒܐ	Template:Navbar
ܩܠܒܐ:Clear	Template:Clear
ܘܝܩܝܦܕܝܐ:ܡܟܬܒܘܬܐ ܕܡܓܠܐ ܠܟܠ ܘܝܩܝܦܕܝܐ	Wikipedia:Vital articles
ܣܕܪܐ:ܐܠܝܩܛܪܘܢܝܘܬܐ	Category:Electronics
ܣܕܪܐ:ܝܪܚܐ ܕܫܢܬܐ	Category:Months
ܩܠܒܐ:Babel	Template:Babel
ܩܠܒܐ:Commons	Template:Commons
ܩܠܒܐ:Reflist	Template:Reflist
ܩܠܒܐ:User ar-1	Template:User ar-1
ܩܠܒܐ:User az	Template:User az
ܩܠܒܐ:See also	Template:See also
ܩܠܒܐ:User de	Template:User de
ܩܠܒܐ:User es	Template:User es
ܩܠܒܐ:User en-3	Template:User en-3
ܩܠܒܐ:User en-1	Template:User en-1
ܩܠܒܐ:User en-2	Template:User en-2
ܩܠܒܐ:User en-4	Template:User en-4
ܩܠܒܐ:User en-0	Template:User en-0
ܩܠܒܐ:User en	Template:User en
ܩܠܒܐ:User fa	Template:User fa
ܩܠܒܐ:User fr-1	Template:User fr-1
ܩܠܒܐ:User he-2	Template:User he-2
ܩܠܒܐ:User he-1	Template:User he-1
ܩܠܒܐ:User sk	Template:User sk
ܩܠܒܐ:User tr	Template:User tr
ܩܠܒܐ:User ja	Template:User ja
ܩܠܒܐ:User fr	Template:User fr
ܩܠܒܐ:User he	Template:User he
ܣܕܪܐ:ܐܣܝܐ	Category:Asia
ܣܕܪܐ:ܕܪܐ ܕܥܣܪܝܢ ܘܚܕ	Category:21st century
ܩܠܒܐ:Mod	Template:Mod
ܩܠܒܐ:User sv	Template:User sv
ܩܠܒܐ:Infobox language/codelist	Template:Infobox language/codelist
ܩܠܒܐ:User it	Template:User it
ܣܕܪܐ:ܝܘܡܐ ܕܫܒܘܥܐ	Category:Days of the week
ܣܕܪܐ:ܐܨܪܐ	Category:Condiments
ܩܠܒܐ:ܝܗܘܝܬܐ Peru	Template:Country data Peru
ܩܠܒܐ:ܝܗܘܝܬܐ Paraguay	Template:Country data Paraguay
ܩܠܒܐ:Edit	Template:Edit
ܩܠܒܐ:ܝܗܘܝܬܐ French Guiana	Template:Country data Guyana
ܩܠܒܐ:ܝܗܘܝܬܐ Argentina	Template:Country data Argentina
ܩܠܒܐ:Navbox suite	Template:Navbox suite
ܩܠܒܐ:Category other	Template:Category other
ܩܠܒܐ:ܡܟܬܒܢܘܬܐ ܕܝܦܬܐ	Template:Collapsible list
ܩܠܒܐ:Sidebar	Template:Sidebar
ܩܠܒܐ:Ambox	Template:Ambox
ܩܠܒܐ:Navigation templates	Template:Navigation templates
ܩܠܒܐ:ܐܬܪܐ	Template:Infobox country
ܩܠܒܐ:ܝܬܝܪ	Template:Cat more
ܩܠܒܐ:/box-header	Template:Box-header
ܣܕܪܐ:User en	Category:User en
ܣܕܪܐ:User zh	Category:User zh
ܩܠܒܐ:ܐܠܦܒܝܬ ܥܪܒܝܐ	Template:Arabic-script sidebar
ܣܕܪܐ:User zh-N	Category:User zh-N
ܩܠܒܐ:ܨܢܕܘܩ ܪܡܙܐ2	Template:Infobox
ܩܠܒܐ:User zh	Template:User zh
ܩܠܒܐ:ܐܫܛܪܘܬܐ/ܨܢܕܘܩ ܫܪܝܬܐ	Template:Documentation/start box
ܩܠܒܐ:Documentation/end box2	Template:Documentation/end box2
ܩܠܒܐ:Documentation/start box2	Template:Documentation/start box2
ܩܠܒܐ:ܩܠܒܐ ܐܚܪܝܢܐ	Template:Template other
ܚܒܝܒ ܡܘܣܐ	Habib Mousa
ܩܠܒܐ:ܐܠܦܒܝܬ ܠܐܛܝܢܝܐ	Template:Latin alphabet sidebar
ܣܕܪܐ:ܦܐܦܐ	Category:Popes
ܩܠܒܐ:Pp-template	Template:Pp-template
ܩܠܒܐ:User nl-1	Template:User nl-1
ܩܠܒܐ:User nl-2	Template:User nl-2
ܣܕܪܐ:ܪܝܫܝ ܩܘܛܢܝܘܬܐ	Category:Presidents
ܩܠܒܐ:User ru	Template:User ru
ܩܠܒܐ:IPA	Template:IPA
ܣܕܪܐ:ܗܪܘܡܐ	Category:Spices
ܣܕܪܐ:ܦܠܫܬ	Category:Palestine
ܣܕܪܐ:ܡܠܐܟܐ	Category:Angels
ܣܕܪܐ:ܢܒܝܐ	Category:Prophets
ܩܠܒܐ:Rellink	Template:Rellink
ܩܠܒܐ:Category redirect	Template:Category redirect
ܩܠܒܐ:ܝܗܘܝܬܐ Venezuela	Template:Country data Venezuela
ܩܠܒܐ:ܨܢܕܘܩ ܡܕܒܪܢܐ	Template:Infobox officeholder
ܩܠܒܐ:Sortname	Template:Sortname
ܩܠܒܐ:Border	Template:Border
ܩܠܒܐ:ܡܢܝܢܐ ܕܝܪܚܐ	Template:MONTHNUMBER
ܩܠܒܐ:ܪܕ	Template:Fmbox
ܩܠܒܐ:ܝܗܘܝܬܐ Chile	Template:Country data Chile
ܩܠܒܐ:GUA	Template:GTM
ܚܢܢܝܫܘܥ ܐ ܚܓܝܪܐ	Hnanisho I
ܩܠܒܐ:User nl	Template:User nl
ܩܠܒܐ:ܡܣܦܩ ܩܐܫ	Template:Purge
ܩܠܒܐ:ܨܢܕܘܩ ܐܡܢܐ	Template:Infobox artist
ܩܠܒܐ:ܡܦܠܚܢܐ	Template:User
ܣܕܪܐ:ܬܘܢܣ	Category:Tunisia
ܩܠܒܐ:Sec link auto	Template:Sec link auto
ܩܠܒܐ:Cmbox	Template:Cmbox
ܩܠܒܐ:Mbox	Template:Mbox
ܩܠܒܐ:Oppose	Template:Disagree
ܩܠܒܐ:COL	Template:COL
ܩܠܒܐ:PER	Template:PER
ܩܠܒܐ:ܨܢܕܘܩ ܡܕܥܐ ܕܝܒܫܬܐ	Template:Infobox continent
ܩܠܒܐ:User ar-2	Template:User ar-2
ܩܠܒܐ:User ar-3	Template:User ar-3
ܩܠܒܐ:User ar	Template:User ar
ܩܠܒܐ:ܝܘܡܐ ܕܫܒܘܥܐ	Template:Days of the week
ܣܕܪܐ:ܡܕܝܢܬܐ ܒܐܘܚܕܢܐ ܡܚܝܕܐ	Category:Cities in the United States
ܩܠܒܐ:ܬ.ܐ.	Template:Disambiguation
ܩܠܒܐ:No	Template:Not done
ܣܕܪܐ:ܩܠܒܐ ܨܢܕܘܩܐ	Category:Infobox templates
ܩܠܒܐ:Partial	Template:Partial
ܩܠܒܐ:UsersSpeak	Template:UsersSpeak
ܩܠܒܐ:ܩܘܕܝܟܘܣ ܕܣܕܪܐ	Template:Category TOC
ܩܠܒܐ:?	Template:?
ܩܠܒܐ:ܝܗܘܝܬܐ Colombia	Template:Country data Colombia
ܩܠܒܐ:User ar-5	Template:User ar-5
ܣܕܪܐ:User yue	Category:User yue
ܣܕܪܐ:User az	Category:User az
ܣܕܪܐ:User sk	Category:User sk
ܣܕܪܐ:User fr	Category:User fr
ܣܕܪܐ:User ja	Category:User ja
ܣܕܪܐ:User la	Category:User la
ܣܕܪܐ:User pt	Category:User pt
ܣܕܪܐ:User ro	Category:User ro
ܣܕܪܐ:User sv	Category:User sv
ܣܕܪܐ:User ko-N	Category:User ko-N
ܡܪܝ ܝܫܘܥ	Karakilise, Şemdinli
ܩܠܒܐ:User yue	Template:User yue
ܣܕܪܐ:ܗܘܦܪܟܝܣ ܕܥܝܪܐܩ	Category:Governorates of Iraq
ܩܠܒܐ:Cat main	Template:Cat main
ܣܕܪܐ:User ar	Category:User ar
ܣܕܪܐ:User arc	Category:User arc
ܣܕܪܐ:User da	Category:User da
ܣܕܪܐ:User sk-N	Category:User sk-N
ܣܕܪܐ:User de	Category:User de
ܣܕܪܐ:User el	Category:User el
ܣܕܪܐ:User en-N	Category:User en-N
ܣܕܪܐ:User es	Category:User es
ܣܕܪܐ:User fa	Category:User fa
ܣܕܪܐ:User fi	Category:User fi
ܣܕܪܐ:User he	Category:User he
ܩܠܒܐ:N/a	Template:N/a
ܣܕܪܐ:User hy	Category:User hy
ܣܕܪܐ:ܠܫܢܐ ܥܒܪܝܐ	Category:Hebrew language
ܣܕܪܐ:ܡܕܝܢܬܐ ܒܐܝܣܪܐܝܠ	Category:Cities in Israel
ܣܕܪܐ:User it	Category:User it
ܣܕܪܐ:User ko	Category:User ko
ܣܕܪܐ:ܒܬܫܪܝܢ ܐܚܪܝ	Category:November
ܣܕܪܐ:ܝܡܡܐ	Category:Seas
ܩܠܒܐ:ܐܠܦܒܝܬ ܝܘܢܝܐ	Template:Greek alphabet sidebar
ܩܠܒܐ:No2	Template:No2
ܣܕܪܐ:ܦܛܪܝܪܟܘ ܕܥܕܬܐ ܣܘܪܝܝܬܐ ܩܬܘܠܝܩܝܬܐ	Category:Syriac Catholic Patriarchs of Antioch
ܩܠܒܐ:Languages	Template:Languages
ܩܠܒܐ:Rh	Template:Rh
ܩܠܒܐ:ܡܢܝܢܐ ܕܡܡܪܐ ܦܪܝܫܐ	Template:FA number
ܩܠܒܐ:User tmr-3	Category:User tmr-3
ܩܠܒܐ:User tmr-2	Category:User tmr-2
ܩܠܒܐ:ܢܒܝܐ ܕܕܝܬܝܩܝ ܥܬܝܩܬܐ	Template:Prophets of the Tanakh
ܩܠܒܐ:ܣܡܘܩܐ	Template:Red
ܣܕܪܐ:ܒܝܬܝܘܬܐ	Category:Kinship and descent
ܩܠܒܐ:ܝܗܘܝܬܐ Brazil	Template:Country data Brazil
ܩܠܒܐ:Yes2	Template:Yes2
ܩܠܒܐ:Yes-No	Template:Yes-No
ܬܪܥܐ:ܬܘܕܝܬܐ	Portal:Religion
ܣܕܪܐ:ܪܝܫܝ ܩܘܛܢܝܘܬܐ ܥܠ ܐܬܪܐ	Category:Presidents by country
ܣܕܪܐ:User ru	Category:User ru
ܣܕܪܐ:User ru-3	Category:User ru-3
ܣܕܪܐ:User templates ar	Category:User templates ar
ܣܕܪܐ:User templates arc	Category:User templates arc
ܣܕܪܐ:User templates en	Category:User templates en
ܣܕܪܐ:User templates he	Category:User templates he
ܣܕܪܐ:User tl	Category:User tl
ܣܕܪܐ:User tmr	Category:User tmr
ܣܕܪܐ:User tr	Category:User tr
ܣܕܪܐ:ܙܡܪܐ	Category:Musicians
ܩܠܒܐ:Lang	Template:Lang
ܣܕܪܐ:ܪܫܘܡܐ	Category:Painters
ܩܠܒܐ:ܫܠܝܚܐ ܕܡܫܝܚܐ	Template:Apostles
ܩܠܒܐ:ܟܬܒܐ ܩܕܝܫܐ	Template:Bible-related
ܩܠܒܐ:Busy/Doc	Template:Busy
ܡܪܝ ܐܦܪܝܡ ܟܡܝܣ	Mar Aprim Khamis
ܡܪܝ ܥܡܢܘܐܝܠ ܝܘܣܦ	Mar Emmanuel Yosip
ܡܪܝ ܓܝܘܪܓܝܣ ܨܠܝܒܐ	Gewargis Sliwa
ܡܪܝ ܡܝܠܝܣ ܙܝܥܐ	Meelis Zaia
ܡܪܝ ܥܒܕܝܫܘܥ ܐܒܪܗܡ	Odisho Oraham
ܣܕܪܐ:ܐܡܢܐ ܥܠ ܐܕܫܐ	Category:Occupations by type
ܩܠܒܐ:ܚܡܫܐ ܐܘܩܝܢܘ	Template:Five oceans
ܩܠܒܐ:CHI	Template:CHL
ܩܠܒܐ:Cat handler/numbered	Template:Category handler/numbered
ܩܠܒܐ:FPCQuickLinks	Template:FPCQuickLinks
ܣܕܪܐ:ܢܝܓܪ	Category:Niger
ܩܠܒܐ:Chinese calendar/cycle	User:Python eggs/Chinese calendar/cycle
ܣܕܪܐ:ܝܘܠܦܢ ܩܢܘܢܝܐ	Category:Jurisprudence
ܣܕܪܐ:ܦܛܪܝܪܟܘ ܕܥܕܬܐ ܕܡܕܢܚܐ	Category:Patriarchs of the Church of the East
ܩܠܒܐ:Infobox language/family-color	Template:Infobox language/family-color
ܩܠܒܐ:User ar-0	Template:User ar-0
ܣܕܪܐ:ܣܥܪܐ	Category:Hairstyles
ܩܠܒܐ:User ar-4	Template:User ar-4
ܩܠܒܐ:User arc	Template:User arc
ܣܕܪܐ:ܢܗܪܘܬܐ	Category:Rivers
ܩܠܒܐ:User he-0	Template:User he-0
ܩܠܒܐ:User he-3	Template:User he-3
ܩܠܒܐ:User he-4	Template:User he-4
ܩܠܒܐ:User ko	Template:User ko
ܩܠܒܐ:User pt	Template:User pt
ܣܕܪܐ:User nl	Category:User nl
ܣܕܪܐ:User no	Category:User no
ܣܕܪܐ:ܣܘܪܝܐ	Category:Syria
ܣܕܪܐ:ܕܪܐ ܩܕܡܝܐ	Category:1st century
ܣܕܪܐ:ܓܙܪܬܐ ܝܒܫܢܝܬܐ	Category:Peninsulas
ܣܕܪܐ:ܗܘܦܪܟܝܣ ܕܗܘܠܢܕܐ	Category:Provinces of the Netherlands
ܣܕܪܐ:ܡܢܝܢܐ	Category:Integers
ܣܕܪܐ:ܡܕܝܢܬܐ ܕܥܝܪܐܩ	Category:Cities in Iraq
ܣܕܪܐ:ܥܝܢܐ (ܨܪܘܝܘܬܐ)	Category:Eye
ܢܝܢܘܣ ܐܚܐ	Ninos Aho
ܣܕܪܐ:ܓܘܪܓܝܐ	Category:Georgia (country)
ܣܕܪܐ:ܟܘܘܝܬ	Category:Kuwait
ܣܕܪܐ:ܠܒܢܢ	Category:Lebanon
ܣܕܪܐ:ܪܝܫܝ ܩܘܛܢܝܘܬܐ ܕܐܬܪܘܬܐ ܡܚܝܕܐ ܕܐܡܪܝܩܐ	Category:Presidents of the United States
ܣܕܪܐ:ܝܘܪܕܢܢ	Category:Jordan
ܣܕܪܐ:ܦܐܪܐ	Category:Fruit
ܣܕܪܐ:ܝܘܠܦܢ ܟܘܪܗܢܐ	Category:Pathology
ܣܕܪܐ:ܓܒܐ	Category:Political parties
ܣܕܪܐ:ܕܝܬܝܩܝ ܚܕܬܐ	Category:New Testament
ܣܕܪܐ:ܕܝܬܝܩܝ ܥܬܝܩܬܐ	Category:Old Testament
ܣܕܪܐ:ܐܘܩܝܢܘ	Category:Oceans
ܣܕܪܐ:ܓܪܡܐ	Category:Skeletal system
ܣܕܪܐ:ܗܘܦܪܟܝܣ ܘܐܘܚܕܢܐ ܕܩܢܕܐ	Category:Provinces and territories of Canada
ܣܕܪܐ:ܚܝܘܬܐ	Category:Animals
ܣܕܪܐ:ܛܘܪܐ	Category:Mountain ranges
ܣܕܪܐ:ܣܘܥܪܢܐ	Category:Events
ܣܕܪܐ:ܟܘܪܗܢܐ	Category:Diseases and disorders
ܣܕܪܐ:User pl	Category:User pl
ܣܕܪܐ:ܩܣܪ	Category:Emperors
ܣܕܪܐ:ܡܕܒܪܐ	Category:Deserts
ܣܕܪܐ:ܝܡܡܬܐ	Category:Lakes
ܩܠܒܐ:ܨܢܕܘܩ ܡܚܡܝܬܐ ܡܨܥܝܐ	Template:Infobox storage medium
ܩܠܒܐ:ܨܢܕܘܩ ܪܡܙܐ ܕܠܫܢܐ	Template:Infobox language
ܣܕܪܐ:User templates	Template:User templates
ܣܕܪܐ:ܩܛܠܥܡܐ	Category:Massacres
ܣܕܪܐ:ܡܠܟܘܬܐ ܕܗܘܠܢܕܐ	Category:Kingdom of the Netherlands
ܣܪܓܘܢ ܓܒܪܐܝܠ	Sargon Gabriel
ܨܝܢ	China (disambiguation)
ܣܕܪܐ:ܠܫܢܐ ܘܠܥܙܐ ܨܝܢܝܐ	Category:Varieties of Chinese
ܛܪܘܝܐܢܝ	Trojany, Masovian Voivodeship
ܫܪܓܐ	Lamp
ܩܠܒܐ:User tmr-1	Template:User tmr-1
ܩܠܒܐ:User arc-4	Template:User arc-4
ܩܠܒܐ:User arc-3	Template:User arc-3
ܩܠܒܐ:User arc-2	Template:User arc-2
ܩܠܒܐ:User arc-1	Template:User arc-1
ܩܠܒܐ:User arc-0	Template:User arc-0
ܩܠܒܐ:Sister	Template:Sister project
ܣܕܪܐ:ܢܒܝܐ ܕܕܝܬܝܩܝ ܥܬܝܩܬܐ	Category:Prophets of the Hebrew Bible
ܣܕܪܐ:ܦܛܪܝܪܟܘ ܕܥܕܬܐ ܕܡܕܢܚܐ ܕܐܬܘܪܝܐ	Category:Catholicos Patriarchs of the Assyrian Church of the East
ܣܕܪܐ:ܦܛܪܝܪܟܘ ܕܥܕܬܐ ܟܠܕܝܬܐ ܩܬܘܠܝܩܝܬܐ	Category:Chaldean Catholic Patriarchs of Babylon
ܩܠܒܐ:ܝܗܘܝܬܐ Falkland Islands	Template:Country data Falkland Islands
ܣܕܪܐ:ܦܛܪܝܪܟܘ	Category:Church patriarchs
ܣܕܪܐ:ܒܝܬ ܟܬܒܐ	Category:Libraries
ܣܕܪܐ:ܫܢܬܐ ܥܕܬܢܝܬܐ	Category:Liturgical calendar
ܣܕܪܐ:ܐܪܙܐ	Category:Sacraments
ܣܕܪܐ:ܒܝܬ ܢܗܪܝܢ	Category:Mesopotamia
ܣܕܪܐ:ܕܝܪ̈ܬܐ ܣܘܪ̈ܝܝܬܐ	Category:Syriac Orthodox monasteries
ܣܕܪܐ:ܓܘܢܐ	Category:Color
ܩܠܒܐ:ܝܗܘܝܬܐ South Georgia and the South Sandwich Islands	Template:Country data South Georgia and the South Sandwich Islands
ܣܕܪܐ:ܦܣܩܐ ܕܝܘܡܐ	Category:Parts of a day
ܣܕܪܐ:ܦܛܪܝܪܟܘ ܕܥܕܬܐ ܣܘܪܝܝܬܐ ܐܪܬܘܕܟܣܝܬܐ	Category:Syriac Orthodox Patriarchs of Antioch
ܕܒܘܪܐ (ܪܚܫܐ)	Wasp
ܩܠܒܐ:ܣܘܪܓܕܐ ܚܘܫܒܢܐ	Template:Year in other calendars
ܣܕܪܐ:ܩܕܝܫܐ	Category:Saints
ܩܪܕܐ (ܪܚܫܐ)	Tick
ܩܠܒܐ:ܣܝܩܘܡ ܫܘܪܝܐ	Template:Start date
ܩܠܒܐ:User nl-4	Template:User nl-4
ܩܠܒܐ:User nl-3	Template:User nl-3
ܪܩܝܝܥܝܬܐ ܕܐܬܘܪ	KBSV
ܩܠܒܐ:Tim	Template:Tim
ܩܠܒܐ:ܠܫܢܐ ܨܝܢܝܐ	Template:Chinese language
ܬܪܥܐ:ܐܘܩܝܢܘܣܝܐ	Portal:Oceania
ܩܠܒܐ:User he-5	Template:User he-5
ܩܠܒܐ:User tmr	Template:User tmr
ܩܠܒܐ:P1	Template:P1
ܐܪܡܝܐ	Aramaean (disambiguation)
ܩܠܒܐ:User arc-5	Template:User arc-5
ܢܘܓܗܐ	Dawn
ܩܠܒܐ:Sec link/normal link	Template:Sec link/normal link
ܩܠܒܐ:Sec link/text	Template:Sec link/text
ܩܠܒܐ:Documentation/core2	Template:Documentation/core2
ܘܝܩܝܦܕܝܐ:NavFrame	Wikipedia:NavFrame
ܩܠܒܐ:Infobox language/genetic	Template:Infobox language/genetic
ܡܪܝ ܐܝܣܚܩ ܝܘܣܦ	Mar Iskhaq Yosip
ܩܠܒܐ:Chinese calendar/year/78	User:Python eggs/Chinese calendar/year/78
ܩܠܒܐ:ܫܢܬܐ ܒܣܘܪܓܕܐ ܐܚܪܝܢܐ/ܝܦܢܢܝܐ	Template:Year in other calendars/Japanese
ܟܘܕܐ	Lochia
ܕܝܠܢܝܐ:ܫܘܚܠܦ̈ܐ ܚܕ̈ܬܐ	Special:RecentChanges
ܩܠܒܐ:Chinese calendar/month/78/27	User:Python eggs/Chinese calendar/month/78/27
