Hĭ-ciŭ	Africa
Nĭk-buōng	Japan
Nàng Mī-ciŭ	South America
Nò̤-ŭi	Norway
Ĭng-gáik-làng	England
Sŭ-gáik-làng	Scotland
Ŭi-ī-sê̤ṳ	Wales
Báe̤k Ái-ī-làng	Northern Ireland
Ái-ī-làng	Republic of Ireland
Hungary	Hungary
Să̤-băng-ngà	Spain
Mī-guók	United States
Bī-lé-sì	Belgium
Luxembourg	Luxembourg
Ṳ̄-dêu	Universe
Dê-giù	Earth
Sĕng-mêng	Life
Sī	Death
Nè̤ng	Human
Huăng-hī	Happiness
George Washington	George Washington
Wikidata	Wikidata
Hŭng-làng	Finland
Sôi-diēng	Sweden
Dăng-măk	Denmark
Pŏ̤-làng	Poland
Lithuania	Lithuania
É-dâi-lé	Italy
Sô̤i-sê̤ṳ	Switzerland
Ó̤-dê-lé	Austria
Hĭ-lé-nà̤	Greece
Tū-ī-gì	Turkey
Bì-ciū	Beer
Può-dò̤-ngà	Portugal
Ĕu-ciŭ	Europe
Ā-ciŭ	Asia
Báe̤k Mī-ciŭ	North America
Nàng-gĭk-ciŭ	Antarctica
Wikipedia	Wikipedia
Hò̤-làng	Netherlands
Ĭng-gĕng	Penis
PHP	PHP
Niū-iók-chê	New York City
Washington, D.C.	Washington, D.C.
Gô-gĭng-săng	San Francisco
Báik-lìng	Berlin
Los Angeles	Los Angeles
Diêng-nō̤	Computer
Sŭ-là̤-sié	Zürich
Barack Obama	Barack Obama
Uruguay	Uruguay
MediaWiki	MediaWiki
Lùng-dŭng	London
Bìng-guō	Apple
Bă-là̤	Paris
Mĕ̤k-să̤-gŏ̤	Mexico
Dâi-să̤-iòng	Atlantic Ocean
Tái-bìng-iòng	Pacific Ocean
California	California
Boston	Boston
Lā̤-bái-ék	Monday
Huōi-sĭng	Mars
Kenya	Kenya
Ethiopia	Ethiopia
Gŭng-ciō (nguòng-siū)	Monarch
Ghana	Ghana
Lā̤-bái-nê	Tuesday
Lā̤-bái-săng	Wednesday
Lā̤-bái-sé	Thursday
Lā̤-bái-ngô	Friday
Lā̤-bái-lĕ̤k	Saturday
Lā̤-bái-nĭk	Sunday
Săi (mà-kuŏ dông-ŭk)	Lion
Huák-guók	France
Kēng	Dog
Ĭng-guók	United Kingdom
Mà	Cat
Dṳ̆ng-huà Ìng-mìng Gê̤ṳng-huò-guók	China
Huák-ngṳ̄	French language
Wiktionary	Wiktionary
Ngṳ̀	Fish
Ciū	Alcoholic beverage
Bă-să̤	Brazil
Ngò̤-lò̤-sṳ̆	Russia
Hāi	Sea
Alabama	Alabama
Wikimedia	Wikimedia Foundation
Jimmy Wales	Jimmy Wales
Dáik-guók	Germany
Belarus	Belarus
Dáik-ngṳ̄	German language
Bĭng-dō̤	Iceland
Estonia	Estonia
Tū-sĭng	Saturn
Hĭ-gĭ	Airplane
Ciéng-cĕng	War
1	1 (number)
2	2 (number)
3	3 (number)
4	4 (number)
5	5 (number)
0	0 (number)
George W. Bush	George W. Bush
Latvia	Latvia
Ukraine	Ukraine
Ciék-káik	Czech Republic
Slovakia	Slovakia
Slovenia	Slovenia
Moldova	Moldova
Romania	Romania
Bulgaria	Bulgaria
Lò̤-mā	Rome
Macedonia Gê̤ṳng-huò-guók	Republic of Macedonia
Albania	Albania
Croatia	Croatia
Bosnia gâe̤ng Herzegovina	Bosnia and Herzegovina
Azerbaijan	Azerbaijan
Andorra	Andorra
Cyprus	Cyprus
Georgia (guók-gă)	Georgia (country)
Kazakhstan	Kazakhstan
Malta	Malta
Monaco	Monaco
Montenegro	Montenegro
Vaticano	Vatican City
San Marino	San Marino
Gū-bă	Cuba
Belize	Belize
Barbados	Barbados
Java	Java (programming language)
Éng-dô-nà̤-să̤-ā	Indonesia
Tū-ī-gì-ngṳ̄	Turkish language
Nàng-hĭ	South Africa
Algeria	Algeria
Wiki Dù-cṳ̆-guāng	Wikisource
Uzbekistan	Uzbekistan
Huà-să	Warsaw
Può-dò̤-ciū	Wine
Cūi	Water
Chà	Wood
Diêng-sê	Television
Chile	Chile
Ià-sŭ	Jesus
Galileo Galilei	Galileo Galilei
Cūi-sĭng	Mercury (planet)
Lĭk-sṳ̄	History
Gĭng-sĭng	Venus
Ngṳ̄-ngiòng	Language
Ái	Love
Mŭk-sĭng	Jupiter
Ngṳ̀ng-ò̤	Milky Way
Tiĕng-uòng-sĭng	Uranus
Hāi-uòng-sĭng	Neptune
Tiĕng-ùng	Astronomy
Sĭng-gă-pŏ̤	Singapore
Kuŏ-hŏk	Science
Mìng-uòng-sĭng	Pluto
Ciŏng-lài	Future
Séng-mū Mā-lé-ā	Mary (mother of Jesus)
Liechtenstein	Liechtenstein
Adolf Hitler	Adolf Hitler
Dâ̤-nê-ché̤ṳ Sié-gái Dâi-ciéng	World War II
Wiki Gáu-kuŏ-cṳ̆	Wikibooks
Wiki Ngṳ̄-liŏh	Wikiquote
Wiki Dâi-hŏk	Wikiversity
Cṳ̆ng	Clock
Ubuntu	Ubuntu (operating system)
Linux	Linux
Só-hŏk	Mathematics
Lá-dĭng-ngṳ̄	Latin
Bahrain	Bahrain
Armenia	Armenia
Serbia	Serbia
Nguŏk-giù	Moon
Istanbul	Istanbul
Ó̤-ciŭ	Australia
Ŭk-lī	Physics
Argentina	Argentina
Peru	Peru
Dièu-siēng Mìng-ciō-ciō-ngiê Ìng-mìng Gê̤ṳng-huò-guók	North Korea
Gāng-puŏ-câi	Cambodia
Gū-làng-gĭng	Quran
Kṳ̄ng-lṳ̀ng	Dinosaur
Ĭ-sṳ̆-làng-gáu	Islam
Lì	Pear
Lùng-lùng	Wheel
Huò-bìng	Peace
Nṳ̄-gái	Woman
Gū-chiŏng-kĕ̤ng	Anus
Nìng-mùng	Lemon
Bă-ciĕu	Banana
Huă	Flower
Napoléon Bonaparte	Napoleon
Sĕng-lī	Physiology
Hèng-sĭng	Star
Nĭk-tàu	Sun
Victor Hugo	Victor Hugo
Dâi-iòng-ciŭ	Oceania
Tái-iòng-hiê	Solar System
Ngāi	Tooth
Kĭng	Hydrogen
Wiki Gê̤ṳng-hiōng	Wikimedia Commons
Cṳ̆	Book
Nĭk	Day
Dĕ̤ng Timor	East Timor
Màng-buŏ	Night
Nièng	Year
Ó̤-sṳ̆-lṳ̆k	Oslo
Lī-sṳ̆-buōng	Lisbon
Táng	Carbon
Dâng	Nitrogen
Iōng	Oxygen
Giàng-sĭng	Planet
Kleopatra 7-sié	Cleopatra
Ĭng-ngŏk	Music
É-dâi-lé-ngṳ̄	Italian language
Séng Peterburg	Saint Petersburg
Chad	Chad
Lé̤ṳ	Aluminium
Sĭng-să̤-làng	New Zealand
Éng-dô	India
Tuvalu	Tuvalu
Tiék	Iron
Tonga	Tonga
Samoa	Samoa
Solomon Gùng-dō̤	Solomon Islands
Vanuatu	Vanuatu
Papua New Guinea	Papua New Guinea
William Shakespeare	William Shakespeare
Palau	Palau
Nauru	Nauru
Micronesia Lièng-băng	Federated States of Micronesia
Iòng (gĭng-sṳ̆k)	Lead
Marshall Gùng-dō̤	Marshall Islands
Kiribati	Kiribati
Mūng-gū	Mongolia
Fiji	Fiji
Venezuela	Venezuela
Guók-cié chiông-gì	Chess
Genghis Khan	Genghis Khan
Maine	Maine
Mā	Horse
Ū-ké	Weapon
Dông-ŭk	Animal
Suriname	Suriname
Paraguay	Paraguay
Guyana	Guyana
Ecuador	Ecuador
Colombia	Colombia
Hŭk-gáu	Buddhism
Bolivia	Bolivia
Dè̤ng	Copper
Trinidad gâe̤ng Tobago	Trinidad and Tobago
Sĭk-ŭk	Plant
Séng Vincent gâe̤ng Grenadines	Saint Vincent and the Grenadines
New Hampshire	New Hampshire
Séng Lucia	Saint Lucia
Séng Kitts gâe̤ng Nevis	Saint Kitts and Nevis
Cĭng-kṳ̄ng	Fungus
Jamaica	Jamaica
Grenada	Grenada
Massachusetts	Massachusetts
Guatemala	Guatemala
Bahamas	The Bahamas
Connecticut	Connecticut
Giĕ	Chicken
Antigua gâe̤ng Barbuda	Antigua and Barbuda
Hawaii	Hawaii
Honduras	Honduras
Dominica	Dominica
Dominica Gê̤ṳng-huò-guók	Dominican Republic
Dṳ̆	Domestic pig
Báe̤k-bĭng-iòng	Arctic Ocean
Haiti	Haiti
El Salvador	El Salvador
Ĭ-lāng	Iran
Iraq	Iraq
Alaska	Alaska
Costa Rica	Costa Rica
Ī-sáik-liĕk	Israel
Panama	Panama
Yemen	Yemen
Bâng-dŭk	Virus
Pŏ̤-làng-ngṳ̄	Polish language
Jordan	Jordan
Nicaragua	Nicaragua
Florida	Florida
Kyrgyzstan	Kyrgyzstan
Arizona	Arizona
Kuwait	Kuwait
Lō̤-kuŏ	Laos
Lebanon	Lebanon
Oregon	Oregon
Maldives	Maldives
Mī-ciŭ	Americas
Utah	Utah
Ngù	Cattle
Mā-lài-să̤-ā	Malaysia
Miēng-diêng	Burma
Nepal	Nepal
Oman	Oman
Pakistan	Pakistan
Qatar	Qatar
Saudi Ā-lá-báik	Saudi Arabia
Sri Lanka	Sri Lanka
Joseph Stalin	Joseph Stalin
Syria	Syria
Platon	Plato
Tajikistan	Tajikistan
Dṳ̆ng-huà Mìng-guók	Taiwan
Aristoteles	Aristotle
Tái-guók	Thailand
Huōi-chiă	Train
Turkmenistan	Turkmenistan
Ā-lá-báik Lièng-hăk Dâi-gŭng-guók	United Arab Emirates
Băh-gĭng	Platinum
Uŏk-nàng	Vietnam
Dâi-hàng Mìng-guók	South Korea
Afghanistan	Afghanistan
Gĭng	Gold
Suez Ông-ò̤	Suez Canal
Bangladesh	Bangladesh
Mali	Mali
Sokrates	Socrates
Angola	Angola
Bhutan	Bhutan
Ùng-lài	Brunei
Tanzania	Tanzania
Cūi-ngṳ̀ng	Mercury (element)
Hĭ-lĭ-pĭng	Philippines
Dṳ̆ng-hĭ Gê̤ṳng-huò-guók	Central African Republic
Isaac Newton	Isaac Newton
Albert Einstein	Albert Einstein
Uòng-sáik	Yellow
Togo	Togo
Tunisia	Tunisia
Zambia	Zambia
Zimbabwe	Zimbabwe
Báe̤k-gĭng	Beijing
Nàng Sudan	South Sudan
Benin	Benin
Botswana	Botswana
Wiki Sĭng-ùng	Wikinews
Burkina Faso	Burkina Faso
Burundi	Burundi
Comoros	Comoros
Congo Gê̤ṳng-huò-guók	Republic of the Congo
Congo Mìng-ciō Gê̤ṳng-huò-guók	Democratic Republic of the Congo
Djibouti	Djibouti
Chiáh-dô̤ Guinea	Equatorial Guinea
Eritrea	Eritrea
Gabon	Gabon
Gambia	The Gambia
Guinea	Guinea
Guinea-Bissau	Guinea-Bissau
Côte d'Ivoire	Ivory Coast
Cameroon	Cameroon
Cabo Verde	Cape Verde
Lesotho	Lesotho
Liberia	Liberia
Libya	Libya
Madagascar	Madagascar
Malawi	Malawi
Mauritania	Mauritania
Mauritius	Mauritius
Morocco	Morocco
Mozambique	Mozambique
Namibia	Namibia
Niger	Niger
Nigeria	Nigeria
Charles Darwin	Charles Darwin
Uganda	Uganda
Rwanda	Rwanda
Séng Tomé gâe̤ng Príncipe	São Tomé and Príncipe
Senegal	Senegal
Seychelles	Seychelles
Carl Linnaeus	Carl Linnaeus
Sierra Leone	Sierra Leone
Somalia	Somalia
Julius Caesar	Julius Caesar
Sudan	Sudan
Swaziland	Swaziland
Kê̤ṳng	Rainbow
Lièng-hăk-guók	United Nations
Dê-cék	Geology
Dê-lī	Geography
Sĭng-câung	Heart
Puòi-hŭ	Skin
Ngàng-sáik	Color
Làng-sáik	Blue
Ngṳ̀ng	Silver
Sék	Tin
Michigan	Michigan
Illinois	Illinois
North Dakota	North Dakota
South Dakota	South Dakota
Montana	Montana
Wyoming	Wyoming
Idaho	Idaho
Washington	Washington (state)
Nevada	Nevada
Éng-dô-iòng	Indian Ocean
Kosovo	Kosovo
Colorado	Colorado
分類:Hŭng-lôi	Category:Contents
Chicago	Chicago
Dĕ̤ng-tiĕng	Winter
Chŭng-tiĕng	Spring (season)
Hâ-tiĕng	Summer
Chiŭ-tiĕng	Autumn
Saddam Hussein	Saddam Hussein
Osama bin Laden	Osama bin Laden
Să̤-băng-ngà-ngṳ̄	Spanish language
Philadelphia	Philadelphia
Tĭ-tṳ̆	Spider
Guō-sĭk	Fruit
Gàu	Monkey
Cièng	Money
Virginia	Virginia
West Virginia	West Virginia
Huăng-ciĕu	Capsicum annuum
Niū-iók-ciŭ	New York
Rhode Island	Rhode Island
Kŏng-tṳ̀ng	Insect
Maryland	Maryland
Delaware	Delaware
Vladimir Lenin	Vladimir Lenin
Ohio	Ohio
Pennsylvania	Pennsylvania
Augustus	Augustus
Microsoft Windows	Microsoft Windows
New Jersey	New Jersey
Hŭng-làng-ngṳ̄	Finnish language
Indiana	Indiana
Ké-chiă	Car
Georgia	Georgia (U.S. state)
Texas	Texas
North Carolina	North Carolina
South Carolina	South Carolina
Manila	Manila
Dĕ̤ng-gĭng	Tokyo
Uòng-lì	Pineapple
Mississippi	Mississippi
Tennessee	Tennessee
New Mexico	New Mexico
Ngà-diēng	Athens
Minnesota	Minnesota
Baghdad	Baghdad
Wisconsin	Wisconsin
Iowa	Iowa
Nebraska	Nebraska
Kansas	Kansas
Hŏng-giāng	Cigarette
Missouri	Missouri
Louisiana	Louisiana
Kentucky	Kentucky
Arkansas	Arkansas
Oklahoma	Oklahoma
Madonna	Madonna (entertainer)
Aceh	Aceh
Séng-gĭng	Bible
Phnom Penh	Phnom Penh
Hù Cé-mìng Chê	Ho Chi Minh City
Ò̤-nô̤i	Hanoi
Cĭng Ià-sŭ Gáu-huôi	True Jesus Church
Ĭng-ngṳ̄	English language
Màng-gók	Bangkok
Kuala Lumpur	Kuala Lumpur
Bangka Belitung Gùng-dō̤	Bangka–Belitung Islands
Dài-báe̤k	Taipei
Concepción	Concepción, Chile
Bengkulu	Bengkulu
Końskowola	Końskowola
Nê-iōng-huá-táng	Carbon dioxide
Jambi	Jambi
Siè	Snake
Lampung	Lampung
Guŏng-sók	Speed of light
Riau	Riau
Riau Gùng-dō̤	Riau Islands Province
Nàng Sumatra	South Sumatra
Lò̤-mā Dá̤-guók	Roman Empire
Mì-niōng	Microsoft
Kó-lū-hŭ	Kurów
Huá-hŏk	Chemistry
Sièng-sŏng	Hydrochloric acid
Ôi-sĭng	Natural satellite
Kă-giù	Association football
Să̤ Sumatra	West Sumatra
Mā-dáik-lī	Madrid
Michael Jackson	Michael Jackson
Cê̤ṳ-iù	Liberty
Cṳ̆-niòng-giāng	Girl
Sék-nà̤	Sydney
Liŏh-sáik	Green
È̤ng-sáik	Red
Huōi	Fire
Sĭng Nàng Wales	New South Wales
Nile Ò̤	Nile
Banten	Banten
Dṳ̆ng Jawa	Central Java
Chēng-chiū-sĭng	Comet
Dĕ̤ng Jawa	East Java
Jakarta	Jakarta
Ăng-kā-lá	Ankara
Să̤ Jawa	West Java
Yogyakarta	Special Region of Yogyakarta
Dṳ̆ng Kalimantan	Central Kalimantan
Dĕ̤ng Kalimantan	East Kalimantan
Báe̤k Kalimantan	North Kalimantan
Nàng Kalimantan	South Kalimantan
Hŏk-hâu	School
Să̤ Kalimantan	West Kalimantan
Dâi-hŏk	University
Wikipedia:Să-buàng	Wikipedia:Sandbox
Chió	House
Dê-dù	Map
Ò̤	River
Osasco	Osasco
Chiĕng-lī-giáng	Telescope
分類:Dài-uăng lĭk-sṳ̄	Category:History of Taiwan
Curitiba	Curitiba
Sĕng-lìng	Forest
分類:Uŏk-nàng lĭk-sṳ̄	Category:History of Vietnam
Iók-báik-cṳ̆	Book of Job
Cĭng-ngiòng	Book of Proverbs
Kūng-cṳ̄	Confucius
Hà	Decapoda
分類:Só-hŏk	Category:Mathematics
Bali	Bali
Ĕu-nguòng	Euro
Mī-gĭng	United States dollar
Dâi-lièu	Liao dynasty
Hòng-ciŭ	Hangzhou
Gĭ-dók-gáu	Christianity
Dĕ̤ng Nusa Tenggara	East Nusa Tenggara
Să̤ Nusa Tenggara	West Nusa Tenggara
Dṳ̆ng Sulawesi	Central Sulawesi
Gĭng-guók	Jin dynasty (1115–1234)
Gorontalo	Gorontalo
Báe̤k Sulawesi	North Sulawesi
Dĕ̤ng-nàng Sulawesi	Southeast Sulawesi
Nàng Sulawesi	South Sulawesi
Să̤ Sulawesi	West Sulawesi
Seattle	Seattle
Dêu	Rice
Maluku	Maluku (province)
Báe̤k Maluku	North Maluku
Papua	Papua (province)
Să̤ Papua	West Papua (province)
Cēu	Bird
Siū-dŭ	Capital city
Può-dò̤-ngà-ngṳ̄	Portuguese language
Nguŏk	Month
Uòng Hiêng-huàng	Huang Xianfan
Cōng	Diamond
Nĭk-buōng-ngṳ̄	Japanese language
Báik-kuŏ-ciòng-cṳ̆	Encyclopedia
Tàu Hiĕk	Main Page
模板:Ô-lī-kó̤	Template:Good article
Saratov	Saratov
Làng-giù	Basketball
Olympic Ông-dông-huôi	Olympic Games
Diòng-gĕ̤ng	Yangtze
Che Guevara	Che Guevara
Mò̤ Dĕk-dŭng	Mao Zedong
Să̤-ăng	Xi'an
Lá-sák	Lhasa
Séng-gău	Sexual intercourse
Ĭng-dô̤	Vagina
Diék-hŏk	Philosophy
分類:Ché̤ṳk-káik chēng-dṳ̀	Category:Candidates for speedy deletion
Gáung-kìng	Piano
Dà	Tea
Marco Polo	Marco Polo
Hebe Camargo	Hebe Camargo
Gê̤ṳng-sāng-ciō-ngiê	Communism
Cṳ̆-buōng-ciō-ngiê	Capitalism
Guók-gă	Country
Mìng-cŭk	Nation
Carthago	Carthage
Uōng-hiĕk liù-lāng-ké	Web browser
Siù-cūi	Human swimming
分類:Tiĕng-ùng	Category:Astronomy
Hŭk	Buddhahood
Lī Bĕk	Li Bai
Dù-cṳ̆-guāng	Library
Sĕng-tái	Ecology
Céng-dê	Politics
Mìng-ciō	Democracy
Cìng-dièu	Qin dynasty
Nobel Ciōng	Nobel Prize
Cìng Sṳ̄-huòng	Qin Shi Huang
Dṳ̆ng-dĕ̤ng	Middle East
Háng-dièu	Han dynasty
Làu Băng	Emperor Gaozu of Han
Háng Ùng-dá̤	Emperor Wen of Han
Háng Gīng-dá̤	Emperor Jing of Han
Háng Ū-dá̤	Emperor Wu of Han
Sĕng-ŭk	Organism
Rabindranath Tagore	Rabindranath Tagore
Háng Guŏng-ū-dá̤	Emperor Guangwu of Han
Gŭng-ciō-cié-dô	Monarchy
Siâ-huôi-ciō-ngiê	Socialism
Cṳ̆ng-chói	Kiss
Nguòng-dièu	Yuan dynasty
Háng Hióng-dá̤	Emperor Xian of Han
Nazi Dáik-guók	Nazi Germany
Christopher Columbus	Christopher Columbus
Dâng Huò	Zheng He
Panama Ông-ò̤	Panama Canal
Céng-dièu	Jin dynasty (265–420)
Nàng-bĭng-iòng	Southern Ocean
Uòng-ò̤	Yellow River
Sṳ̆-mā Ièng	Emperor Wu of Jin
Ngê	Ear
Pé	Nose
Mĕ̤k-ciŭ	Eye
Hŭng-muòng	Mosquito
Săi-ngṳ̀	Shark
Lŏk-dò̤	Camel
Chiông	Elephant
Mā-ngiê	Ant
Sùi-dièu	Sui dynasty
Hò̤-làng-ngṳ̄	Dutch language
Sùi Ùng-dá̤	Emperor Wen of Sui
Sùi Iòng-dá̤	Emperor Yang of Sui
Să̤-hâ	Western Xia
Sóng-dièu	Song dynasty
Diêu Kuŏng-êng	Emperor Taizu of Song
Sóng Tái-cŭng	Emperor Taizong of Song
Sóng Cĭng-cŭng	Emperor Zhenzong of Song
Sóng Ìng-cŭng	Emperor Renzong of Song
Sóng Sìng-cŭng	Emperor Shenzong of Song
Sóng Hŭi-cŭng	Emperor Huizong of Song
Sóng Gŏ̤-cŭng	Emperor Gaozong of Song
Sóng Lī-cŭng	Emperor Lizong of Song
Sóng Duăng-cŭng	Emperor Duanzong of Song
Ögedei	Ögedei Khan
Güyük	Güyük Khan
Möngke	Möngke Khan
Kublai	Kublai Khan
Huă-chái	Cauliflower
Giò (sĭk-ŭk)	Eggplant
Siók	Snow
Niè-giāng	Child
Cā-tàu	Morning
Hŭng-cṳ̆ng	Minute
Ngò̤-lò̤-sṳ̆-ngṳ̄	Russian language
Huák-lŭk	Law
Hièng-huák	Constitution
Háng-ngṳ̄	Chinese language
Sá̤-bàu	Cell (biology)
Háik	Blood
Hié (ké-guăng)	Lung
Romania-ngṳ̄	Romanian language
Bulgaria-ngṳ̄	Bulgarian language
Ṳ̄	Rain
Dê-cīng	Earthquake
Cūi-căi	Flood
Hāi-lâung	Tsunami
Hùng	Cloud
Hŭng-tăi	Tropical cyclone
Hŭng	Wind
Georgia-ngṳ̄	Georgian language
Háng-cê	Chinese characters
Dièu-siēng-cê	Hangul
Lá-dĭng cê-mō̤	Latin script
Ùng-hŏk	Literature
分類:Ĭng-ngŏk	Category:Music
分類:Ùng-hŏk	Category:Literature
È̤ng-làu-máe̤ng	Dream of the Red Chamber
Hù-lì	Fox
Harry Potter	Harry Potter
Chiū-ìng	Masturbation
Siâ-huôi	Society
Gáu-ṳ̆k	Education
Nàng-gái	Man
Ìng-guòng	Human rights
Temür	Temür Khan, Emperor Chengzong of Yuan
Gŭng-sê̤ṳ	Military
Gă-pĭ	Coffee
Săng	Mountain
Khayisan	Külüg Khan, Emperor Wuzong of Yuan
Ayurbarwada	Ayurbarwada Buyantu Khan, Emperor Renzong of Yuan
Shidibala	Gegeen Khan, Emperor Yingzong of Yuan
Yesün Temür	Yesün Temür Khan, Emperor Taiding of Yuan
Sŏng Dṳ̆ng-săng	Sun Yat-sen
Hiŏng-gē̤ng	Hong Kong
Miami	Miami
Ragibagh	Ragibagh Khan, Emperor Tianshun of Yuan
Tugh Temür	Jayaatu Khan, Emperor Wenzong of Yuan
Kuśala	Khutughtu Khan, Emperor Mingzong of Yuan
Hàng Ciéng	Korean War
Rinchinbal	Rinchinbal Khan, Emperor Ningzong of Yuan
Toghon Temür	Toghon Temür
Siū-ék	Seoul
Siông-hāi	Shanghai
Ùng-huá Dâi-gáik-mêng	Cultural Revolution
Chĭng-dièu	Qing dynasty
Uŏk-nàng Ciéng-cĕng	Vietnam War
Thomas Edison	Thomas Edison
Armenia-ngṳ̄	Armenian language
Ukraine-ngṳ̄	Ukrainian language
HTML	HTML
Steven Spielberg	Steven Spielberg
Mŏ̤h-ngiòng	Mo Yan
Sôi-diēng-ngṳ̄	Swedish language
Dăng-măk-ngṳ̄	Danish language
Nò̤-ŭi-ngṳ̄	Norwegian language
Luxembourg-ngṳ̄	Luxembourgish language
Ciék-káik-ngṳ̄	Czech language
Karl Marx	Karl Marx
Nĕng-nĕng	Breast
Guŏng	Light
Hĭ-lé-nà̤-ngṳ̄	Greek language
Ái-ī-làng-ngṳ̄	Irish language
Kié-ngò̤	Penguin
Pŏ̤-sṳ̆-ngṳ̄	Persian language
Cŭng-gáu	Religion
Hàng-guók-ngṳ̄	Korean language
Cháung-sié-gé	Book of Genesis
Chók-Ăi-gĭk-gé	Book of Exodus
Háng-ngṳ̄ Guăng-uâ	Mandarin Chinese
Uŏk-nàng-ngṳ̄	Vietnamese language
Sigmund Freud	Sigmund Freud
Tái-guók-ngṳ̄	Thai language
Mā-lài-ngṳ̄	Malay language
Mūng-gū-ngṳ̄	Mongolian language
Bandar Seri Begawan	Bandar Seri Begawan
Hĭ-báik-lài-ngṳ̄	Hebrew language
Ŭi-ī-sê̤ṳ-ngṳ̄	Welsh language
Sŭ-gáik-làng-ngṳ̄	Scottish Gaelic
Vientiane	Vientiane
Lō̤-cṳ̄	Laozi
Găng-câung	Liver
Sṳ̆-mā Chiĕng	Sima Qian
Tó	Rabbit
Ciŏ Hĭ	Zhu Xi
Cìng-gāng	Emotion
Dâi-iòng	Ocean
Victoria Nṳ̄-uòng	Queen Victoria
Sék-giă-mèu-nà̤	Gautama Buddha
Mŭk-hâng-mĕk-dáik	Muhammad
Hŭ-ngék	Breathing
Ṳ̀-gă	Confucianism
Bók-lō̤	Abdomen
Dô̤-gáu	Taoism
Chói-siĕk	Tongue
Dâiu-gáuk	Neck
Chói	Mouth
Elizabeth 2-sié	Elizabeth II
Dòng-dièu	Tang dynasty
Dòng Gŏ̤-cū	Emperor Gaozu of Tang
Dòng Tái-cŭng	Emperor Taizong of Tang
Dòng Gŏ̤-cŭng	Emperor Gaozong of Tang
Dòng Dṳ̆ng-cŭng	Emperor Zhongzong of Tang
Dòng Iô-cŭng	Emperor Ruizong of Tang
Ū Cáik-tiĕng	Wu Zetian
Dòng Hièng-cŭng	Emperor Xuanzong of Tang
Dòng Sé̤ṳk-cŭng	Emperor Suzong of Tang
Dòng Dâi-cŭng	Emperor Daizong of Tang
Dòng Dáik-cŭng	Emperor Dezong of Tang
Cê-mō̤	Letter (alphabet)
Siēu-hŏk	Primary school
Mìng-dièu	Ming dynasty
Ciŏ Nguòng-ciŏng	Hongwu Emperor
Ronald Reagan	Ronald Reagan
Gióng-ùng Huòng-dá̤	Jianwen Emperor
Īng-lŏk Huòng-dá̤	Yongle Emperor
Hùng-hĭ Huòng-dá̤	Hongxi Emperor
Sŏng-dáik Huòng-dá̤	Xuande Emperor
Mìng Ĭng-cŭng	Zhengtong Emperor
Gīng-tái Huòng-dá̤	Jingtai Emperor
Sìng-huá Huòng-dá̤	Chenghua Emperor
Hùng-dé Huòng-dá̤	Hongzhi Emperor
Céng-dáik Huòng-dá̤	Zhengde Emperor
Gă-cêng Huòng-dá̤	Jiajing Emperor
Lè̤ng-kéng Huòng-dá̤	Longqing Emperor
Uâng-lĭk Huòng-dá̤	Wanli Emperor
Tái-chiŏng Huòng-dá̤	Taichang Emperor
Tiĕng-kiē Huòng-dá̤	Tianqi Emperor
Sùng-dĭng Huòng-dá̤	Chongzhen Emperor
Gĭng Céng-nĭk	Kim Jong-il
Nguòng-só ciŭ-gĭ-biēu	Periodic table
Chăng-màng	Blindness
Sá̤-kṳ̄ng	Bacteria
Chéu	Tree
Può-dò̤	Grape
Huăng-giāng-sṳ̀	Potato
Tòng	Sugar
Uòng-dâu	Soybean
Séng-sék	Information
Bó̤-cāi	Newspaper
Diêng-uâ	Telephone
Ùng-huá	Culture
Huáng-ngṳ̄	Sanskrit
Dâi-diòng	Large intestine
Siēu-diòng	Small intestine
Ĭ-hŏk	Medicine
Sièng	Salt
Huá-hŏk nguòng-só	Chemical element
Unix	Unix
Ùi-gì	Go (game)
Káh-dièu-nó̤h	Toy
Diêng-īng	Film
Gĭng-sṳ̆k	Metal
Kă-dăk-chiă	Bicycle
Mièng-huă	Cotton
Sók-dô	Velocity
Sì-găng	Time
Cāi	Paper
Só-lâiu	Plastic
Miêng-cék	Area
Gŭng-chióh	Metre
Iù-diĕng-bău	Maize
Duâi-măk	Barley
Dĕ̤ng-nàng-ā	Southeast Asia
Sīng-iòng	Shenyang
Tṳ̀ng-kéng	Chongqing
Tiĕng-cĭng	Tianjin
Ū-háng	Wuhan
Gū Ăi-gĭk	Ancient Egypt
Gū Hĭ-lé-nà̤	Ancient Greece
Hṳ̀ng	Bear
Britney Spears	Britney Spears
Ngàng	Cancer
Măk	Wheat
Cié-sē̤	Sorghum
Pó̤-sióng	Disability
Lĭk-huák	Calendar
Sìng-gĭng-bâng	Mental disorder
Gregorius Lĭk-huák	Gregorian calendar
Tutankhamun	Tutankhamun
Nguŏk-gĭng	Menstruation
Mà-chiók	Mahjong
Ông-ò̤	Canal
Detroit	Detroit
Diòng-siàng	Great Wall of China
Gĭng-cê-ták	Pyramid
Osman Dá̤-guók	Ottoman Empire
Guók-nô̤i sĕng-sāng cūng-dĭk	Gross domestic product
Diêng	Electricity
Ché̤ṳng	Firearm
Lòng-gĭ-ché̤ṳng	Machine gun
Sáung-buàng	Abacus
Tāng-káik	Tank
Chāu-muòi	Strawberry
Liĕk-chiĕ	Lychee
Ià-cī	Coconut
Tò̤	Peach
Cáung-ngṳ̄	Zhuang languages
Siŏng-ngṳ̄	Xiang Chinese
Mì-ngù-ī-ngṳ̄	Uyghur language
Lâung-gŏ̤	Cake
Wiki Ŭk-cṳ̄ng	Wikispecies
Nĕng-dáe̤k	Brassiere
Ā-lá-báik-ngṳ̄	Arabic language
Cūng-lī	Prime minister
Dièu-siēng Tái-cŭng	Taejong of Joseon
Lù Ū-hièng	Roh Moo-hyun
Páuk Céng-hĭ	Park Chung-hee
Siĕng-ìng-ciōng	Cactus
Siŏh-tàu-lâung	Pebble
Iòng-bék	Pencil
Gă-sĭ	Furniture
Dó̤h	Table (furniture)
Ó̤-muòng	Macau
Liòng Cīng-ĭng	CY Leung
Iē-giāng	Chair
Hù Gīng-dò̤	Hu Jintao
Sĭk Gê̤ṳng-bìng	Xi Jinping
Dòng-gêng-lĕ̤k	Giraffe
Chĭng-dáung	Shenzhen
Guōng-dĕ̤ng	Guangdong
Guōng-să̤	Guangxi
Sŭ-lièng	Soviet Union
Kiák-sióng-gĭ	Still camera
Kagoshima-gâing	Kagoshima Prefecture
C ngṳ̄-ngiòng	C (programming language)
Kă	Foot
Ciēng	Gekkonidae
Dô-dâing	Lizard
Giĕng-tàu	Shoulder
Wikipedia:Bō̤-ciéng hō̤ ùng	Wikipedia:Featured articles
Sié-gái	World
Wikipedia:Duâi chéu â	Wikipedia:Village pump
Busan	Busan
Lèng-huă	Nelumbo nucifera
Vermont	Vermont
Denver	Denver
Guōng-ciŭ	Guangzhou
Ciōng Gái-sĭk	Chiang Kai-shek
Gŏng Dĕk-mìng	Jiang Zemin
Ŭng Gă-bō̤	Wen Jiabao
Nàng-gĭng	Nanjing
Làu Dáik-huà	Andy Lau
Diŏng Hŏk-iū	Jacky Cheung
Báe̤k-gĭng Dâi-hŏk	Peking University
Chĭng-huà Dâi-hŏk	Tsinghua University
Ŭ-lū-mŭk-cà̤	Ürümqi
Gŏng-sŭ	Jiangsu
Ciék-gŏng	Zhejiang
Dâing Siēu-bìng	Deng Xiaoping
Lò̤-mā Gê̤ṳng-huò-guók	Roman Republic
Câung-kṳ̆	Tibet
Să̤-câung	Tibet Autonomous Region
Ciŭ Ŏng-lài	Zhou Enlai
Dṳ̆ng-guók Gê̤ṳng-sāng-dōng	Communist Party of China
Chiū-gĭ	Mobile phone
Dò̤-nēu	Ostrich
Kŏng-hĭ Huòng-dá̤	Kangxi Emperor
Dièu-siēng	Korea
Lī Káik-giòng	Li Keqiang
Gŏ̤ Hèng-giông	Gao Xingjian
Ciŏ Ṳ̀ng-gĭ	Zhu Rongji
Lī Bèng	Li Peng
Lòng	Gray wolf
Bìng-iōng	Pyongyang
Sĭng-iók Séng-gĭng	New Testament
9	9 (number)
Kiék	Scorpion
Gièng-lè̤ng Huòng-dá̤	Qianlong Emperor
Dṳ̆ng-guók Dâi-lṳ̆k	Mainland China
Háik-lṳ̀ng-gĕ̤ng-sēng	Heilongjiang
Mā Ĭng-gāu	Ma Ying-jeou
Lè̤	Donkey
Wikipedia:Cék-liông ô-lī-kó̤ gì ùng-ciŏng	Wikipedia:Good articles
Sé-chiŏng	Sichuan
Gô-iók Séng-gĭng	Old Testament
Séng-dáng-cáik	Christmas
Săng-gáe̤k-hìng	Triangle
Muammar Gaddafi	Muammar Gaddafi
Lâu-hū	Tiger
Daejeon	Daejeon
Daegu	Daegu
Sié-cŭng Dĕk-biék Cê̤ṳ-dé-chê	Sejong City
Incheon	Incheon
Gyeonggi Dô̤	Gyeonggi Province
Bô-uăk-cáik	Easter
Ò̤-báe̤k	Hebei
Bŏk Hĭ-lài	Bo Xilai
GNU Cê̤ṳ-iù Ùng-dáung Hṳ̄-kō̤-céng	GNU Free Documentation License
Uŏng Cĭng-ôi	Wang Jingwei
Dìng Cūi-biēng	Chen Shui-bian
À̤	Shoe
Ngṳ̀ng-hòng	Bank
Lū Séng	Lu Xun
7	7 (number)
8	8 (number)
Lĕ̤k	Deer
Hù	Lake
Sáung-tàu	Garlic
Chái-guă	Cucumber
Dō̤	Island
Băh-sáik	White
Ŭ-sáik	Black
6	6 (number)
Moshchena	Moshchena
Huăng-kê	Tomato
George H. W. Bush	George H. W. Bush
Paltoga	Paltoga
Quảng Bình	Quảng Bình Province
Atlanta	Atlanta
Benito Mussolini	Benito Mussolini
Sṳ̀-diēng	Dictionary
Tàu	Head
Hiê-lìng-dóng	Wellington
Dâi Bók-liĕk-diĕng Dō̤	Great Britain
Las Vegas	Las Vegas
10	10 (number)
Alfred Nobel	Alfred Nobel
Tàu-sĕ̤	Comb
Guòng-lĭk	Power (social and political)
Mà-hùng-cēu	Owl
Dēng-cṳ̆ng	Hour
Ké-chiông	Meteorology
Đà Nẵng	Da Nang
Káh-chiók	Eurasian magpie
Làng-huă	Orchidaceae
Gă-săk	Cockroach
Ngáuk-ngṳ̀	Crocodilia
Lā-lì	Pangolin
Nàng-muōi-sĭng	Firefly
Holocene	Holocene
Hāi-báu	Earless seal
Bà̤-bá-cēu	Eurasian wren
Ciáh-giāng	Eurasian tree sparrow
Niccolò Cusano Dâi-hŏk	Università degli Studi Niccolò Cusano
Long An	Long An Province
Thái Nguyên	Thái Nguyên Province
Herodotus	Herodotus
Othello	Othello
Nĭk-buōng-hāi	Sea of Japan
Dĕ̤ng-ā	East Asia
Dĕ̤ng-ĕu	Eastern Europe
Vĩnh Phúc	Vĩnh Phúc Province
Chĕ̤ng	Allium fistulosum
Liù-giù-guók	Ryukyu Kingdom
Dièu-siēng uòng-dièu	Joseon
Gŏ̤-là̤	Goryeo
Dâi-hàng Dá̤-guók	Korean Empire
Buŏk-hāi-guók	Balhae
Gŏ̤-gău-là̤	Goguryeo
Bì-bà-dâu-giék	Bat
Báik-cá̤	Baekje
Sĭng-lò̤	Silla
Tàu-huók	Hair
Hàng Hĭ	Han Fei
Uòng-dá̤	Yellow Emperor
Diéu-ngṳ̀-dài Liĕk-dō̤	Senkaku Islands
Gê̤ṳng-huò-dōng (Mī-guók)	Republican Party (United States)
Mìng-ciō-dōng (Mī-guók)	Democratic Party (United States)
Cūi-tiák	European otter
Sìng-dŭ	Chengdu
Buò-gŭng-ĭng	Taraxacum
Tá	Jellyfish
Dâng-ciŭ	Zhengzhou
Cūng-tūng	President
Muāng-ciŭ-guók	Manchukuo
Gù-cŭi	Streptopelia
Só̤h	Rope
Dṳ̆ng-guók Guók-mìng-dōng	Kuomintang
Hiăng-diê ciā-muói	Sibling
Ngâng	Swan goose
Ĕng-gŏ̤	Parrot
Gŏ̤-giāng-hié	Taiwanese opera
Gă-huák	Addition
Dài-uăng-sēng	Taiwan Province
Dŏ̤	Knife
Băng-mā	Zebra
Guók-cié biĕu-cūng cṳ̆-hô̤	International Standard Book Number
Đồng Nai	Đồng Nai Province
Sóc Trăng	Sóc Trăng Province
Quảng Ngãi	Quảng Ngãi Province
Hà Tĩnh	Hà Tĩnh Province
Cà Mau	Cà Mau Province
Quảng Nam	Quảng Nam Province
Bến Tre	Bến Tre Province
Khánh Hòa	Khánh Hòa Province
Káh-gă-ngṳ̄	Hakka Chinese
Sơn La	Sơn La Province
Huŏng-ngiòng	Dialect
Lev Trotsky	Leon Trotsky
Quảng Ninh	Quảng Ninh Province
Lạng Sơn	Lạng Sơn Province
Bắc Ninh	Bắc Ninh Province
Gáng-ngṳ̄	Gan Chinese
Sṳ̆-mā Guŏng	Sima Guang
Mà-hṳ̀ng	Giant panda
Muāng-ngṳ̄	Manchu language
Chiū	Hand
Dô Hū	Du Fu
Gùng-dō̤	Archipelago
Niŏh-niŏh	Leaf
Bŭk-buó	Waterfall
Yasser Arafat	Yasser Arafat
Chṳ̆ng-sìng-ngṳ̄	Okinawan language
Câung-ngṳ̄	Standard Tibetan
Ngù-ngṳ̄	Wu Chinese
Tasmania	Tasmania
Ì-cô̤	Soap
Hŭk-săng	Foshan
Ciĕu-huò Tiĕng-huòng	Hirohito
Al-Qaeda	Al-Qaeda
Mò̤-táuk-chiă	Motorcycle
Ò̤-mā	Hippopotamus
Anastacia	Anastacia
Sĕk Gái	Ten Commandments
Huă-báu	Leopard
Să̤-ngiù	Rhinoceros
Lò̤-buàng	Compass
Buáng-dō̤	Peninsula
Sĭng-giŏng	Xinjiang
Mŭk-guă	Papaya
Mì-sĕng-só	Vitamin
Gái-làng-chái	Cabbage
Giáng	Mirror
Ciŭ-dièu	Zhou dynasty
Kāng-muòng-giāng	Window
Băh Gṳ̆ng	White House
Gīng-chák	Police
Hók-ciŭ-uâ	Fuzhou dialect
Báe̤k-hāi-dô̤	Hokkaido
Giŏng	Ginger
Nobel Huò-bìng Ciōng	Nobel Peace Prize
Sáu	Cough
Hák-chê	Sneeze
Káung-mìng	Sleep
Gèng-hāi	Aral Sea
Dé̤ṳk	Bamboo
Hù Cé-mìng	Ho Chi Minh
Hòa Bình	Hòa Bình Province
Sŭ Sék	Su Shi
Queensland	Queensland
Tù	Soil
Ù-huă-guō	Common fig
Hưng Yên	Hưng Yên Province
Dòng-dô	Length
Kon Tum	Kon Tum Province
Hậu Giang	Hậu Giang Province
Máe̤ng	Dream
Yên Bái	Yên Bái Province
Bắc Giang	Bắc Giang Province
Thừa Thiên-Huế	Thừa Thiên–Huế Province
Bắc Kạn	Bắc Kạn Province
Lai Châu	Lai Châu Province
Hà Nam	Hà Nam Province
Lào Cai	Lào Cai Province
Mìng-dĕ̤ng-ngṳ̄	Eastern Min
Hannibal	Hannibal
Mìng-báe̤k-ngṳ̄	Northern Min
Mìng-nàng-ngṳ̄	Southern Min
Thanh Hóa	Thanh Hóa Province
Kiên Giang	Kiên Giang Province
Quảng Trị	Quảng Trị Province
Nghệ An	Nghệ An Province
An Giang	An Giang Province
Tây Ninh	Tây Ninh Province
Phú Thọ	Phú Thọ Province
Duâi-sĭng-sĭng	Gorilla
Trà Vinh	Trà Vinh Province
Bạc Liêu	Bạc Liêu Province
Gia Lai	Gia Lai Province
Tiền Giang	Tiền Giang Province
Bình Phước	Bình Phước Province
Đồng Tháp	Đồng Tháp Province
Thái Bình	Thái Bình Province
Hà Giang	Hà Giang Province
Đắk Lắk	Đắk Lắk Province
Cáung-cŭk	Zhuang people
Bình Định	Bình Định Province
Lâm Đồng	Lâm Đồng Province
Đắk Nông	Đắk Nông Province
Phú Yên	Phú Yên Province
Hải Dương	Hải Dương Province
Dièu-ciŭ-uâ	Teochew dialect
Iók-hâng Hók Ĭng	Gospel of John
Dài-uăng-uâ	Taiwanese Hokkien
Muòng	Door
Chiēng-gák	Nail (anatomy)
Cao Bằng	Cao Bằng Province
Bình Dương	Bình Dương Province
Bình Thuận	Bình Thuận Province
Bà Rịa-Vũng Tàu	Bà Rịa–Vũng Tàu Province
Ninh Bình	Ninh Bình Province
Ninh Thuận	Ninh Thuận Province
Nam Định	Nam Định Province
Điện Biên	Điện Biên Province
Sìng-lṳ̀ng	Jackie Chan
Méng	Face
Ùng-ngiòng-ùng	Classical Chinese
Gāng-lāng	Olive
Săng-ôi-ék-tā̤	Trinity
Sŏng-cṳ̄	Sun Tzu
Sĭng-săng	Teacher
Cleveland	Cleveland
Dăk-lâi Lā-mà	Dalai Lama
Huă-sĕng	Peanut
100	100 (number)
Kă-kók-tàu	Knee
Hâing	Prunus armeniaca
Ngāng-giáng	Glasses
Cê̤ṳ-lài-huōi	Match
Chê-diòng	Market (economics)
Nàng Dṳ̆ng-guók Hāi	South China Sea
Dièu-siēng Sié-cŭng	Sejong the Great
Hăk-gĭng	Alloy
Bĭng-siŏng	Refrigerator
Nobel Ùng-hŏk Ciōng	Nobel Prize in Literature
Huăng-sṳ̀	Sweet potato
Uòng-hāi	Yellow Sea
Akihito	Akihito
Newton ông-dông-hŏk dêng-lŭk	Newton's laws of motion
Să̤-guă	Watermelon
Biobío Dâi-hŏk	University of the Bío Bío
Huòng-dá̤	Emperor
Ìng-mìng-bê	Renminbi
Tā̤-cék	Volume
Cèng-sáik	Orange (colour)
Gă-sĭ-huă	Tool
Ĭ-sĕng	Physician
Iéng (cēu)	Swallow
Kó	Trousers
Lô-gă Hók Ĭng	Gospel of Luke
Mìng-ciō-dōng	Democratic Party
Ciŏng-tàu	Brick
Tiō-uòng	Ellipse
Sìng-huák	Multiplication
Sé̤ṳ-dù Hèng-diông	Acts of the Apostles
Uòng-dô̤ Sĕk-nê Sĭng-cô̤	Zodiac
Huá-siŏh	Fossil
Gēng-huák	Subtraction
Cī-cī	Seed
Chiĕk	Crab
Gă-dŏ̤	Scissors
Niêu	Urine
Ăng-hŭi	Anhui
Ngiăh	Forehead
Sĭ-piĕng	Psalms
Chungcheong Báe̤k-dô̤	North Chungcheong Province
Chungcheong Nàng-dô̤	South Chungcheong Province
Gangwon Dô̤ (Dâi-hàng Mìng-guók)	Gangwon Province (South Korea)
Nô̤i Mūng-gū	Inner Mongolia
Gĭng Nĭk-sìng	Kim Il-sung
Gyeongsang Nàng-dô̤	South Gyeongsang Province
Gyeongsang Báe̤k-dô̤	North Gyeongsang Province
Jeolla Báe̤k-dô̤	North Jeolla Province
Jeolla Nàng-dô̤	South Jeolla Province
Jeju Dĕk-biék Cê̤ṳ-dé-dô̤	Jeju Province
Huăng-cièng-giāng	Coin
Bă-biĕk-ták	Tower of Babel
Ulsan	Ulsan
Gwangju	Gwangju
Chó	Vinegar
Kangwŏn Dô̤ (Dièu-siēng Mìng-ciō-ciō-ngiê Ìng-mìng Gê̤ṳng-huò-guók)	Kangwon Province (North Korea)
Michael Jordan	Michael Jordan
Lé-ê-gé	Book of Leviticus
Gṳ̆ng-gṳ̆ng	Root
Bì-bà (cūi-guō)	Loquat
Hamlet	Hamlet
Huà Guók-hŭng	Hua Guofeng
Sāng	Umbrella
Làu Hiēu-pŏ̤	Liu Xiaobo
Hók-gióng	Fujian
Mūng-gū-cŭk	Mongols
Mĕk-sê Liŏh	Book of Revelation
Hièng-câung	Xuanzang
Gū-chiŏng	Buttocks
Mìng-chòng	Bed
Hāi-nàng	Hainan
Háng-ngṳ̄ Pĭng-ĭng	Pinyin
Uōng-dĕ̤ng	Far East
Băh-gák	Rock dove
Găng-sé̤ṳk	Gansu
Taliban	Taliban
Huŏi-sáik	Grey
Sĭng-mêng-gé	Book of Deuteronomy
Sŭ-ciŭ	Suzhou
Ŭng-ciŭ	Wenzhou
Háng-cŭk	Han Chinese
Nìng-pŏ̤	Ningbo
Chói-chiŭ	Beard
Cāi-iêu	Kite
Hăk-ī-bĭng	Harbin
Mā-kì	Leech
1000	1000 (number)
Mìng-só-gé	Book of Numbers
Cáu-sèng	Kitchen
Hùng-nàng	Yunnan
Lō̤-uă	Corvus (genus)
Guók-lĭk Gău-tŭng Dâi-hŏk	National Chiao Tung University
Guók-lĭk Chĭng-huà Dâi-hŏk	National Tsing Hua University
Săng-dĕ̤ng	Shandong
È̤ng-ĕ̤ng	Centipede
Ò̤-nàng	Henan
Mì-mò̤	Eyebrow
Bók-sài	Navel
Lièu-nìng	Liaoning
Hióng-liông	Euclidean vector
Cretaceous	Cretaceous
Tochigi-gâing	Tochigi Prefecture
Chói-mò̤-cēu	Kingfisher
Dàu	Dice
Cūi-nà̤	Cement
Gék-lìng	Jilin
Dĕ̤ng Dṳ̆ng-guók Hāi	East China Sea
Hāi-chĕk	Piracy
Gūi	Ghost
Lè̤ng-ū Huòng-dá̤	Zhu Yujian
Bóng-dó̤	Waste
Hù-nàng	Hunan
Jurassic	Jurassic
Chĭng-hāi	Qinghai
Mì-ngù-ī-cŭk	Uyghur people
Ă-piéng	Opium
Chiū-cī	Ring (jewellery)
Hù-báe̤k	Hubei
Săng-să̤	Shanxi
Cĕ̤ng-sáik	Brown
Giòng-găng	Rape
Gói-ciŭ	Guizhou
Triassic	Triassic
Sék-sáuk	Cricket (insect)
Cāi-piéu	Banknote
SQL	SQL
Hù Sék	Hu Shih
Iók-cṳ̆-ā-gé	Book of Joshua
Cŏng-cṳ̄	Zhuang Zhou
Cṳ̀-hĭ Tái-hâiu	Empress Dowager Cixi
Kan Naoto	Naoto Kan
Miyagi-gâing	Miyagi Prefecture
模板:Commons category	Template:Commons category
Lò̤-mā Cṳ̆	Epistle to the Romans
Pău-ŭk-siáng	Parabola
Dô̤-dáik	Morality
Iwate-gâing	Iwate Prefecture
Ĭ-siòng-chiă	Sewing machine
Dièu-siēng Lò̤-dông-dōng	Workers' Party of Korea
Nàng-báe̤k-dièu	Southern and Northern Dynasties
Chái Ĭ-lìng	Jolin Tsai
Pì-lĭk-bī Cṳ̆	Epistle to the Philippians
Ngā-gŏ-cṳ̆	Song of Songs
Mā-lăk-gĭ-cṳ̆	Book of Malachi
模板:Taxobox	Template:Taxobox
分類:Guók-uòng	Category:Kings
分類:Gŭng-ciō	Category:Monarchs
Diŏng Ngiê-mèu	Zhang Yimou
模板:Dṳ̆ng-guók lĭk-sṳ̄	Template:History of China
Gĭng Céng-ŏng	Kim Jong-un
Liù-giù-ngṳ̄	Ryukyuan languages
Mìng-dṳ̆ng-ngṳ̄	Central Min
Céng-ngṳ̄	Jin Chinese
Mìng-ngṳ̄	Min Chinese
Buò-siĕng-ngṳ̄	Pu-Xian Min
Dài-uăng Mìng-nàng-ngṳ̄ Lò̤-mā-cê Pĭng-ĭng Huŏng-áng	Taiwanese Romanization System
Gŏng-să̤	Jiangxi
Dài-uăng-sēng (Dṳ̆ng-huà Ìng-mìng Gê̤ṳng-huò-guók)	Taiwan Province, People's Republic of China
Nìng-hâ	Ningxia
Lùng-sùng	Dragon boat
Noda Yoshihiko	Yoshihiko Noda
Yingluck Shinawatra	Yingluck Shinawatra
Siŏh-gă-cŏng	Shijiazhuang
Kuóh-dà̤	Fuzhou Tanka
Chṳ̄	Muroidea
Ciŏ-hāi	Zhuhai
Sáng-tàu	Shantou
Dâng-gŏng	Zhanjiang
Mùi-ciŭ	Meizhou
Chĭng-uōng	Qingyuan
Dĕ̤ng-uāng	Dongguan
Dṳ̆ng-săng-chê	Zhongshan
Dièu-ciŭ	Chaozhou
Tàng-táik	Catfish
Gé̤ṳk-huă	Chrysanthemum
Mĕ̤k-lê-huă-dà	Jasmine tea
Sofie gì Sié-gái	Sophie's World
Ordovician	Ordovician
Silurian	Silurian
Hók-gióng-sēng (Dṳ̆ng-huà Mìng-guók)	Fujian Province, Republic of China
Mièu-lĭk	Miaoli County
Dāng-nòng	Gallbladder
Devonian	Devonian
Hók-ciŭ	Fuzhou
Nàng-bìng	Nanping
Buò-dièng	Putian
Săng-mìng	Sanming
Ciòng-ciŭ	Quanzhou
Â-muòng	Xiamen
Ciŏng-ciŭ	Zhangzhou
Lṳ̀ng-ngàng	Longyan
Nìng-dáik	Ningde
Să̤-nìng	Xining
Să̤-iù-gé	Journey to the West
Săng-guók Iēng-ngiê	Romance of the Three Kingdoms
Cūi-hū	Water Margin
Ā-dŏng	Adam
Aomori-gâing	Aomori Prefecture
Fukushima-gâing	Fukushima Prefecture
Tái-nguòng	Taiyuan
Hải Phòng	Haiphong
Sĭng-dé̤ṳk (gâing)	Hsinchu County
Dâi-lièng	Dalian
Hĭ-Pŏ̤ Ciéng-cĕng	Greco-Persian Wars
Permian	Permian
Biēu-chĭng	Cousin
Cambrian	Cambrian
Iòng-ciók	Candle
Chiba-gâing	Chiba Prefecture
Pău	Pomelo
Lô-dáik-gé	Book of Ruth
Mà-hù	Dragonfly
Dáng-ī-lī	Book of Daniel
Páuk-káik	Poker
Mô̤	Hat
Gŏ̤-lìng-dŏ̤ Cièng Cṳ̆	First Epistle to the Corinthians
Aichi-gâing	Aichi Prefecture
Lī-ngṳ̀	Common carp
Muāng-ciŭ	Manchuria
Sê̤ṳ-sṳ-gé	Book of Judges
Pŏ̤-lìng-chái	Spinach
Akita-gâing	Akita Prefecture
Pièu-gĕng	Spoon
Dê̤ṳ	Chopsticks
Mĕ̤k-lê	Jasmine
Nàng-dàu	Nantou County
Gié-tiàng-chiă	Taxicab
Â-hài	Chin
Gŭ	Mushroom
Ibaraki-gâing	Ibaraki Prefecture
Lài-gŭng	Thunder
Siĕu-sŏng	Nitric acid
Ngù-giāng-kó	Jeans
Bō̤-siŏh	Gemstone
Lièu-că̤ Cé-ê	Strange Stories from a Chinese Studio
Gáu-kuŏ-cṳ̆	Textbook
Chāu-māng	Grasshopper
Dâng Gĭng	Zheng Jing
Diòng-chŭng	Changchun
Milan Kundera	Milan Kundera
Lâung	Egg (food)
Ū-ì-săng-chê	Wuyishan, Fujian
Lĕ̤k-sé Sê̤ṳ-giông	Tiananmen Square protests of 1989
Diêu Ciē-iòng	Zhao Ziyang
Hù Iêu-băng	Hu Yaobang
Fukuda Yasuo	Yasuo Fukuda
Sṳ̀ng-chéu (Sṳ̀ng-báh)	Pinaceae
Gī-hò̤-chiă	Compass (drawing tool)
Táng-sŏng	Carbonic acid
Liòng-chióh	Ruler
Chăng-màng-chṳ̄	Talpidae
Dṳ̆ng-hâ Iâ cĭ Máe̤ng	A Midsummer Night's Dream
Tié-tàu-să-hô	Barber
Mā-kō̤ Hók Ĭng	Gospel of Mark
Diê (dông-ŭk)	Oyster
Kaesŏng	Kaesong
Hwanghae Báe̤k-dô̤	North Hwanghae Province
P'yŏng'an Báe̤k-dô̤	North Pyongan Province
Hamgyŏng Báe̤k-dô̤	North Hamgyong Province
Hamgyŏng Nàng-dô̤	South Hamgyong Province
P'yŏng'an Nàng-dô̤	South Pyongan Province
Namp'o	Nampo
Ryanggang Dô̤	Ryanggang Province
Tò̤-huòng	Taoyuan City
Sŭk-mī	Glutinous rice
Nguòng-siĕu-uòng	Tangyuan (food)
Gĭng-dŭ	Kyoto Prefecture
Ōsaka-hū	Osaka Prefecture
Cék-ngṳ̀	Goldfish
Fukuoka-gâing	Fukuoka Prefecture
Ehime-gâing	Ehime Prefecture
Gŏ̤-lìng-dŏ̤, Hâiu Cṳ̆	Second Epistle to the Corinthians
Gàu-ūng	Earthworm
Sā̤-ĭ-gĭ	Washing machine
Gék	Mandarin orange
Gé̤ṳ	Saw
Yamagata-gâing	Yamagata Prefecture
Éu-dê-huòng	Kindergarten
Dài-uăng Hāi-hiĕk	Taiwan Strait
Lù-guói	Aloe
Yamaguchi-gâing	Yamaguchi Prefecture
Kanagawa-gâing	Kanagawa Prefecture
Nagano-gâing	Nagano Prefecture
Iĕng-huă	Fireworks
Mì-pŏ̤-lù	Microwave oven
Saitama-gâing	Saitama Prefecture
Mie-gâing	Mie Prefecture
Hĭ-báik-lài Cṳ̆	Epistle to the Hebrews
Gă-lăk-tái Cṳ̆	Epistle to the Galatians
Muàng-ngṳ̀	Eel
Céng-gŏng	Jinjiang, Fujian
Siŏng-dièu	Shang dynasty
Gunma-gâing	Gunma Prefecture
Hyōgo-gâing	Hyōgo Prefecture
Miyazaki-gâing	Miyazaki Prefecture
Kumamoto-gâing	Kumamoto Prefecture
Ă-cì	Cicada
Koizumi Jun'ichirō	Junichiro Koizumi
Ī-sê̤ṳ-táik-cṳ̆	Book of Esther
Diòng-dô-cṳ̆	Ecclesiastes
Hatoyama Yukio	Yukio Hatoyama
Gŏ̤-lò̤-să̤ Cṳ̆	Epistle to the Colossians
Ngā-gáuk Cṳ̆	Epistle of James
Iók-hâng Ék Cṳ̆	First Epistle of John
Pì-lé-muòng Cṳ̆	Epistle to Philemon
Táik-sák-lò̤-nà̤-giă, Hâiu Cṳ̆	Second Epistle to the Thessalonians
Táik-sák-lò̤-nà̤-giă Cièng Cṳ̆	First Epistle to the Thessalonians
Bī-dáik Cièng Cṳ̆	First Epistle of Peter
Bī-dáik Hâiu Cṳ̆	Second Epistle of Peter
Tì-mò̤-tái Cièng Cṳ̆	First Epistle to Timothy
Dòng-lòng	Mantis
Gifu-gâing	Gifu Prefecture
Ishikawa-gâing	Ishikawa Prefecture
Nara-gâing	Nara Prefecture
Wakayama-gâing	Wakayama Prefecture
Shizuoka-gâing	Shizuoka Prefecture
Shiga-gâing	Shiga Prefecture
Iók-hâng Nê Cṳ̆	Second Epistle of John
Ī-suói-ā-cṳ̆	Book of Isaiah
Iók-hâng Săng Cṳ̆	Third Epistle of John
Iù-dâi Cṳ̆	Epistle of Jude
Tì-mò̤-tái Hâiu Cṳ̆	Second Epistle to Timothy
Tì-dŏ̤ Cṳ̆	Epistle to Titus
Nùng-mìng	Farmer
Ià-lé-mī-cṳ̆	Book of Jeremiah
Ī-sê̤ṳ-lá-cṳ̆	Book of Ezra
Nà̤-hĭ-mī-cṳ̆	Book of Nehemiah
Iók-ngī-cṳ̆	Book of Joel
Băh-lô	Little egret
Chŭng-cáik	Chinese New Year
Sō-siè	Key (lock)
Abe Shinzō	Shinzō Abe
Asō Tarō	Tarō Asō
Séng-cṳ̆-tā̤	Egyptian hieroglyphs
Niigata-gâing	Niigata Prefecture
Yamanashi-gâing	Yamanashi Prefecture
Shimane-gâing	Shimane Prefecture
Toyama-gâing	Toyama Prefecture
Okayama-gâing	Okayama Prefecture
Kă-tōi	Leg
Piăng	Human back
Piĕ	Letter (message)
Sáik-màng	Color blindness
Carboniferous	Carboniferous
Ciŏng-huá	Changhua County
Fukui-gâing	Fukui Prefecture
Ōita-gâing	Ōita Prefecture
Tottori-gâing	Tottori Prefecture
Nùng-lĭk	Chinese calendar
Kōchi-gâing	Kōchi Prefecture
Uâng-iū īng-lĭk dêng-lŭk	Newton's law of universal gravitation
Chèng-gēng	Bombyx mori
Dài-uăng Nĭk-buōng Sì-dâi	Taiwan under Japanese rule
Páuk Gê̤ṳng-hiê	Park Geun-hye
Dài-nàng	Tainan
Cĕng	Sewing needle
Muāng-cŭk	Manchu people
Kìng-giāng	Pliers
Anna Karenina	Anna Karenina
Tài-nè̤ng	Homicide
Gáung-gṳ̆ng	Rebar
Tiè-mà	Crying
Swadesh hŏk-sĭng-sṳ̀ liĕk-biēu	Swadesh list
Dŭng-nìng-guók	Kingdom of Tungning
Hùng-lìng	Yunlin County
Kă-cāi	Toe
Lāng	Saliva
Diò-să-hô	Cook (profession)
Bĭng-lòng	Areca catechu
Dâi-céng Tiĕng-huòng	Emperor Taishō
Băng-sièng Lā-mà	Panchen Lama
Mŭk-gê̤ṳng	Hibiscus syriacus
Muòi-huă	Prunus mume
Cĕ̤ng-chéu	Trachycarpus fortunei
Muòi-kṳ̄ng	Mold
Gĭng-cá̤	Economy
Sĕ̤ng-săng-giāng	Twin
Mĕ̤k-tiák	Eyelash
Nguòng-cṳ̄-bék	Ballpoint pen
Norodom Sihanouk	Norodom Sihanouk
Saga-gâing	Saga Prefecture
Tokushima-gâing	Tokushima Prefecture
Lòng-dâung	Hyoscyamus niger
Lòi-sĭ-gā	Screwdriver
Kēng-muōi-dăi	Foxtail millet
Sĭk-sĭk	Wing
Kagawa-gâing	Kagawa Prefecture
Mū-dăng	Paeonia suffruticosa
Thaksin Shinawatra	Thaksin Shinawatra
Uòng-dăi	Proso millet
Kê	Diospyros
Săng-guók (Dièu-siēng)	Three Kingdoms of Korea
Bék	Pen
Ŭng-dìng	Dust
Huăng-siŏh-liù	Psidium guajava
Duâi-tàu-giáng	Magnifying glass
Gă-ngiê (gâing)	Chiayi County
Ĭ-gŭng	Grandparent
Puái-dáu	Noon
Huōi-căi	Conflagration
Chiū-ló̤h	Glove
Nagasaki-gâing	Nagasaki Prefecture
Hâ-dièu	Xia dynasty
Cá̤-nàng	Jinan
Dṳ̆ng-guók Káung-nĭk Ciéng-cĕng	Second Sino-Japanese War
Sarawak	Sarawak
Hŭng-cūi	Feng shui
Chiéu	Laughter
Ngô̤-mâng gâe̤ng Piĕng-giéng	Pride and Prejudice
Oda Nobunaga	Oda Nobunaga
Dăng-hù	Coral
Lī Sìng-uāng	Syngman Rhee
Iòng-bék-chó̤	Eraser
Nàng-chiŏng	Nanchang
Tokugawa Ieyasu	Tokugawa Ieyasu
Bók-séu-gáung	Stainless steel
Sáu-chiū	Broom
Dŭk-cài	Autocracy
Kŭng-dièu	Air conditioning
Diòng-să	Changsha
Pèng	Paint
Mìng-dê Tiĕng-huòng	Emperor Meiji
Kă-âu-dăng	Heel
Ā-mò̤-sê̤ṳ-cṳ̆	Book of Amos
Ŏ̤-bă-dī-ā-cṳ̆	Book of Obadiah
Itō Hirobumi	Itō Hirobumi
Nguŏh	Jade
Dâu-hô	Tofu
Mì-hèu	Macaque
Mī-giă-cṳ̆	Book of Micah
Bù-sák	Bodhisattva
Hăk-gĭ-cṳ̆	Book of Haggai
Ī-să̤-giék	Book of Ezekiel
Chiū-biēu	Watch
ASP.NET	ASP.NET
Iók-nā-cṳ̆	Book of Jonah
Sabah	Sabah
Ià-lé-mī-ăi-gŏ̤	Book of Lamentations
Tái-gáng	Eunuch
Nàng-nìng	Nanning
Ê-só	Monosodium glutamate
Nā-ŭng-cṳ̆	Book of Nahum
Hăk-bă-gók-cṳ̆	Book of Habakkuk
Sák-gā-lé-ă-cṳ̆	Book of Zechariah
Guók-gê̤ṳng Nô̤i-ciéng	Chinese Civil War
Uŏk-nàng Gê̤ṳng-huò-guók	South Vietnam
Chiĕu-chê	Supermarket
Ciŏng Cṳ̄-ì	Zhang Ziyi
Lák-tàu	Baldness
Gulliver Lṳ̄-hèng-gé	Gulliver's Travels
Gŏ̤-hṳ̀ng	Kaohsiung
Naha-chê	Naha
Buŏk-hāi	Bohai Sea
Báh-chói	Yawn
Hâung Ṳ̄	Xiang Yu
Putrajaya	Putrajaya
Kŏng-mìng	Kunming
Nĭk-guŏng-dĕng	Fluorescent lamp
Jane Eyre	Jane Eyre
Johor	Johor
Ngâung	Intellectual disability
Huòi-cŭk	Hui people
Làng-ciŭ	Lanzhou
Hŏ̤-să̤-cṳ̆	Book of Hosea
Tiék-cĭng	Rust
Dĕ̤ng-kiĕ	Cuttlefish
Lìng Cáik-sṳ̀	Lin Zexu
Săng-guók	Three Kingdoms
Chŭng-chiŭ Sì-dâi	Spring and Autumn period
Ciéng-guók Sì-dâi	Warring States period
Puō-ngì	Puyi
Mā-lăk-gă	Malacca
Oracle	Oracle Database
Hăk-bùi	Hefei
Huák-lùng-gŭng	Falun Gong
Kelantan	Kelantan
Lŏk-iòng	Luoyang
Toyotomi Hideyoshi	Toyotomi Hideyoshi
Kana	Kana
Câung-cŭk	Tibetan people
Pulau Pinang	Penang
Hamasaki Ayumi	Ayumi Hamasaki
Să̤-huăng-ngā-cṳ̆	Book of Zephaniah
Dâi-nĭk-buōng Dá̤-guók	Empire of Japan
Hṳ̆ng-nù	Xiongnu
Mâing-cṳ̄	Mencius
Kedah	Kedah
Perak	Perak
Hŏk-ôi	Academic degree
Gié-lìng	Guilin
Terengganu	Terengganu
Selangor	Selangor
Iòng (dông-ŭk)	Caprinae
Hāi-kāu	Haikou
Chāu-buōng sĭk-ŭk	Herbaceous plant
Pahang	Pahang
Bă-là̤ Séng-mū-iêng (Siēu-siók)	The Hunchback of Notre-Dame
Chiông-gì	Xiangqi
Yun Chi-ho	Yun Chi-ho
Gói-iòng	Guiyang
Gáung-bék	Fountain pen
Ngù Dìng-iēng	Ngo Dinh Diem
Gô-dā̤	Past
Dĭng-hiŏng-kó̤	Anchovy
Miêng	Noodle
Hiêng-câi	Present
Lèng-gēng	Longan
Mì-lĕk-hŭk	Maitreya
Guăng-ĭng	Avalokiteśvara
Bìng-dĕ̤ng	Pingtung County
Gēu-gī	Lycium barbarum
Lĕ̤k-dèu-gáuk	Rib
Ciŏng-bìng	Zhangping
Ciŏng-puō	Zhangpu County
Ciéu-ăng	Zhao'an County
Dâng Sìng-gŭng	Koxinga
Céng-huò	Zhenghe County
Ciá-ìng	Zherong County
Nguŏk-biāng	Mooncake
Ciŭ Īng-kŏng	Zhou Yongkang
Ciŭ-nìng	Zhouning County
Cṳ̆-gák Liông	Zhuge Liang
Ció-ĭng Hù-hô̤	Bopomofo
Tù-kēng	Mole cricket
Dṳ̆ng-guók Ìng-mìng Gāi-huóng-gŭng	People's Liberation Army
Sìng-ū Tiĕng-huòng	Emperor Jimmu
Kūng-chiók	Peafowl
Ciē-chái	Nori
Dennis Rodman	Dennis Rodman
È̤ng-dà	Black tea
Cò̤ Chó̤	Cao Cao
Lièng-gŏng	Lianjiang County
Tài-tàu	Decapitation
Cūi-ngù	Longhorn beetle
Hiŏng-siàng	Xiangcheng District, Zhangzhou
Buŏi	Flight
Ŭi-nà̤-sṳ̆ Sĕng-lī-nè̤ng	The Merchant of Venice
Ū-ì-săng	Wuyi Mountains
Ŭ-sŭ-lī-gĕ̤ng	Ussuri River
Dĕ̤ng-cé	Winter solstice
Tiĕng-huòng	Emperor of Japan
Kăi-hŭng	Kaifeng
Sĭng-dài-bê	New Taiwan dollar
Mièu-cŭk	Miao people
Nguòng Sié-kāi	Yuan Shikai
Gă-lṳ̀ng Huòng-dá̤	Gia Long
John Wesley	John Wesley
Siăh	Eating
Perlis	Perlis
Negeri Sembilan	Negeri Sembilan
Labuan	Labuan
Lṳ̀ng	Chinese dragon
Iòng-iù-gàu	Kerosene lamp
Cần Thơ	Cần Thơ
Gĭng-cŭk	Vietnamese people
Ciĕng-bò̤	Champa
Diòng-gáu-sê̤ṳ	Missionary
Uōng-dâi Cièng-tiàng	Great Expectations
Niōng-bēng	Ceiling
Rasŏn	Rason
Guăng Ṳ̄	Guan Yu
Ŭ-gŭi	Turtle
Tá̤	Drawer (furniture)
Gê̤ṳng-huò-dōng	Republican Party
Bō̤-dâi Huòng-dá̤	Bảo Đại
Siê-iù	Soy sauce
Ŭ-lṳ̀ng-dà	Oolong
Huōi-lṳ̀ng-guō	Pitaya
Gê̤ṳng-sāng-dōng	Communist party
Chái Ĭng-ùng	Tsai Ing-wen
Băh-cṳ̄ng-nè̤ng	White people
Ŏ̤-mì-tò̤-hŭk	Amitābha
Ngiè-làng	Yilan County, Taiwan
Ciŭ Giĕk-lùng	Jay Chou
Orhan Pamuk	Orhan Pamuk
Hà-puō	Xiapu County
Carpineto Romano	Carpineto Romano
Ngū-dâi Sĕk-guók	Five Dynasties and Ten Kingdoms period
Cō̤	Jujube
Tā̤-ṳ̆k	Physical education
Sĭng-báe̤k	New Taipei City
Dài-dṳ̆ng	Taichung
Làu Bê	Liu Bei
Huă-lièng	Hualien County
Gĭng-muòng	Kinmen
Dài-dĕ̤ng	Taitung County
Sĭng-dé̤ṳk (chê)	Hsinchu
Gă-ngiê (chê)	Chiayi City
Giĕ-lè̤ng	Keelung
Săi	Sai
Jun Ji-hyun	Jun Ji-hyun
Ngiè	Domestic goose
Dièu-siēng Gŏ̤-cŭng	Gojong of Korea
Hók-chiăng	Fuqing
Gáuk-gáuk	Bone
Amuro Namie	Namie Amuro
Diêng-tù	Battery (electricity)
Gê̤ṳ-gê̤ṳ	Crutch
Nakashima Mika	Mika Nakashima
Hù-lì-mà	Siberian weasel
Gŏ̤-ák-guŏ	Pressure cooking
Chagang Dô̤	Chagang Province
Óng-chái	Ipomoea aquatica
Ké̤ṳk-siăh	Begging
Sŏng-ngù	Eastern Wu
Băh-cŭk	Bai people
Siông Cĭng	Shō Shin
Mùi-liĕk	Meilie District
Â-dáu	Afternoon
Huòng Tái-gĭk	Hong Taiji
Guŏng-sê̤ṳ Huòng-dá̤	Guangxu Emperor
Alan Dawa Dolma	Alan Dawa Dolma
Ngù-mō̤-ngù-giāng	Snail
Takeshi Kaneshiro	Takeshi Kaneshiro
Sông-dê Huòng-dá̤	Shunzhi Emperor
Nū-ī-hăk-cà̤	Nurhaci
Iòng-muòi	Myrica rubra
Sŏng Guòng	Sun Quan
Cò̤ Pī	Cao Pi
Ciōng Gĭng-guók	Chiang Ching-kuo
Uòng Mì	Wang Wei (8th-century poet)
Lī Dĕng-hŭi	Lee Teng-hui
Ṳ̆ng-céng Huòng-dá̤	Yongzheng Emperor
Dùng-dê Huòng-dá̤	Tongzhi Emperor
Dŭng-huòng	Dunhuang
Să-mŏk	Erg (landform)
Hiŏng-iòng-guă	Chayote
Uòng Ăng-sĭk	Wang Anshi
Tokugawa Yoshimune	Tokugawa Yoshimune
Săng-ā	Sanya
Dài-uăng Mìng-ciō-guók	Republic of Formosa
Seo Jae-pil	Seo Jae-pil
Guók-ngṳ̄	National language
Sṳ̆k-háng	Shu Han
Cò̤-ngôi	Cao Wei
Hiŏng-gŭ	Shiitake
Mŭk-ngī	Auricularia auricula-judae
Sā̤-tŏng	Bathing
Gă-kéng Huòng-dá̤	Jiaqing Emperor
Páuk Hièng-īng	Pak Hon-yong
Dièu-siēng Sié-cū	Sejo of Joseon
Dô̤-guŏng Huòng-dá̤	Daoguang Emperor
Hièng-hŭng Huòng-dá̤	Xianfeng Emperor
Hùng Séu-ciòng	Hong Xiuquan
Gĭng-kiŏk	Peking opera
Bău Cīng	Bao Zheng
Duâi-siók	Daxue (solar term)
Báik-guá	Bagua
Sṳ̆-mā Hé	Sima Yi
Áng-pŭng	Emerald cockroach wasp
Hŭng-sṳ̆k	Convention (norm)
Ièu-cŭk	Yao people
Bĭng-sĭng	Bingxin
Biék	Trionychidae
Dièu-siēng Tái-cū	Taejo of Joseon
Báik-nguŏk-cáik	Mid-Autumn Festival
Guŏng-Dṳ̆ng Huòng-dá̤	Nguyễn Huệ
Lò̤ Giĕk-sôi	Jerry Norman
Ngà̤ Táuk-sĭng	Watchman Nee
Liŏh-chiông-gĭ	Videocassette recorder
Dâng-chái	Mytilidae
Gā-cō̤	Flea
Dài-uăng Muāng-chĭng Sì-dâi	Taiwan under Qing rule
Mā-tái Hók Ĭng	Gospel of Matthew
Sĕk-cê-gá	Christian cross
Tè̤ng-chō̤	Ophiocordyceps sinensis
Ī-hók-sū Cṳ̆	Epistle to the Ephesians
Sìng	Sing
Mā-cū (Sìng)	Mazu (goddess)
Mìng	Ming (disambiguation)
Uŏk-nàng Gê̤ṳng-sāng-dōng	Communist Party of Vietnam
10000	10000 (number)
Kū-guă	Momordica charantia
Mìng-miâng Huòng-dá̤	Minh Mạng
Chék Gié-guŏng	Qi Jiguang
Dĭk Ìng-giĕk	Di Renjie
Dṳ̆ng-huà Mìng-guók Guók-gŭng	Republic of China Armed Forces
Ì-cŭk	Yi people
Gāu-nguŏk-gāu	Double Ninth Festival
Dâing Lâ̤-gŭng	Teresa Teng
Mìng-sìng Huòng-hâiu	Empress Myeongseong
Natsukawa Rimi	Rimi Natsukawa
Lṳ̄ Séu-lièng	Annette Lu
Sṳ̀ng-chéu (Hók-ciŭ chê-chéu)	Banyan
Sê̤ṳ-dáik Huòng-dá̤	Tự Đức
Lìng Hŭi-ĭng	Lin Huiyin
Cṳ̀-ciŏng	Tile
Ngù Săng-gié	Wu Sangui
Hĭng-sŏng Dâi-iêng-gŭng	Heungseon Daewongun
Gŏ̤ Dé-sêng	Gao Zhisheng
Dêu-uòng	King Zhou of Shang
Hàng Hàng	Han Han
Hók-ciŭ Dâi-hŏk	Fuzhou University
Huăng-giāng	Alien (law)
Tiăng-dŏng	Living room
Ók-dāu	Clothes iron
Liŏh-dà	Green tea
Liŏh-dâu	Mung bean
Dièu-siēng-cŭk	Koreans
Yu Kil-chun	Yu Kil-chun
Mò̤-bék	Ink brush
Páuk Hông-ciŏ	Pak Pong-ju
Hŭk-dáng Dâi-hŏk	Fudan University
Kŭmgang-săng Guăng-guŏng Dê-kṳ̆	Mount Kumgang Tourist Region
Páuk Dṳ̀ng-iòng	Park Jung-yang
Lêng Gié-hĕk	Ling Jihua
Hòng-ciŭ Să̤-hù	West Lake
Gă-săk-giāng	City car
Gái-chái	Brassica juncea
Siông-hāi Gău-tŭng Dâi-hŏk	Shanghai Jiao Tong University
Bù-sìng	Muscidae
Diŏng Hiēu-kĭng	Tiong Hiew King
Ciū-ciòng	Jiuquan
Hŭ-huò-hô̤-dĕk	Hohhot
Ngù Chĭng-nguòng	Go Seigen
Hà-iù	Fish sauce
Băh-ngiê	Termite
Băh-uâ-cê	Pe̍h-ōe-jī
Ngièng Hók	Yan Fu
Páu-diông	Firecracker
Hṳ̆ng-dòng	Thorax
Mā-cū (Dō̤)	Matsu Islands
Ăng-kă̤	Anxi County
Să̤-cŏng	Suit (clothing)
Ìng-cṳ̄	Son of man
Hiroshima-gâing	Hiroshima Prefecture
Chiēng-cāi	Finger
Hwanghae Nàng-dô̤	South Hwanghae Province
Hók-tīng	Fuding
Siĕu-ciū	Baijiu
Dùng-cé	Comrade
Hŭng-tiŭ	Bicycle pump
Gióng-iòng	Jianyang District
Dáng-mìng	Tanka people
Mìng-kă̤	Mingxi County
Guōng-guă	Winter melon
Sīng Bō̤-dĭng	Shen Baozhen
Hùng-siĕu	Yunxiao County
Káh-gă	Hakka people
Bâng-ā	Muteness
Nàng-gĭng Dâi-hŏk	Nanjing University
Gìng-ièu	Chiung Yao
Chék-nguŏk-buáng	Ghost Festival
Uòng Sĭng-lìng	Cyndi Wang
Hù-siŭ	Pond loach
Cò̤ Sĭk	Cao Zhi
Ciŭ Ùng-uòng	King Wen of Zhou
Huò-sĭng	Heshen
Bō̤-sĕng Dâi-dá̤	Baosheng Dadi
Siĕ Lòng	Shi Lang
Giŏng Tái-gŭng	Jiang Ziya
Dìng Bō̤-tĭng	Chen Baochen
Tái-sông	Taishun County
Diêu Dò̤	Zhao Tuo
Dâng Dùng	Jana Ueekata
Chŏng-nàng	Cangnan County
Mìng-nàng-nè̤ng	Hoklo people
Lī Siòng-sêu	Witness Lee
Ngṳ̀-uòng	Fish ball
Lìng Sĕng	Lin Sen
Lī Còng-hé̤ṳk	Li Cunxu
Siĕ Mìng-dáik	Shih Ming-teh
Uòng Sīng-dĭ	Wang Shenzhi
Chái-tàu-guōi	Turnip cake
Buò-gì	Livistona chinensis
Lī Lièng-ĭng	Li Lianying
Cūi-giĕ	Chinese edible frog
Dìng Gēng	Trần Thái Tông
Dièu-siēng Buáng-dō̤ lĭk-sṳ̄	History of Korea
Cáe̤ng	Zongzi
Iù-cák-guōi	Youtiao
Sinŭiju Dĕk-biék Hèng-céng-kṳ̆	Sinuiju Special Administrative Region
Guók-lĭk Dṳ̆ng-iŏng Dâi-hŏk	National Central University
Tūng-ék Sĭng-lò̤	Unified Silla
Sák Déng-bĭng	Sa Zhenbing
Dìng Gīng-ê̤ṳng	Chen Jingrun
ISO 639-1	ISO 639-1
Lìng Chṳ̆	Lin Shu
Huá-huá	Crested myna
Mī-hūng	Rice vermicelli
Háng-cê Ùng-huá-kuŏng	East Asian cultural sphere
Lī Gŭng-ūng	Lý Thái Tổ
Hók-gióng tū-làu	Fujian Tulou
Dṳ̆ng-huà Dâi-hŏk	Chung Hua University
Chĭng-mìng	Qingming Festival
Nê-hù	Erhu
Pū-tŭng-uâ	Standard Chinese
Siă-cŭk	She people
Mē̤ng-giāng	Drain fly
Mĭk-pŭng	Apidae
Okinawa-gâing	Okinawa Prefecture
Diòng-lŏ̤h	Changle
Nàng-ā	South Asia
Báh-uŏk	Baiyue
Guòng-lé	Rights
Gióng-nìng	Jianning County
Gŭng-sĭ	Company
Tŏng-diè-dáing	Public bathing
Tì-kŭ	Chub mackerel
Ŭ-cṳ̄ng-nè̤ng	Black people
Nàng-uŏk-guók	Nanyue
Hâ-uă	Eve
Chèng-chṳ̄	Arvicolinae
Kiŏng-cŭk	Qiang people
Uòng-lièng	Coptis chinensis
Chèng	Arable land
Wiki Bô-lâung-diòng	Wikimedia Incubator
Chái Ŭng	Sai On
Nà̤-gŭ	Bhikkhuni
Guŏng-biāng	Kompyang
Bĭng-dê̤ṳ	Ice pop
Wikipedia:Sū-iū ngṳ̄-ngiòng bēng-buōng gì Wikipedia	List of Wikipedias
Ngṳ̆k-huòng-dâi-dá̤	Jade Emperor
Ngù-sāi-gŭi	Dung beetle
Chiók	Drinking
À̤-liák	Slipper
Lī-dièu	Lý dynasty
Cé̤ṳk	Congee
Dĕ̤ng-cáik	Dongzhi Festival
Mìng-ciō Céng-buô-dōng	Democratic Progressive Party
Siông Mŭk	Shō Boku
Siông Dáik	Shō Toku
Siông Nguòng	Shō Gen
Siông Ṳ̆k	Shō Iku
Siông Nìng	Shō Nei
Ì-cô̤-hūng	Laundry detergent
Tĕng	Solenidae
Pàng-hù Gùng-dō̤	Penghu
Hāi-chŏng	Haicang District
Muōi-sì	Eleocharis dulcis
Hāi-nàng-ngṳ̄	Hainanese
Dĕ̤ng-săng	Dongshan County
Cĭk-mī	Jimei District
Mìng-gĕ̤ng	Min River (Fujian)
Dùng-ăng	Tong'an District
Dài-gĕ̤ng	Taijiang District
Lṳ̀ng-hāi	Longhai City
Siŏh-săi	Shishi, Fujian
Siòng-ăng	Xiang'an District
Mìng-âu	Minhou County
Siêu-ū	Shaowu
Ôi	Stomach
Chŏng-săng	Cangshan District
Măh Lé-huò	Robert Samuel Maclay
Siông Géng	Shō Kei
Hāi-gēu	Fur seal
Sibu	Sibu
Lù Gŭng-mìng	Justus Doolittle
Siông Ŭng	Shō On
Lū-bék	Light-vented bulbul
Ciŭ Ū-uòng	King Wu of Zhou
Diòng-tái	Changtai County
Diòng-tĭng	Changting County
Cṳ̆-dó̤h	Desk
Siàng-siŏng	Chengxiang District
Chèng-lòi	Viviparidae
Nàng-hāi	南海
Siông Ièng	Shō En
Lī-siàng	Licheng District, Quanzhou
Ciòng-gē̤ng	Quangang District
Siông Hô̤	Shō Kō
Niŏh-hâ-ciŏ	Phyllanthus urinaria
Ĕ̤ng-ngiê	Tetramorium
Chiă-ngò̤	Meretrix lusoria
Aragaki Yui	Yui Aragaki
Siông Chĭng	Shō Sei
Siông Tái-giū	Shō Taikyū
Sô̤i	Sitting
Siĕu	Dizi (instrument)
Lĭk-chiŭ	Liqiu
Mā-lái-iè	Heteropoda venatoria
Duâi-sṳ̄	Dashu
Sŏng-gáung	Shuangjiang (solar term)
Chṳ̄-sṳ̄	Chushu
Mòng-cṳ̄ng	Mangzhong
Sêu-nìng	Shouning County
Káh-dièu	Play (activity)
Lŏk-gŏng	Luojiang District
Â-muòng Dâi-hŏk	Xiamen University
Dô̤-sê̤ṳ	Daoshi
Kŭ-chèng	Gutian County
Dâi-dièng	Datian County
Dáik-huá	Dehua County
Siēu-sṳ̄	Xiaoshu
Siēu-siók (cáik-ké)	Xiaoxue
Siēu-hàng	Xiaohan
Cáik-ké	Solar term
Siēu-muāng	Xiaoman
Băh-ló	Bailu
Lĭk-hâ	Lixia
Lĭk-dĕ̤ng	Lidong
Mìng (Sĕk-guók)	Min (Ten Kingdoms)
Gák-lì	Clam
Hàng-ló	Hanlu
Hà-mà-chāu	Plantago asiatica
Là̤ Lé	Lê Lợi
Găng-chō̤	Glycyrrhiza uralensis
Gū-piéu	Stock
Huà-ăng	Hua'an County
Nìng-huá	Ninghua County
Iù-kă̤	Youxi County
Chĭng-liù	Qingliu County
Să-gâing	Sha County
Chiŭ-hŭng	Qiufen
Gāi-gáik Kăi-huóng	Chinese economic reform
Lièng-siàng	Liancheng County
Sông-chiŏng-gâing	Shunchang County
Lò̤-nguòng	Luoyuan County
Bìng-nàng	Pingnan County, Fujian
Bìng-tàng	Pingtan County
Nàng-ăng	Nan'an, Fujian
Dṳ̀-huák	Division (mathematics)
Hù-lù	Calabash
Ciŏng-lŏk	Jiangle County
Gĭng-dĭk	Jingzhe
Diêng-dĕng	Lamp (electrical component)
Gók-ṳ̄	Guyu
Duâi-hàng	Dahan (solar term)
Īng-lĭk Huòng-dá̤	Zhu Youlang
Tiék-guăng-ĭng	Tieguanyin
Hù-lī	Huli District
Īng-dêng	Yongding District, Longyan
Sṳ̀ Cài-hâiu	Xu Caihou
Céng-ăng	Jin'an District, Fuzhou
Gū-làu	Gulou District, Fuzhou
Séu-sê̤ṳ	Xiuyu District
Īng-chŭng	Yongchun County
Ciĕu-siàng	Jiaocheng District
Siĕng-iù	Xianyou County
Iòng-bìng-kṳ̆	Yanping District
Sĭng-lò̤-kṳ̆	Xinluo District
Puō-siàng	Pucheng County, Fujian
Săng-nguòng	Sanyuan District
Hàng-gŏng	Hanjiang District, Putian
Hŭng-dĕk	Fengze District
Lié-siàng	Licheng District, Putian
Siông-hòng-gâing	Shanghang County
Sṳ̀ng-kă̤-gâing	Songxi County
Ū-bìng	Wuping County
Nàng-cêng	Nanjing County
Chŭng-hŭng	Chunfen
Lĭk-chŭng	Lichun
Ṳ̄-cūi	Yushui (solar term)
Lè̤ng-ê̤ṳ Tái-hâiu	Empress Dowager Longyu
Siông Bă-cé	Shō Hashi
Siông Tái	Shō Tai
Hók-ăng	Fu'an
Mìng-chiăng	Minqing County
Gióng-ĕu	Jian'ou
Mā-muōi	Mawei District
Īng-tái	Yongtai County
Lṳ̀ng-ùng	Longwen District
Sṳ̆-mìng	Siming District
Hiê-ăng	Hui'an County
Bìng-huò	Pinghe County
Tái-nìng	Taining County
Guŏng-dĕk	Guangze County
Īng-ăng	Yong'an
Ùng-dé̤ṳk	Asparagus setaceus
分類:Dáik-guók	Category:Germany
分類:É-dâi-lé	Category:Italy
分類:Mī-guók	Category:United States
分類:Ngò̤-lò̤-sṳ̆	Category:Russia
分類:Dṳ̆ng-guók	Category:China
分類:Nĭk-buōng	Category:Japan
分類:Ó̤-ciŭ	Category:Australia
Iĕk-cūi-ké	Water heating
分類:Éng-nà̤	Category:Indonesia
分類:Hàng-guók	Category:South Korea
分類:Tái-guók	Category:Thailand
分類:Uŏk-nàng	Category:Vietnam
分類:Buô-ṳ̄ dông-ŭk	Category:Mammals
分類:Bà-hèng dông-ŭk	Category:Reptiles
分類:Cēu	Category:Birds
分類:Cĭng-kṳ̄ng	Category:Fungi
分類:Sĭk-ŭk	Category:Plants
分類:Ŭk-lī	Category:Physics
分類:Huá-hŏk	Category:Chemistry
分類:Lĭk-sṳ̄	Category:History
分類:Dê-lī	Category:Geography
分類:Siâ-huôi	Category:Society
分類:Mī-sŭk	Category:Visual arts
分類:Cŭng-gáu	Category:Religion
分類:Tā̤-ṳ̆k	Category:Sports
分類:Kuŏ-hŏk	Category:Science
分類:Gióng-dé̤ṳk-ŭk	Category:Buildings and structures
Gū Lò̤-mā	Ancient Rome
Liù-giāng	Corbiculidae
Regina Duarte	Regina Duarte
Mìng-uŏk	Minyue
Cūi-kì	Slug
分類:Sĕng-tái	Category:Ecology
Săng-sáiu	Chinese zodiac
分類:Disambig	Category:Disambiguation pages
分類:Diék-hŏk	Category:Philosophy
分類:Sĭng-lī	Category:Psychology
分類:Hŭk-gáu	Category:Buddhism
分類:Gĭ-dók-gáu	Category:Christianity
分類:Ĭ-sṳ̆-làng-gáu	Category:Islam
分類:Iù-tái-gáu	Category:Judaism
Kiê	Standing
Tiĕng-cĭng Dâi-hŏk	Tianjin University
Mā-cū	Matsu
Dĭ-dă	Suona
Uòng Iòng-hâng	Wang Yanhan
Uòng Gié-bèng	Wang Jipeng
Uòng Iòng-gĭng	Wang Yanjun
Hô-dê̤ṳ	Tofu skin
Gùng	Skirt
Uòng Iòng-hĭ	Wang Yanxi
Uòng Nāi-siòng	Wong Nai Siong
Ciòng-ciŭ-uâ	Quanzhou dialect
Cháe̤	Luffa aegyptiaca
Tuyên Quang	Tuyên Quang Province
Lìng Sié-gŭng	Rin Seikō
Hióng Dáik-hèng	Kōchi Chōjō
Dà-gī	Coffee table
Iraq gâe̤ng Levant Ĭ-sṳ̆-làng-guók	Islamic State of Iraq and the Levant
Pàng-kì	Sesarmidae
Dâu-mò̤-chái	Bean sprout
Hèu Dáik-bōng	Hou Debang
Chiòng (dông-cáuk)	Squatting position
Giū-mī-chŏng	Kumemura
Cièng-cāi	Joss paper
Lìng Gáuk-mìng	Lin Juemin
Â-muòng-uâ	Amoy dialect
Tău-dò̤-nó̤h	Theft
Ciĕ-muài	Sesame
Abu Bakr al-Baghdadi	Abu Bakr al-Baghdadi
Nṳ̆k-ṳ̀ng	Rousong
Sé-sáik-bà̤	Four Color Cards
分類:Ùng-huá	Category:Culture
分類:Dê-cék	Category:Geology
Dìng-dièu	Trần dynasty
Wikipedia:Dŏng-nièng gĭng-dáng	Wikipedia:Selected anniversaries
模板:Tái-iòng-hiê	Template:Solar System table
Holopedia	Min Nan Wikipedia
Gì-chái	Amaranthus tricolor
Kō̤-cṳ̆	Standardized test
Ciē-sáik	Purple
Gŏ̤-gák-hié	Gaojia opera
Kī-mā-sŭ	Sachima
Bàng-uâ-cê	Foochow Romanized
Luciano Huck	Luciano Huck
Hù-siông	Upajjhaya
Màng-gōng	Mango dialect
Tái-bìng-tiĕng-guók	Taiping Heavenly Kingdom
Gâng	Perspiration
Sìng (bòng-hâ̤)	Scylla serrata
Ià-huò-huà	Jehovah
Sók-lŭk	Speed
Ák	Duck
Dìng Nguòng-guŏng	Tan Goan-kong
Duâi-tàu-chái	Turnip
Huăng-siông	Mangifera indica
分類:Dáik-guók ìng-ŭk	Category:German people
分類:Mī-guók ìng-ŭk	Category:American people
分類:Iēng-uòng	Category:Actors
分類:Ĭng-guók ìng-ŭk	Category:British people
分類:Huák-guók ìng-ŭk	Category:French people
模板:Chess diagram	Template:Chess diagram
模板:Tl	Template:Tl
Káh-ngṳ̄ Băh-uâ-cê	Pha̍k-fa-sṳ
分類:Guók-gă	Category:Countries
Wikipedia:Hèng-céng Ìng-uòng	Wikipedia:Administrators
分類:Dṳ̆ng-guók mìng-cŭk	Category:Ethnic groups in China
分類:Ìng-ŭk	Category:People
分類:Cék-ngiĕk	Category:Occupations
Wikipedia:Gĭ-ké-nè̤ng	Wikipedia:Bots
分類:Sì-găng	Category:Time
分類:Gĕ̤ng-tiàng	Category:Engineering
分類:Cài-lâiu	Category:Materials
分類:Ĭ-hŏk	Category:Medicine
分類:Céng-dê	Category:Politics
分類:Gáu-ṳ̆k	Category:Education
Ăi-gĭk	Egypt
模板:Bot	Template:Bot
Nizhneleninskoye	Nizhneleninskoye
Gă-nā-dâi	Canada
分類:Iù-hié	Category:Games
Hók-gióng Sṳ̆-huâng Dâi-hŏk	Fujian Normal University
分類:Ĕu-ciŭ guók-gă	Category:Countries in Europe
分類:Ĕu-ciŭ	Category:Europe
模板:Documentation	Template:Documentation
分類:Ê̤ṳng-hô	Category:Wikipedians by language
Sìng Câi-gĭ	Sung Jae-gi
模板:Softredirect	Template:Soft redirect
Wikipedia:維基數據	Wikipedia:Wikidata
模板:Chēng	Template:Db
分類:Ngṳ̄-ngiòng	Category:Languages
分類:Lĭk-huák	Category:Calendars
分類:Wikipedia	Category:Wikipedia
Wikipedia:Mò̤ hô-cáik sĭng-mìng	Wikipedia:General disclaimer
分類:未索引其頁面	Category:Noindexed pages
Dâi-chṳ̄	Kangaroo
Hâ Chák-lī	Charles Hartwell
Tiĕng-ăng-dòng	Church of Heavenly Peace, Fuzhou
Huòng-huō Diòng-siàng	Great Firewall
模板:!-	Template:!-
模板:Smallcaps	Template:Smallcaps
模板:Nowrap	Template:Nowrap
Wikipedia:Ék-chiék Wikipedia dŭ găi-dŏng ô gì ùng	Wikipedia:Vital articles
分類:Hĭ-ciŭ	Category:Africa
模板:Wikisource	Template:Wikisource
模板:Babel	Template:Babel
模板:Commons	Template:Commons
模板:Reflist	Template:Reflist
Hók-ciŭ-huòng	Fukushūen
Wikipedia:列明來源	Wikipedia:Citing sources
模板:Stub	Template:Stub
Gēng Cĭng-dṳ̆ng	Geng Jingzhong
模板:User eo-1	Template:User eo-1
模板:User eo-3	Template:User eo-3
模板:User de	Template:User de
模板:User de-1	Template:User de-1
模板:User es	Template:User es
模板:User de-3	Template:User de-3
模板:User en-3	Template:User en-3
模板:User en-1	Template:User en-1
模板:User en-2	Template:User en-2
模板:User eo-2	Template:User eo-2
模板:User en-4	Template:User en-4
模板:User en	Template:User en
模板:User de-2	Template:User de-2
模板:User es-1	Template:User es-1
模板:User fr-1	Template:User fr-1
模板:User it-3	Template:User it-3
模板:User fr-2	Template:User fr-2
模板:User ja	Template:User ja
模板:User ja-1	Template:User ja-1
模板:User it-1	Template:User it-1
模板:User fr	Template:User fr
分類:Ā-ciŭ	Category:Asia
分類:Nàng Mī-ciŭ	Category:South America
分類:Mā-lài-să̤-ā	Category:Malaysia
模板:Mod	Template:Mod
模板:SIL	Template:Infobox language/codelist
模板:User it	Template:User it
模板:User es-2	Template:User es-2
模板:Huăng-ngìng	Template:Welcome
分類:Dièu-lâiu	Category:Condiments
模板:Click	Template:Click
分類:User fr-1	Category:User fr-1
模板:Image label	Template:Image label
模板:Category handler	Template:Category handler
模板:Wiki gĕ̤ng-tiàng	Template:Wikimedia Foundation
模板:Niék-sé cáik-ké	Template:Solar terms
Guóh Guók-tĭng	Guo Guoting
模板:Steady	Template:Steady
模板:Guók-gă	Template:Infobox country
模板:Documentation/docname	Template:Documentation/docname
模板:Cite journal	Template:Cite journal
模板:Infobox 公司	Template:Infobox company
模板:Wikibooks	Template:Wikibooks
模板:Dablink	Template:Hatnote
模板:Hō̤ gì ùng-ciŏng	Template:Featured article
分類:User en-4	Category:User en-4
分類:User en	Category:User en
分類:User zh	Category:User zh
分類:User zh-M	Category:User zh-N
分類:User en-2	Category:User en-2
模板:Infobox	Template:Infobox
模板:User eo	Template:User eo
模板:User zh	Template:User zh
分類:Gáuk-guók gì lĭk-sṳ̄	Category:History by country
Wikipedia:Dŏng-nièng gĭng-dáng/09 nguŏk 23 hô̤	Wikipedia:Selected anniversaries/September 23
Wikipedia:Dŏng-nièng gĭng-dáng/09 nguŏk 22 hô̤	Wikipedia:Selected anniversaries/September 22
模板:Legend	Template:Legend
Wikipedia:Dŏng-nièng gĭng-dáng/09 nguŏk 17 hô̤	Wikipedia:Selected anniversaries/September 17
Wikipedia:Dŏng-nièng gĭng-dáng/10 nguŏk 15 hô̤	Wikipedia:Selected anniversaries/October 15
模板:Cite web	Template:Cite web
Wikipedia:Dŏng-nièng gĭng-dáng/09 nguŏk 28 hô̤	Wikipedia:Selected anniversaries/September 28
模板:Ombox	Template:Ombox
Wikipedia:Dŏng-nièng gĭng-dáng/10 nguŏk 22 hô̤	Wikipedia:Selected anniversaries/October 22
Wikipedia:Dŏng-nièng gĭng-dáng/11 nguŏk 2 hô̤	Wikipedia:Selected anniversaries/November 2
Wikipedia:Dŏng-nièng gĭng-dáng/11 nguŏk 9 hô̤	Wikipedia:Selected anniversaries/November 9
模板:Country data	Template:Country data
Wikipedia:Dŏng-nièng gĭng-dáng/10 nguŏk 1 hô̤	Wikipedia:Selected anniversaries/October 1
Wikipedia:Dŏng-nièng gĭng-dáng/10 nguŏk 5 hô̤	Wikipedia:Selected anniversaries/October 5
Wikipedia:Dŏng-nièng gĭng-dáng/10 nguŏk 8 hô̤	Wikipedia:Selected anniversaries/October 8
分類:Īng-sĭk	Category:Food and drink
模板:MongolUnicode	Template:MongolUnicode
Wikipedia:Dŏng-nièng gĭng-dáng/10 nguŏk 6 hô̤	Wikipedia:Selected anniversaries/October 6
Wikipedia:Dŏng-nièng gĭng-dáng/10 nguŏk 17 hô̤	Wikipedia:Selected anniversaries/October 17
Wikipedia:Dŏng-nièng gĭng-dáng/10 nguŏk 2 hô̤	Wikipedia:Selected anniversaries/October 2
Wikipedia:Dŏng-nièng gĭng-dáng/09 nguŏk 16 hô̤	Wikipedia:Selected anniversaries/September 16
Wikipedia:Dŏng-nièng gĭng-dáng/09 nguŏk 19 hô̤	Wikipedia:Selected anniversaries/September 19
Wikipedia:Dŏng-nièng gĭng-dáng/10 nguŏk 25 hô̤	Wikipedia:Selected anniversaries/October 25
Wikipedia:Dŏng-nièng gĭng-dáng/11 nguŏk 10 hô̤	Wikipedia:Selected anniversaries/November 10
Wikipedia:Dŏng-nièng gĭng-dáng/10 nguŏk 21 hô̤	Wikipedia:Selected anniversaries/October 21
Wikipedia:Dŏng-nièng gĭng-dáng/09 nguŏk 15 hô̤	Wikipedia:Selected anniversaries/September 15
Wikipedia:Dŏng-nièng gĭng-dáng/09 nguŏk 4 hô̤	Wikipedia:Selected anniversaries/September 4
Wikipedia:Dŏng-nièng gĭng-dáng/09 nguŏk 8 hô̤	Wikipedia:Selected anniversaries/September 8
Wikipedia:Dŏng-nièng gĭng-dáng/10 nguŏk 4 hô̤	Wikipedia:Selected anniversaries/October 4
Wikipedia:Dŏng-nièng gĭng-dáng/09 nguŏk 1 hô̤	Wikipedia:Selected anniversaries/September 1
Wikipedia:Dŏng-nièng gĭng-dáng/09 nguŏk 6 hô̤	Wikipedia:Selected anniversaries/September 6
Wikipedia:Dŏng-nièng gĭng-dáng/09 nguŏk 25 hô̤	Wikipedia:Selected anniversaries/September 25
Wikipedia:Dŏng-nièng gĭng-dáng/09 nguŏk 10 hô̤	Wikipedia:Selected anniversaries/September 10
Wikipedia:Dŏng-nièng gĭng-dáng/09 nguŏk 26 hô̤	Wikipedia:Selected anniversaries/September 26
Wikipedia:Dŏng-nièng gĭng-dáng/09 nguŏk 20 hô̤	Wikipedia:Selected anniversaries/September 20
Wikipedia:Dŏng-nièng gĭng-dáng/11 nguŏk 4 hô̤	Wikipedia:Selected anniversaries/November 4
Wikipedia:Dŏng-nièng gĭng-dáng/09 nguŏk 30 hô̤	Wikipedia:Selected anniversaries/September 30
Wikipedia:Dŏng-nièng gĭng-dáng/10 nguŏk 7 hô̤	Wikipedia:Selected anniversaries/October 7
Wikipedia:Dŏng-nièng gĭng-dáng/10 nguŏk 19 hô̤	Wikipedia:Selected anniversaries/October 19
Wikipedia:Dŏng-nièng gĭng-dáng/09 nguŏk 27 hô̤	Wikipedia:Selected anniversaries/September 27
Wikipedia:Dŏng-nièng gĭng-dáng/09 nguŏk 11 hô̤	Wikipedia:Selected anniversaries/September 11
Wikipedia:Dŏng-nièng gĭng-dáng/11 nguŏk 8 hô̤	Wikipedia:Selected anniversaries/November 8
Wikipedia:Dŏng-nièng gĭng-dáng/11 nguŏk 1 hô̤	Wikipedia:Selected anniversaries/November 1
Wikipedia:Dŏng-nièng gĭng-dáng/11 nguŏk 7 hô̤	Wikipedia:Selected anniversaries/November 7
Wikipedia:Dŏng-nièng gĭng-dáng/10 nguŏk 11 hô̤	Wikipedia:Selected anniversaries/October 11
Wikipedia:Dŏng-nièng gĭng-dáng/11 nguŏk 3 hô̤	Wikipedia:Selected anniversaries/November 3
Wikipedia:Dŏng-nièng gĭng-dáng/10 nguŏk 20 hô̤	Wikipedia:Selected anniversaries/October 20
Wikipedia:Dŏng-nièng gĭng-dáng/10 nguŏk 16 hô̤	Wikipedia:Selected anniversaries/October 16
Wikipedia:Dŏng-nièng gĭng-dáng/10 nguŏk 14 hô̤	Wikipedia:Selected anniversaries/October 14
Wikipedia:Dŏng-nièng gĭng-dáng/10 nguŏk 18 hô̤	Wikipedia:Selected anniversaries/October 18
Wikipedia:Dŏng-nièng gĭng-dáng/10 nguŏk 24 hô̤	Wikipedia:Selected anniversaries/October 24
Wikipedia:Dŏng-nièng gĭng-dáng/10 nguŏk 3 hô̤	Wikipedia:Selected anniversaries/October 3
Wikipedia:Dŏng-nièng gĭng-dáng/09 nguŏk 7 hô̤	Wikipedia:Selected anniversaries/September 7
分類:Săng	Category:Mountains
模板:IPA	Template:IPA
分類:Céng-dê-gă	Category:Politicians
分類:Mī-ciŭ	Category:Americas
Tàng	Phlegm
分類:Gáuk-guók gì ìng-ŭk	Category:People by nationality
模板:Wiki-huá	Template:Wikify
分類:Gŭng-sê̤ṳ	Category:Military
模板:Increase	Template:Increase
模板:Ciŭ-gĭ-biēu	Template:Periodic table (32 columns, compact)
模板:User nl	Template:User nl
模板:Infobox 網站	Template:Infobox website
Wikipedia:Dŏng-nièng gĭng-dáng/10 nguŏk 12 hô̤	Wikipedia:Selected anniversaries/October 12
模板:Decrease	Template:Decrease
模板:User no-2	Template:User no-2
模板:Image label end	Template:Image label end
模板:Documentation subpage	Template:Documentation subpage
Wikipedia:Dŏng-nièng gĭng-dáng/11 nguŏk 5 hô̤	Wikipedia:Selected anniversaries/November 5
Wikipedia:Dŏng-nièng gĭng-dáng/10 nguŏk 13 hô̤	Wikipedia:Selected anniversaries/October 13
Wikipedia:Dŏng-nièng gĭng-dáng/09 nguŏk 3 hô̤	Wikipedia:Selected anniversaries/September 3
Wikipedia:Dŏng-nièng gĭng-dáng/09 nguŏk 24 hô̤	Wikipedia:Selected anniversaries/September 24
模板:Purge	Template:Purge
模板:Lang-la	Template:Lang-la
分類:Cìng-gāng	Category:Emotion
模板:Dṳ̆ng-huà Ìng-mìng Gê̤ṳng-huò-guók Hèng-céng-kṳ̆	Template:Province-level divisions of China
模板:Userpage	Template:User page
模板:Non-free logo	Template:Non-free logo
模板:User	Template:User
Wikipedia:Dŏng-nièng gĭng-dáng/09 nguŏk 12 hô̤	Wikipedia:Selected anniversaries/September 12
Wikipedia:Dŏng-nièng gĭng-dáng/09 nguŏk 2 hô̤	Wikipedia:Selected anniversaries/September 2
Wikipedia:Dŏng-nièng gĭng-dáng/11 nguŏk 6 hô̤	Wikipedia:Selected anniversaries/November 6
Wikipedia:Dŏng-nièng gĭng-dáng/09 nguŏk 18 hô̤	Wikipedia:Selected anniversaries/September 18
Wikipedia:Dŏng-nièng gĭng-dáng/10 nguŏk 10 hô̤	Wikipedia:Selected anniversaries/October 10
Wikipedia:Dŏng-nièng gĭng-dáng/10 nguŏk 9 hô̤	Wikipedia:Selected anniversaries/October 9
Wikipedia:Dŏng-nièng gĭng-dáng/10 nguŏk 23 hô̤	Wikipedia:Selected anniversaries/October 23
模板:Image label small	Template:Image label small
模板:Ĕu-ciŭ	Template:Europe and seas labelled map
模板:User fr-3	Template:User fr-3
模板:Allcaps	Template:Allcaps
模板:Gô-dā̤ gì guók-gă	Template:Infobox former country
Wikipedia:Tiăng-dŏng	Wikipedia:Local Embassy
分類:User ja-M	Category:User ja-N
模板:Gì-ngiê	Template:Disambiguation
模板:Smallcaps all	Template:Smallcaps all
分類:Dièu-siēng lĭk-sṳ̄	Category:History of Korea
模板:User no-3	Template:User no-3
模板:User nan	Template:User nan
模板:User nan-1	Template:User nan-1
模板:Lang-grc	Template:Lang-grc
模板:User ksh	Template:User ksh
模板:User yue-3	Template:User yue-3
模板:AUS	Template:AUS
模板:User yue-1	Template:User yue-1
模板:Lifetime	Template:Lifetime
模板:Lang-en	Template:Lang-en
分類:Sĕng-ŭk	Category:Organisms
模板:ISO 639 name conversion template doc	Template:ISO 639 name conversion template doc
Wikipedia:Dŏng-nièng gĭng-dáng/9 nguŏk	Wikipedia:Selected anniversaries/September
Kŏ̤-lìng	Judson Dwight Collins
Wikipedia:Dŏng-nièng gĭng-dáng/09 nguŏk 14 hô̤	Wikipedia:Selected anniversaries/September 14
Wikipedia:Dŏng-nièng gĭng-dáng/09 nguŏk 9 hô̤	Wikipedia:Selected anniversaries/September 9
Wikipedia:Dŏng-nièng gĭng-dáng/09 nguŏk 13 hô̤	Wikipedia:Selected anniversaries/September 13
Wikipedia:Dŏng-nièng gĭng-dáng/10 nguŏk	Wikipedia:Selected anniversaries/October
分類:User vi-3	Category:User vi-3
模板:User la-1	Template:User la-1
分類:User wuu	Category:User wuu
分類:User fr	Category:User fr
分類:User ja	Category:User ja
分類:User la	Category:User la
分類:User fr-3	Category:User fr-3
分類:User it-3	Category:User it-3
分類:User ja-3	Category:User ja-3
分類:User fr-2	Category:User fr-2
分類:User it-2	Category:User it-2
分類:User ja-2	Category:User ja-2
分類:User la-2	Category:User la-2
分類:User wuu-M	Category:User wuu-N
分類:User ko-M	Category:User ko-N
分類:User fr-M	Category:User fr-N
分類:User it-M	Category:User it-N
分類:User nl-M	Category:User nl-N
模板:User yue	Template:User yue
分類:Ùng-cê	Category:Writing systems
分類:Dô̤-gáu	Category:Taoism
分類:Dō̤	Category:Islands
分類:User de	Category:User de
分類:User de-2	Category:User de-2
分類:User de-3	Category:User de-3
分類:User de-M	Category:User de-N
分類:User en-3	Category:User en-3
分類:User en-M	Category:User en-N
分類:User es	Category:User es
分類:User es-1	Category:User es-1
分類:User es-2	Category:User es-2
分類:User es-3	Category:User es-3
分類:User es-M	Category:User es-N
分類:Chió	Category:Housing
分類:User it	Category:User it
分類:User it-1	Category:User it-1
分類:User ja-1	Category:User ja-1
分類:User ko	Category:User ko
分類:Mī-guók gì ciŭ	Category:States of the United States
分類:User ko-1	Category:User ko-1
分類:User ko-2	Category:User ko-2
分類:User ko-3	Category:User ko-3
分類:User ksh	Category:User ksh
分類:User ksh-M	Category:User ksh-N
分類:User la-1	Category:User la-1
Wikipedia:Dŏng-nièng gĭng-dáng/09 nguŏk 29 hô̤	Wikipedia:Selected anniversaries/September 29
分類:User la-3	Category:User la-3
分類:User la-M	Category:User la-N
Wikipedia:Dŏng-nièng gĭng-dáng/09 nguŏk 5 hô̤	Wikipedia:Selected anniversaries/September 5
模板:Distinguish	Template:Distinguish
模板:Internal link helper	Template:Internal link helper
模板:Information	Template:Information
分類:Huâng-cô̤i	Category:Crime
Sáik-mō̤	Louse
分類:Séng-sék	Category:Information science
分類:Hāi	Category:Seas
Hŭng-siéng	Mechanical fan
分類:Guōng-dĕ̤ng	Category:Guangdong
分類:Hók-gióng	Category:Fujian
分類:Gĭng-cá̤	Category:Economies
分類:Ciék-ciĕ dông-ŭk	Category:Arthropods
分類:User nan	Category:User nan
分類:User nan-1	Category:User nan-1
分類:User nan-2	Category:User nan-2
分類:User nan-3	Category:User nan-3
分類:User nan-M	Category:User nan-N
Hók-ciŭ-nè̤ng	Fuzhou people
分類:Hĭ-ciŭ guók-gă	Category:Countries in Africa
分類:Gáuk-guók gì gáu-ṳ̆k	Category:Education by country
Wikipedia:Dŏng-nièng gĭng-dáng/11 nguŏk	Wikipedia:Selected anniversaries/November
模板:User ja-2	Template:User ja-2
模板:User ja-3	Template:User ja-3
分類:User vi	Category:User vi
分類:User vi-1	Category:User vi-1
分類:User vi-2	Category:User vi-2
分類:User vi-M	Category:User vi-N
分類:Ciék-gŏng	Category:Zhejiang
分類:Ĭng-ngŏk-gă	Category:Musicians
模板:Lang	Template:Lang
Wikipedia:Dŏng-nièng gĭng-dáng/09 nguŏk 21 hô̤	Wikipedia:Selected anniversaries/September 21
分類:Hŏk-sŭk	Category:Academia
Bì-bà (ngŏk-ké)	Pipa
分類:Wikimedia gĕ̤ng-tiàng	Category:Wikimedia projects
分類:Gì-lôi	Category:Abstract strategy games
模板:Nocaps	Template:Nocaps
分類:Hŭng-sṳ̆k	Category:Cultural conventions
Huài-dáik	Moses Clark White
模板:Infobox Language/family-color	Template:Infobox language/family-color
分類:Ò̤	Category:Rivers
Cūi-siĕng	Narcissus tazetta
模板:User la-2	Template:User la-2
模板:User no-1	Template:User no-1
模板:User zh-1	Template:User zh-1
模板:User zh-2	Template:User zh-2
模板:User zh-3	Template:User zh-3
分類:Dâi-hàng Mìng-guók ìng-ŭk	Category:South Korean people
分類:Sôi-diēng ìng-ŭk	Category:Swedish people
分類:Nĭk-buōng ìng-ŭk	Category:Japanese people
分類:Dài-uăng ìng-ŭk	Category:Taiwanese people
分類:User nl	Category:User nl
分類:User zh-1	Category:User zh-1
分類:User zh-3	Category:User zh-3
分類:User zh-2	Category:User zh-2
分類:Cāi	Category:Paper
分類:Cáik-ké	Category:Solar terms
分類:Ông-ò̤	Category:Canals
分類:Uŏk-nàng ìng-ŭk	Category:Vietnamese people
分類:Sóng-dièu huòng-dá̤	Category:Song dynasty emperors
分類:Mìng-dièu huòng-dá̤	Category:Ming dynasty emperors
分類:Săng-guók huòng-dá̤	Category:Three Kingdoms emperors
分類:Ngò̤-lò̤-sṳ̆ ìng-ŭk	Category:Russian people
分類:Hiŏng-gē̤ng ìng-ŭk	Category:Hong Kong people
分類:Ciĕk-káik ìng-ŭk	Category:Czech people
分類:Tái-guók ìng-ŭk	Category:Thai people
Uŏk-ngṳ̄	Yue Chinese
分類:Sáng	Category:Surnames
分類:Dièu-siēng Mìng-ciō-ciō-ngiê Ìng-mìng Gê̤ṳng-huò-guók	Category:North Korea
分類:Dṳ̆ng-guók ìng-ŭk	Category:Chinese people
分類:Dièu-siēng	Category:Korea
分類:Dài-uăng	Category:Taiwan
分類:Dièu-siēng Mìng-ciō-ciō-ngiê Ìng-mìng Gê̤ṳng-huò-guók ìng-ŭk	Category:North Korean people
分類:Liù-giù-guók	Category:Ryukyu Kingdom
分類:Hók-gióng-nè̤ng	Category:People from Fujian
分類:Dâi-iòng-ciŭ guók-gă	Category:Countries in Oceania
分類:Báe̤k Mī-ciŭ guók-gă	Category:Countries in North America
分類:Ngṳ̀	Category:Fish
分類:Cūi-guō	Category:Fruit
分類:Niōng-tā̤ dông-ŭk	Category:Molluscs
分類:Só-cê	Category:Numeral systems
分類:Gióng-dé̤ṳk cài-lâiu	Category:Building materials
分類:Dông-ŭk	Category:Animals
分類:Ciáh-tùi dông-ŭk	Category:Vertebrates
分類:Guòng-lé	Category:Rights
分類:Ìng-guòng	Category:Human rights
分類:Ū-ké	Category:Weapons
分類:Nàng Mī-ciŭ guók-gă	Category:Countries in South America
分類:Gă-sĭ	Category:Furniture
分類:Mìng-nàng-ngṳ̄	Category:Min Nan
分類:Ké-chiông	Category:Meteorology
分類:Dṳ̆ng Mī-ciŭ	Category:Central America
分類:Hiŏng-gē̤ng	Category:Hong Kong
分類:Ĭ-siòng	Category:Clothing
分類:Cáik-nĭk	Category:Festivals
分類:Kuàng-ciék dông-ŭk	Category:Annelids
分類:Bâng	Category:Diseases and disorders
分類:Kiŏng-diòng dông-ŭk	Category:Cnidarians
分類:Gùng-dō̤	Category:Archipelagoes
分類:Ciŭ-dièu guók-uòng	Category:Zhou dynasty kings
分類:Káh-dièu-nó̤h	Category:Toys
分類:Gă-dìng	Category:Family
Hók-ăng-uâ	Fu'an dialect
分類:Huòng-dá̤	Category:Emperors
分類:Nguòng-dièu huòng-dá̤	Category:Yuan dynasty emperors
分類:Céng-dièu huòng-dá̤	Category:Jin dynasty (265–420) emperors
分類:Chĭng-dièu huòng-dá̤	Category:Qing dynasty emperors
分類:Báe̤k Mī-ciŭ	Category:North America
分類:Gŏ̤-chiū	Category:Singers
分類:Hù	Category:Lakes
分類:Só-hŏk-gă	Category:Mathematicians
模板:Infobox ngṳ̄-ngiòng	Template:Infobox language
分類:Dâi-iòng-ciŭ	Category:Oceania
分類:Tiĕng-căi	Category:Natural disasters
分類:Gô-dā̤ gì guók-gă	Category:Former countries
Hĭng-huá-nè̤ng	Putian people
Chék Lìng Báik Ĭng	Qi Lin Bayin
Vĩnh Long	Vĩnh Long Province
分類:Sié-gái	Category:World
Cāi-puŏi	Corrugated fiberboard
分類:Giông-kŏng	Category:Health
Hâ-cé	Summer solstice
分類:Sĕng-lī	Category:Physiology
Bóng-kăng-chió	Toilet (room)
分類:Â-muòng	Category:Xiamen
Trojany	Trojany, Masovian Voivodeship
模板:Infobox color	Template:Infobox color
分類:Ngū-dâi Sĕk-guók gì huòng-dá̤ gâe̤ng guók-uòng	Category:Five Dynasties and Ten Kingdoms rulers
Uòng Iòng-céng	Wang Yanzheng
Hók-gióng Uōng-mìng Áng	Yan Xiaoling – Fan Yanqiong case
分類:Ā-ciŭ guók-gă	Category:Countries in Asia
分類:Mī-ciŭ guók-gă	Category:Countries in the Americas
Ciŏng-ciŭ-uâ	Zhangzhou dialect
模板:User yue-2	Template:User yue-2
模板:User nan-2	Template:User nan-2
模板:User la	Template:User la
模板:User cdo-3	Template:User cdo-3
模板:User cdo-2	Template:User cdo-2
模板:User cdo-1	Template:User cdo-1
模板:User cdo	Template:User cdo
模板:ISO 639 name zh	Template:ISO 639 name zh
模板:ISO 639 name en	Template:ISO 639 name en
分類:Ŭng-ciŭ	Category:Wenzhou
分類:Huák-lŭk	Category:Statutory law
分類:Káh-gă	Category:Hakka
Puòi-à̤	Dress shoe
Iòng Chŭi-sĕng	Yang Sui-sheng
分類:Cò̤-ngôi huòng-dá̤	Category:Cao Wei emperors
分類:Dṳ̆ng Mī-ciŭ guók-gă	Category:Countries in Central America
分類:Dṳ̆ng-guók guók-uòng	Category:Chinese kings
分類:Sŏng-ngù huòng-dá̤	Category:Eastern Wu emperors
分類:Bēng-guòng	Category:Copyright law
分類:Hók-gióng ùng-huá	Category:Culture in Fujian
分類:Biēu-cìng	Category:Facial expressions
分類:Hók-ciŭ	Category:Fuzhou
分類:Káh-gă ùng-huá	Category:Hakka culture
分類:Hók-gióng lĭk-sṳ̄	Category:History of Fujian
分類:Ôi-sĕng	Category:Hygiene
分類:Ciòng-ciŭ	Category:Quanzhou
分類:Mìng-dĕ̤ng-ngṳ̄	Category:Min Dong
分類:Dṳ̆ng-huà Mìng-guók	Category:Republic of China
分類:Nìng-dáik	Category:Ningde
分類:Hók-ciŭ-nè̤ng	Category:People from Fuzhou
分類:Sṳ̆k-háng huòng-dá̤	Category:Shu Han emperors
分類:User cdo	Category:User cdo
分類:User cdo-M	Category:User cdo-N
模板:Image label begin	Template:Image label begin
模板:Dṳ̆ng-huà Mìng-guók Hèng-céng-kṳ̆	Template:Administrative divisions of Taiwan
分類:Sĕng-uăk	Category:Personal life
分類:Săng-mìng	Category:Sanming
Uòng-pŭng	Wasp
模板:User vi	Template:User vi
分類:User en-1	Category:User en-1
分類:User de-1	Category:User de-1
分類:Gă-sĭ-huă	Category:Tools
分類:Mìng-cŭk	Category:Ethnicity
分類:Mìng-guók guók-uòng gâe̤ng huòng-dá̤	Category:Min (Ten Kingdoms) rulers
Mìng-kiŏk	Min opera
Wikipedia:失效鏈接	Wikipedia:Link rot
Guă-cī	Egusi
Dĕ̤ng-ĕu-guók	Dong'ou Kingdom
Liù-giù	Ryukyu Islands
模板:User nan-3	Template:User nan-3
模板:User wuu	Template:User wuu
Lṳ̆k-dê	Land
Să̤-hù	西湖
Hāi-chái	Saccharina japonica
模組:Citation/CS1/Whitelist	Module:Citation/CS1/Whitelist
Gŭng-ô-nguòng	Civil service
Hù-diĕk	Butterfly
模板:Hók-gióng	Template:Fujian
Chái-tàu	Radish
Nguòng-siĕu-cáik	First Full Moon Festival
模板:Infobox Language/genetic	Template:Infobox language/genetic
Dṳ̆ng-săng	中山
Sì	Sì
模板:ISO 639 name cdo	Template:ISO 639 name cdo
模板:User cdo-0	Template:User cdo-0
模板:Ping	Template:Reply to
Yun Hyon-seok	Yun Hyon-seok
模板:Ruby	Template:Ruby
Chék-nguŏk-chék	Double Seventh Festival
模組:Arguments	Module:Arguments
特殊:最近其改變	Special:RecentChanges
模組:Citation/CS1	Module:Citation/CS1
模組:Citation/CS1/Configuration	Module:Citation/CS1/Configuration
模組:TableTools	Module:TableTools
模組:HtmlBuilder	Module:HtmlBuilder
模組:Coordinates	Module:Coordinates
模組:Math	Module:Math
模組:Infobox	Module:Infobox
Hók-chiăng-uâ	Fuqing dialect
Dĕ̤ng-hāi	東海
Ciá	Saccharum
Làu Cĕng-éng	Liu Cheng-ying
Hĭng-huá Bàng-uâ-cê	Hinghwa Romanized
Cáu-gŭng	Kitchen God
Gióng-nìng Lò̤-mā-cê	Kienning Colloquial Romanized
