ᎬᎿᎦᏍᏛ	Africa
ᏣᏩᏂᏏ	Japan
ᏧᎦᎾᏮ ᎠᎹᏰᏟ	South America
ᎠᏂᏍᏆᏂᏱ	Spain
ᏌᏊᎢᏳᎾᎵᏍᏔᏅᏍᎦᏚᎩ ᎾᎿ ᎠᎺᏰᏟ	United States
ᏇᎵᏥᎥᎻ	Belgium
ᎡᎶᎯ	Earth
ᏣᏥ ᏩᏒᏓᎾ	George Washington
ᏫᏂᎦᏙᎯ	Finland
ᏍᏫᏕᏂ	Sweden
ᏗᏂᎹᎦ	Denmark
ᏉᎳᏂ	Poland
ᎢᏔᎵ	Italy
ᏍᏫᏍ	Switzerland
ᎠᏍᏟᏯ	Austria
ᎪᎢᎯ	Greece
ᎬᏃ	Turkey
ᏉᏥᎦᎳ	Portugal
ᏳᎳᏛ	Europe
ᏓᎶᏂᎦᏍᏛ	Asia
ᏧᏴᏢ ᎠᎹᏰᏟ	North America
ᏧᏁᏍᏓᎸ	Antarctica
ᏫᎩᏇᏗᏯ	Wikipedia
ᎾᏍᎩ ᏁᏛᎳᏂ	Netherlands
ᏩᏙᎵ	Penis
ᏄᏯᎩ BMX	New York City
ᏆᎳᎩ ᎣᏆᎹ	Barack Obama
ᎫᎴ ᏗᏍᎪᏂᎯᏱ	London
ᏒᎦᏔ	Apple
ᎺᏏᎪ	Mexico
ᎤᏃᎸᏔᏅ	January
ᎧᎦᎵ	February
ᎠᎾᏱᎵᏒ	March
ᎹᏏ	Mars
ᎫᏬᏂ	April
ᎠᎾᏍᎬᏘ	May
ᏕᎭᎷᏱ	June
ᎫᏰᏉᏂ	July
ᎦᎶᏂ	August
ᏚᎵᏍᏗ	September
ᏚᏂᏃᏗ	October
ᏅᏓᏕᏆ	November
ᎥᏍᎩᏱ	December
ᏢᏓᏥ ᎤᏃᏕᎾ	Lion
ᎩᏟ	Dog
ᎩᎵᏏᏲ	United Kingdom
ᏪᏌ	Cat
ᏓᎶᏂᎨᏍᏛ	China
ᎠᏣᏗ	Fish
ᏆᏏᎵ	Brazil
ᏲᏂᎢ	Russia
Cetacea	Cetacea
ᎠᏛᏥ	Germany
ᏇᎳᎷᏍ	Belarus
ᎠᏂᏛᏥ ᎦᏬᏂᎯᏍᏗ	German language
ᏧᏁᏍᏓᎸᎯ	Iceland
ᎡᏍᏙᏂᏯ	Estonia
ᏌᏓᏂ	Saturn
ᏣᏥ ᎡᏙᎯ ᏊᏏ	George W. Bush
ᏳᎧᎴᏂ	Ukraine
ᏤᎩ ᏍᎦᏚᎩ	Czech Republic
ᎹᎵᏙᏫᎠ	Moldova
ᎶᎹᏂᏯ	Romania
ᎹᏏᏙᏂᎢᎠ	Republic of Macedonia
ᎠᎵᏇᏂᏯ	Albania
ᎢᏤᎢᏳᏍᏗ ᎦᏙᎯ	Greenland
ᏆᏍᏂᏯ ᎠᎴ ᎲᏤᎪᏫᎾ	Bosnia and Herzegovina
ᎠᏏᎵᏆᏌᏂ	Azerbaijan
ᎠᏂᏙᎳ	Andorra
ᎧᏌᎩᏍᏔᏂ	Kazakhstan
ᎢᏂᏙᏂᏍᏯ	Indonesia
ᎠᏂᎬᎾ ᎧᏬᏂᎯᏍᏗ	Turkish language
ᎤᏍᏇᎩᏍᏖᏂ	Uzbekistan
ᎠᎹ	Water
ᎦᏃᏥ	Leather
ᎠᏓ	Wood
ᏥᎵ	Chile
ᎹᎫᎵ	Mercury (planet)
ᎠᎾᏂᏍᏓᎾᎵ	Venus
ᎦᏬᏂᎯᏍᏗ	Language
ᏧᏈᏓ	Jupiter
ᏳᏪᏅᏍ	Uranus
ᏁᏩᏚᏂ	Neptune
ᏡᏙ	Pluto
ᎠᏂᎶᎻ ᎦᏬᏂᎯᏍᏗ	Latin
ᎠᎵᎻᏂᎠ	Armenia
ᏒᏈᏯ	Serbia
ᎡᎳᏗᏜ	Australia
ᏘᏲᎭᎵ ᎡᏆ	Dinosaur
ᏎᏗᏳᏍᏗ ᏒᎦᏔ	Pear
ᏅᏩᏙ ᎯᏯᏛ	Peace
Star Wars	Star Wars
ᎴᎹᏂ	Lemon
ᏆᏁᎾ	Banana
ᎦᏚᎲᎢ	City
Napoleon	Napoleon
ᏃᏈᏏ	Star
ᏅᏓ	Sun
ᎦᎷᎾᏗ	Sky
ᏅᏓ ᎠᎴ ᏚᏓᏕᏫᏍᏛ	Solar System
ᎦᏌᎧᎯᎨ ᎤᏃᎴ	Helium
ᎵᏘᎥᎻ	Lithium
ᏇᎵᎵᎥᎻ	Beryllium
ᎪᏪᎵ	Book
ᏒᏃᏱ	Night
ᎤᎦᏔ ᏅᏓᏳᏓᎴᏅ ᏬᏗᎨ	Carbon
ᎾᎢᏠᏤᏂ	Nitrogen
ᏗᎧᏃᎩᏛ	Music
ᏩᎶᏫᏂ	Fluorine
ᏥᏩᏩ	Chihuahua (state)
ᎦᏌᎧ ᏔᎷᎩᏍᎩ	Aluminium
ᎢᏂᏗᎢᎠ	India
ᏔᎷᎩᏍᎩ	Iron
ᏉᏔᏏᎥᎻ	Potassium
ᎪᎳ ᏗᏝᏂᎪᎯᏍᏗᏍᎩ	Calcium
ᎦᏂ	Lead
ᎹᏂᎪᎵᎠ	Mongolia
ᏔᎢᏖᏂᎥᎻ	Titanium
ᏩᏁᏗᎥᎻ	Vanadium
ᏐᏈᎵ	Horse
ᎦᏂᏝᎢ	Animal
ᏉᎵᏫᎠ	Bolivia
ᎥᏣᏱ	Copper
ᎩᎵᏣᎢᏍ	Kyrgyzstan
ᏩᎧ	Cattle
ᏔᏥᎩᏍᏕᏂ	Tajikistan
ᏉᎨᎼᏂ	Pokémon
ᏔᏯᎴᏂ	Thailand
ᎠᎢᎵᏗᏴᎻ	Iridium
ᏝᏘᏅᎻ	Platinum
ᏧᎦᎾᏮ ᎪᎵᎠ	South Korea
ᎠᏕᎸ ᏓᎶᏂᎨ	Gold
ᎠᏂᏉᎵᏍ	Poles
Julius Caesar	Julius Caesar
ᎤᏅᏉᎳᏛ	Rainbow
ᎠᏑᏫᏍᏗ	Color
ᎠᏕᎸ ᎤᏁᎦ	Silver
ᏔᎷᎩᏍᎩᏳᏍᏗ	Tin
ᏳᏪᏂᎥᎻ	Uranium
ᏡᏙᏂᎥᎻ	Plutonium
ᏁᏩᏚᏂᎥᎻ	Neptunium
ᏇᎵᎥᎻ	Barium
ᏍᏆᏂ ᎧᏬᏂᎯᏍᏗ	Spanish language
Johann Sebastian Bach	Johann Sebastian Bach
ᎧᎿᏁᏍᎩ	Spider
ᎠᏓᎵᏍᎩᏱᏍᎩ	Monkey
ᎠᏕᎳ	Money
ᏄᏯᎩ	New York
ᏳᎳᏈᎥᎻ	Europium
Augustus	Augustus
Trajan	Trajan
ᏙᎩᏲ	Tokyo
ᏍᏆᏂᏤᏍᏛᎢ	New Mexico
ᎣᎦᎳᎰᎹ	Oklahoma
ᏗᎦᎳᏫᏍᏗ ᏥᏌᏯ	True Jesus Church
ᎩᎵᏏ ᎦᏬᏂᎯᏍᏗ	English language
ᎠᎺᎵᏏᏯᎻ	Americium
ᎠᏔᏩ, ᎨᎾᏓ	Ottawa
ᎠᏤᏙ	Jakarta
Wikipedia:ᏃᏯᎭ ᎧᏁᏌᎢ	Wikipedia:Sandbox
ᎤᏪᏴ	River
ᎠᎧᏔᏘ	Telescope
ᎫᎵᏘᎦ	Curitiba
ᏌᎶᎵ	Red squirrel
ᎠᏙᎯ ᎢᎾᎨ	Forest
ᎪᏈᏂ ᏌᎪᏂᎨ	Corbin Bleu
ᏧᏈᏓ (ᎤᏁᎳᏅᎯ)	Jupiter (mythology)
ᏉᏧᎾ	Fortuna
ᏳᎳᏛ ᎠᏕᎳ	Euro
Category:ᎠᏂᎶᎻ ᎤᎾᏁᎳᏅᎯ	Category:Roman gods
ᎡᏆ ᎦᏙᎯ	Continent
ᎯᎸᏍᎩ ᏥᏍᏆ	Bird
ᏏᏅᏙ	Month
ᎤᎵᎮᎵᏍᏗ	Main Page
ᎤᎴᏍᏓᎸ	Vagina
ᎤᏬᎳᏨᎯ	Philosophy
Category:Candidates for speedy deletion	Category:Candidates for speedy deletion
ᎤᏔᏅ ᏗᎧᏃᎩᏍᏗ	Piano
ᏗᎧᏃᎩᏍᏗ	Guitar
ᎤᏬᏚ	Beauty
ᏙᏒᏓᎵ	Ant
ᏩᏚᎵᏏ	Bee
ᏕᎭᎷᎨ ᎠᏓᏛᏍᎩ	Eggplant
ᎧᏬᏄ	Anatidae
ᎤᏂᏥ	Mother
ᎤᎾᏥ	Snow
ᎠᏲᎵ	Child
ᎠᎦᏍᎬ	Rain
Nelson Mandela	Nelson Mandela
ᏅᏯ	Rock (geology)
ᎤᎶᎩᎸ	Cloud
ᎠᎦᎷᎦ	Tornado
ᏗᏎᏍᏗ ᏓᏍᏓᏅᏅ	Geometry
Category:ᏗᎧᏃᎩᏛ	Category:Music
ᎬᏂᎨᏧᎵ	Red fox
ᎧᏫ	Coffee
ᎣᏓᎸᎢ	Mountain
ᎤᎧᏲᏗ ᎡᎶᎯᏱ	Desert
ᏴᏩᏁᎬ Civil ᏓᏄᏩ	American Civil War
ᏆᏍᎩ ᎦᏬᏂᎯᏍᏗ	Basque language
Unicode/Cherokee	Unicode
ᎠᏂᏍᏫᏗ ᎦᏬᏂᎯᏍᏗ	Swedish language
ᎥᎦᏔᎲᎢ	Knowledge
ᎪᎵᎥ	Korean language
ᎦᎴᎪ ᎦᏬᏂᎯᏍᏗ	Galician language
ᏁᎵᏒ	Thought
ᎠᎺᏉᎯ	Ocean
ᎠᏤᎷᎯᏍᏗ	Saxophone
ᏬᎾᎵᏗ ᏪᎦᏂ	Ronald Reagan
ᎠᏣᏅᏙ	Plasma (physics)
ᎠᎴᏂ	Bekasi
ᏏᏆ	Pig
ᏚᎵᏍᏗ 11, 2001 ᏗᎦᏘᎸᏍᏗ	September 11 attacks
ᏡᎬ	Tree
ᎤᏅᏗ ᎦᏚᏅ	Cheese
ᏖᎸᎳᏗ	Grape
ᏐᎯ	Nut (fruit)
ᎠᎱᎵ	Drum
ᏄᏓᎨᏒ (Gravitation)	Gravity
ᏧᏙ	Judo
ᎠᎾᎦᎵᏍᎩ ᎦᏂᏱᏍᎩ	Metal
ᎠᏥᎸ ᏔᎷᎩᏍᎩ	Steel
ᏗᎦᎶᎪᏗ	Agriculture
ᏎᎷ	Maize
ᎠᏍᏓᏩᏛᏍᏙᏗ	Frequency
ᎠᏰᎵ ᏚᎾᏙᏢᏩᏗᏒ ᏙᎪᏪᎸ	List of sovereign states
ᏲᎾ	Bear
ᏧᏍᎦ	Oak
ᎠᏂ	Strawberry
ᏒᏗᏩᎵ	Raspberry
ᎧᏄᎦᎸ	Blackberry
ᏆᏅ	Peach
ᎣᏂᏥ	Orange (fruit)
ᎳᎢᎻ	Lime (fruit)
ᎠᎵᎮᎵᏍᏗ ᎢᎦ	Thanksgiving
ᎦᏓᏘ	Flag
ᎦᏍᎩᎶ	Chair
ᏗᎦᎵᏍᏚᎩᏍᎩ	Giraffe
ᎹᏱᏕ	Platypus
Queen	Queen (band)
ᏗᎦᎭᎵ	Lizard
ᏫᎩᏇᏗᏯ:ᎾᎥ ᏄᎾᏓᎸ ᎾᎿᎢ	Wikipedia:Village pump
ᎠᏍᏘᏂ	Austin, Texas
ᎭᏫᎾᏗᏢ ᏗᏎᏍᏗ ᎤᎬᏩᎵ	Plane (geometry)
ᎬᎾ ᎤᏔᎾ	Ostrich
ᎠᎺᎵᎨ ᎬᎾ ᎤᏔᎾ	Rhea (bird)
ᏓᏂᏍᏓᏲᎯᎲ	Christmas
Indo-European languages	Indo-European languages
ᏢᏓᏥᏧᎶᎸᏗ	Tiger
ᎼᏋᏗ	Montfort, Netherlands
ᎩᏳᎦ	Chipmunk
ᎠᏕᎵ	Adele
ᎠᏫ	Deer
ᎤᏁᏍᏓᎳ	Ice
ᎣᎩᏙᏓ ᎦᎸᎳᏗ ᎮᎯ	Lord's Prayer
ᎦᎦᎹ	Cucumber
ᏔᎹᏟ	Tomato
ᏎᎵᎾ	Selena
ᎵᎳ ᏙᏮᏍ	Lila Downs
ᏢᏓᏥ ᎠᎦᏣᏄᎳ	Cheetah
Felidae	Felidae
ᏑᎵ	Common buzzard
Escherichia coli	Escherichia coli
ᎠᏐᎠᏍᏙ	Earless seal
ᎠᏫᏳᏍᏘ	Antelope
ᎨᏯᏔᎯ ᎬᎾ	Wild turkey
ᎤᏍᏗᏰᎬ	Hair
ᎠᏍᏛᎭᏟ	Sandwich
ᏌᎵ	Persimmon
ᏥᏯ	European otter
ᏩᏂᎨ ᎠᏣᏗ	Jellyfish
Pinnipedia	Pinniped
ᎭᏰᎳᏍᏗ	Knife
ᏐᏈᎵ-ᏧᎶᎸᏗ	Zebra
ᏣᎳᎩ ᎧᏬᏂᎯᏍᏗ	Cherokee language
ᎠᎹᏍᎧᎦᎯ	Waterfall
ᏣᏱ ᎤᏬᏗᎨ	Bronze
ᏩᎭᎧ	Oaxaca
ᎪᏢᏅ	Butter
ᏗᎧᏃᎩᏛ ᎬᏔᏂᏓᏍᏗ	Musical instrument
ᏌᏌ	Swan
ᏅᏃᎯ	Road
ᏝᏪᏆ	Hippopotamus
ᎾᏳ	Sand
ᎫᏔᏍᏲᏍᏗ	Rose
ᏢᏓᏥ ᎤᏅᏣᏗ	Leopard
ᎠᏂᎪᎢ ᎤᏂᏃᎮᎸᎯ	Greek mythology
ᎠᎺᎵᎨ ᎤᏂᎬᏫᏳᎯ	List of Presidents of the United States
ᏓᏎᏘ	Mirror
ᏢᏓᏥ	Cougar
ᎠᏩᎶᏓᎢᏘ	Aphrodite
ᎤᏍᏔᎦᎳᏱ	Cave
ᎠᎺᎵᎨ ᏢᏓᏥ ᎤᏅᏣᏗ	Jaguar
ᎪᏩᎳ ᏲᎾ	Koala
ᎤᎶᎩᎸ ᏢᏓᏥ	Clouded leopard
ᎠᏍᎩᏘᏍᏗ	Dream
ᏥᏍᏕᏥ	Rat
ᎠᏂᎪᎢ ᎧᏬᏂᎯᏍᏗ	Modern Greek
ᎠᏂᏃᎯᎵᏙᎲ	Hunting
ᎠᏉᎳ	Apollo
ᎬᎩᏍᏗ	Watermelon
ᎤᎬᏫᏳᎯ ᎡᏆ	Emperor
ᎪᎱᏍᏗ ᎬᏔᏂᏓᏍᏗ	Tool
ᏣᏱ	Brass
ᎤᎨᏓᎵᏴ	Valley
ᎠᏓᏢᎢᎯ	Octopus
ᏗᏑᏫᏍᎩ ᎡᏆ	Walrus
ᎭᎹᏏ	Hermes
ᏧᎾᏓᏱᎵᏓᏍᏗ	Court
ᏚᏯ	Phaseolus vulgaris
ᎠᏂᏨᎹᏂ	English people
ᎠᎵᏍᏕᎸᏙᏗ ᎠᏕᎸ ᎬᏗ	Finance
ᎪᎦ	Corvus (genus)
ᏩᎴᎳ	Hummingbird
ᎬᎾ	Turkey (bird)
ᎠᏂᏳᎧᏪᏂ	Ukrainians
ᎤᎦᏔ	Flax
The Doors	The Doors
ᎠᏂᏣᏍᎩᎵ	Ghost
ᎠᏂᏔᎢᏖᏂ	Titan (mythology)
ᏑᏏ	Sushi
ᏐᏃᎳ	Sonora
ᎤᏪᏴᎢ	Stream
ᏙᏯ	Beaver
ᏫᎾᏏ	Venus (mythology)
ᎤᏯᏍᎦᎳ	Armadillo
Template:Commonscat	Template:Commons category
ᏧᎴᎯᏌᏅᎯ	Phoenix (mythology)
ᎠᏂᏲᎾ	Russians
ᎠᏂᎢᏔᎵ	Italians
Dire Straits	Dire Straits
ᏓᎬᎾ ᏥᏳ ᏗᏔᎳᏗᏍᏗ ᏚᎦᏘᎸᏒᎢ	Attack on Pearl Harbor
Template:Taxobox	Template:Taxobox
ᏩᎶᏏ	Frog
ᏧᎵᏍᏓᎾᎵ	Catfish
ᏳᎧᏔᏂ	Yucatán
ᎭᏩᏱ ᏗᎧᏃᎩᏍᏗ	Ukulele
ᎬᎪᏩᏛᏗ ᏗᎧᏃᏗ	Visible spectrum
Morse ᎠᏍᏓᏩᏛᏍᏙᏗ	Morse code
ᏳᏪᏅᏍ (ᎤᏁᎳᏅᎯ)	Uranus (mythology)
ᏩᏓᏚᎦ	Dragonfly
ᎠᎳ ᏊᎦᏦᏩ	Alla Pugacheva
ᎦᏃᎸᏍᎩ ᎠᎦᏍᎩ	Storm
ᎦᏩᏒᎩ	Muskmelon
ᏍᎪᏯ ᎠᏁᏍᎩᎸᎥᏍᎩ	Caterpillar
ᎠᏂᏍᏆᏂ (ᎧᏃᎮᎭ)	State of Mexico
ᏝᏍᎧᎳ	Tlaxcala
ᏓᏫᏍᎦᎳ	Flint
ᏓᏬᎵ	Mushroom
ᏐᏈᎵ-ᎠᏍᎦᏯ	Centaur
ᏗᎳ	Skunk
ᎠᏂᎬᎾ	Turkish people
Carl Menger	Carl Menger
Template:Cite book	Template:Cite book
ᎦᏯ	Gaia (mythology)
ᎡᎳᏗᏝ ᎬᎾ ᎤᏔᎾ	Emu
ᎠᎹᏳᎸᏗ	Coast
ᎤᎭᎸᏂ	Bell (instrument)
ᏣᎳᎩ	Cherokee
ᎠᏂᎾᏩᎰ	Navajo people
Uriah Heep	Uriah Heep (band)
ᎠᏂᎦᎸᏥ	French people
ᏗᏂᏃᎨᏂ	Rifle
ᎠᏂᏍᏫᏍ	Swiss people
ᏧᏃ (ᎤᏁᎳᏅᎯ)	Juno (mythology)
ᏌᏆᏯ	Sapphire
ᎠᏍᏆᏂᎪᏒᏗ ᏂᎦᎵᏍᏔᏂᏙᎲ	Fireworks
Panthera	Panthera
ᎠᏥᎾ	Cedrus
ᏢᏕᎦ	Eel
ᏋᏏᎥᏍ	Perseus
ᏓᎾᎵᏍᏓᏴᎲᏍᎬ	Festival
ᏓᏰᏂ	Diana (mythology)
ᎠᏂᎲᏂᎦᎵ	Hungarians
ᎬᏙ ᎾᏍᏅᏏ	One Direction
ᏃᏥᏳᏍᏗ ᏒᎦᏔ	Ananas
ᎤᎬᏫᏳᎯ ᎡᏆ ᏇᏠ II	Pedro II of Brazil
ᎾᏍᎦᏅᎾ	Virtue
Inachis io	Aglais io
ᎠᏂᏍᏆᏂ	Spanish people
ᏤᏊᎳᏍᎧ	Cheburashka
ᎠᏂᏕᏂ	Danes
ᎠᏂᏍᏫᏗ	Swedes
ᎢᏯ	Pumpkin
ᏭᏕᎵᎬ	Sunset
ᏌᎪᏂᎨ ᏣᎴᎩ	Blue Ridge Mountains
ᎤᏁᎫᎯᏍᏗ	Mayonnaise
ᏓᏆ	Baleen whale
ᎠᏂᏤᎩ	Czechs
ᎠᏂᏫᏂ	Finns
ᎠᏂᎠᏲᎵᏍ	Irish people
ᎠᏂᏍᎶᏩᎩ	Slovaks
ᎢᎣᎷ	Aeolus
ᎤᏜᏩᏓ	Macropus
ᎾᎥ ᏄᎾᏓᎸ	Community
ᎠᏂᏉᏧᎦᎵ	Portuguese people
ᏪᏍᏔ (ᎤᏁᎳᏅᎯ)	Vesta (mythology)
ᎠᏂᏍᎧᏥ	Scottish people
ᎠᎺᏉ ᎠᎨᏴ	Mermaid
ᎠᎢᎵᏏ	Iris (mythology)
Rita Levi-Montalcini	Rita Levi-Montalcini
ᏧᎳ	Vulpes
ᎠᏂᏪᎵᏏ	Welsh people
ᎠᏂᏃᏫᏥᏂ	Norwegians
ᎠᏂᎤᏁᏍᏓᎳ	Icelanders
ᎹᏔ ᏩᏒᏓᎾ	Martha Washington
ᎡᏆ ᎠᎺᎵᎨ ᎬᎾ ᎤᏔᎾ	Greater rhea
ᎠᏂᏛᏥ	Dutch people
Tigranes the Great	Tigranes the Great
ᎭᏯᏏᏂ	Hyacinth (mythology)
ᏎᏗ	Walnut
ᎶᏃᎶᏃ	Rongorongo
ᎤᏁᎳᏅᎢᎤᏪᏥ	Amazing Grace
ᎤᏯᏍᎦ	Seashell
ᎠᎺᏉᎯ ᎤᏁᏍᏓᎳ	Sea ice
Ayyavazhi	Ayyavazhi
ᎠᏅᎬᏂ	Anggun
ᎤᎵᎾᏫ	Turtle
ᏓᎦᎦ	Horse-fly
ᎢᏃᎵ	American badger
ᎠᏂᏓᏪᎯ	Angel
ᎠᏂᎡᏍᏙᏂᎠᏂ	Austrians
ᎪᎷᏩᏛᎲ ᎢᎬᏁᏗ	Patent
Neofelis	Neofelis
ᏍᏏᏉᏯ	Sequoyah
ᏗᎭᏄᎧᎯ	Santa Claus
Anthocharis cardamines	Anthocharis cardamines
Delias eucharis	Delias eucharis
ᎠᏓᎦᏙᎯ ᎠᏓᏅᏖᎵᏙᎲ	Forest management
Talicada nyseus	Talicada nyseus
ᎠᏓᏍᏕᎸᏗ	Charity (virtue)
ᏴᏩᏁᎬ ᏥᏉᏉ	American robin
ᏔᏘᏯᎾ ᏊᎳᏃᏩ	Tatiana Bulanova
ᎤᎾᎩᎾ	American chestnut
ᎠᏂᏇᎳᎷᏍ	Belarusians
ᎠᏂᎶᎺᏂᎠᏂ	Romanians
ᏈᎵᎩ ᎩᎵᎪᎶᏫ	Philipp Kirkorov
ᎠᏂᎪᎢ	Greeks
ᎤᎫᎾ	Badger
ᏧᏴᏢ ᏗᎧᎸ ᏃᏈᏏ	Pole star
ᎬᎮ	Lynx
ᏕᎦᏃᏣᎸ	Telegraphy
ᏓᎵᏆ	Tahlequah, Oklahoma
ᎨᏥᎧᎲᏓ ᎠᏁᎬᎢ	Trail of Tears
Geitoneura klugii	Geitoneura klugii
ᏎᎷ ᎤᏂᏥ ᎠᏯᏟᏗ	Job's Tears
Struthioniformes	Ratite
ᎬᎿᎨ ᏎᏗ	Juglans nigra
ᎠᏂᏆᏏᎵ	Brazilians
ᎠᏂᎢᏤᎢᏳᏍᏗ	Greenlandic Inuit
ᎧᏁᏨᎢ	Ballot
ᏥᏍᏛᎾ	Astacidea
ᎦᎶᎵᎠᏂ	Florian (name)
ᎢᏤ ᎢᏳᏍᏗᎤ ᏪᏴ	Green River (Colorado River)
ᏩᎦᏧᎧᏅᏍᏕᎾ ᎤᏂᎾᏗᏅᏗ	Market trend
ᏣᎳᎩ ᏧᎴᎯᏌᏅᎯ	Cherokee Phoenix
ᎠᏫᏒᏅ	Garden
ᏎᎷ ᎦᏚ	Cornbread
ᎠᏂᎺᏏᎪ	Mexican people
ᎡᏆ ᏚᏧᏍᏚ ᏙᏓᎸ	Great Smoky Mountains
ᎡᎩᏁᏍ ᎹᏂᎧ	Agnez Mo
ᎠᏂᏇᎵᏥᎥᎻ	Belgians
Category:ᎠᎹᏰᏟ	Category:United States
Category:ᎨᎾᏓ	Category:Canada
Category:ᏥᏍᏆ	Category:Birds
Category:Plantae	Category:Plants
Category:ᎧᏃᎮᏍᎩ	Category:History
Category:ᎤᎾᏙᏢᎯ	Category:Society
Category:ᏗᏛᎪᏔᏅ	Category:Communication
Category:ᎡᎶᎯ	Category:Earth
ᏦᎢ ᎠᎾᏓᎸᎢ	Three Sisters (agriculture)
ᎤᏐᎪᏍᏓᎩᎦᎨ ᎣᎭᎳ	Scarlett O'Hara
Rathinda amor	Rathinda amor
Dryas iulia	Dryas iulia
ᎨᎵᏍᎩ	Crumble
Zemeros flegyas	Zemeros flegyas
ᏬᎭᎵ	Eagle
Polyura athamas	Polyura athamas
Discolampa ethion	Discolampa ethion
ᎧᎹᎹ ᎤᏔᎾ	Elephantidae
Abisara neophron	Abisara neophron
Morpho rhetenor helena	Morpho helena
ᎠᎳᏍᏚᎶ	Turban
ᎠᎹᏗᎧᏂᎬᎾᎬᎾ	Nowata, Oklahoma
ᏎᎼᏂ	Salmon
ᏧᎾᎦ	Brown trout
Category:Stub	Category:Stubs
Category:ᎡᏆ ᎦᏙᎯ	Category:Continents
ᏧᏂᏴᏫ	Pillsbury Doughboy
ᎪᎢ ᎤᏅᏗ ᎦᏚᏅ ᎨᎵᏍᎩ	Tiropita
ᏗᎦᎪᏗ ᏚᎾᏙᎥ ᏙᎪᏪᎸ	List of plants by common name
ᏧᏂᎵᎦᎳ	Giant (mythology)
ᏓᎶᏂᎨ ᎠᏓᏛᏍᎩ	Apricot
ᎫᎴ	Acorn
Template:Wikipedialang	Template:Wikipedia languages
Category:ᎠᏰᎵ ᏚᎾᏙᏢᏩᏗᏒ	Category:Countries
Category:ᎠᎾᎵᏏᎾᎯᏍᏗᏍᎩ	Category:Economics
Wikipedia:Administrators	Wikipedia:Administrators
Category:ᎠᏂᏴᏫ	Category:People
Category:ᎤᏁᎳᏅ ᎤᏬᏢᏅ	Category:Nature
Category:ᎠᏕᎸ	Category:Money
Wikipedia:Vital 100	Wikipedia:Vital articles/Level/2
Template:Bot	Template:Bot
Wikipedia:What Wikipedia is not	Wikipedia:What Wikipedia is not
ᎨᎾᏓ	Canada
Category:ᏳᎳᏛ	Category:Europe
Current events	Portal:Current events
Template:Documentation	Template:Documentation
Wikipedia:NLT/ENGLISH	Wikipedia:No legal threats
Wikipedia:Neutral point of view	Wikipedia:Neutral point of view
Wikipedia:Vandalism	Wikipedia:Vandalism
Sung Jae-gi	Sung Jae-gi
ᎡᏂᏗ ᎡᎯᏍᏗ	Andy Payne
ᏗᎦᎸᏫᏍᏓᏁᏗ	Business
Template:Softredirect	Template:Soft redirect
Template:Delete	Template:Db
ᏍᏗᏫ	Stephen
ᎹᏱᎩᎵ	Michael
Category:ᎦᏬᏂᎯᏍᏗ	Category:Languages
Category:ᏫᎩᏇᏗᏯ	Category:Wikipedia
Wikipedia:TROLL	Wikipedia:What is a troll?
Template:Navbox	Template:Navbox
ᏣᎳᎩ ᎫᎾᏕᎶᏆᏍᏗ ᏚᏓᏥᏍᎬᎢ	Cherokee Central Schools
Template:Nutshell	Template:Nutshell
ᏍᏆᏏ	Squash (plant)
Template:Clear	Template:Clear
Template:Col-break	Template:Col-break
Template:Col-begin	Template:Col-begin
Template:Col-end	Template:Col-end
Template:Bots	Template:Bots
Template:Anchor	Template:Anchor
Category:ᎬᎿᎦᏍᏛ	Category:Africa
Category:ᏗᎪᏪᎵ	Category:Books
Template:Babel	Template:Babel
Template:Commons	Template:Commons
Template:Reflist	Template:Reflist
Wikipedia:Searching	Help:Searching
Template:Stub	Template:Stub
Template:User af-1	Template:User af-1
Template:User eo-1	Template:User eo-1
Template:User da	Template:User da
Template:User da-1	Template:User da-1
Template:User eo-3	Template:User eo-3
Template:User de	Template:User de
Template:User de-1	Template:User de-1
Template:User et-1	Template:User et-1
Template:User el	Template:User el
Template:User es	Template:User es
Template:User en-3	Template:User en-3
Template:User en-1	Template:User en-1
Template:User en-2	Template:User en-2
Template:User eo-2	Template:User eo-2
Template:User en-4	Template:User en-4
Template:User en	Template:User en
Template:User de-2	Template:User de-2
Template:User fr-1	Template:User fr-1
Category:ᏗᏓᏅᏖᏗ	Category:Concepts
Category:ᎥᎴᏂᏙᎲ	Category:Life
Template:User ia-2	Template:User ia-2
Template:User io-3	Template:User io-3
Template:User ja-4	Template:User ja-4
Template:User sk	Template:User sk
Template:User fr-2	Template:User fr-2
Template:User ja	Template:User ja
Template:User ja-1	Template:User ja-1
Template:User fr	Template:User fr
Category:ᏨᏍᎪᏱ	Category:Insects
Category:ᏓᎶᏂᎦᏍᏛ	Category:Asia
Category:ᏧᎦᎾᏮ ᎠᎹᏰᎵ	Category:South America
Category:User uk-N	Category:User uk-N
Template:Esoteric	Template:Intricate template
Template:Mod	Template:Mod
Template:User sv	Template:User sv
Template:SIL	Template:Infobox language/codelist
Template:User uk	Template:User uk
Template:User es-2	Template:User es-2
Template:Tsilugi	Template:Welcome
Template:Wikipediasister	Template:Wikipedia's sister projects
Category:User fr-1	Category:User fr-1
Template:Wikiquote	Template:Wikiquote
Template:User chr-1	Template:User chr-1
Template:Image label	Template:Image label
Template:Switch	Template:Switch
Template:Documentation/docname	Template:Documentation/docname
Template:Cite journal	Template:Cite journal
Category:User en-4	Category:User en-4
Category:User en	Category:User en
Template:Ombox	Template:Ombox
Category:ᎠᎵᏍᏓᏴᏗ ᎠᎴ ᎠᏗᏔᏍᏗ	Category:Food and drink
Template:Pp-template	Template:Pp-template
Template:Wiktionary	Template:Wiktionary
Template:Multi-listen start	Template:Multi-listen start
Category:ᏗᎦᎶᎪᏗ	Category:Agriculture
Category:ᎠᏂᎪᎢ ᎤᎾᏁᎳᏅᎯ	Category:Greek deities
Template:Ethnic group	Template:Infobox ethnic group
Template:Namespace detect	Template:Namespace detect
Template:User nl	Template:User nl
Template:User no-2	Template:User no-2
Template:Image label end	Template:Image label end
Template:Documentation subpage	Template:Documentation subpage
Template:Userpage	Template:User page
Template:Image label small	Template:Image label small
Template:ᎡᎶᏆ	Template:Europe and seas labelled map
Template:Mbox	Template:Mbox
Template:Infobox Continent	Template:Infobox continent
Category:User ja-N	Category:User ja-N
Template:Verify source	Template:Verify source
Template:Hang on	Template:Hang on
Template:Uw-advert3	Template:Uw-advert3
ᎾᏆᏍᏛᏉᎦᏥᏍᎦᏂ	Just As I Am (hymn)
Category:User chr	Category:User chr
Category:User sk	Category:User sk
Category:User eo	Category:User eo
Category:User fr	Category:User fr
Category:User gl	Category:User gl
Category:User ja	Category:User ja
Category:User sv	Category:User sv
Category:User fr-N	Category:User fr-N
Category:User gl-N	Category:User gl-N
Category:Wikipedia cleanup	Category:Articles needing cleanup
Category:User chr-1	Category:User chr-1
Category:User chr-2	Category:User chr-2
Category:User sk-N	Category:User sk-N
Category:User de	Category:User de
Category:User de-2	Category:User de-2
Category:User en-3	Category:User en-3
Category:User en-N	Category:User en-N
Category:User es	Category:User es
Category:User es-2	Category:User es-2
Category:User es-N	Category:User es-N
Template:Adminbox	Template:User wikipedia/Administrator
Category:ᎠᎪᏩᏏᏗ	Category:Vision
Template:User gl	Template:User gl
ᏫᎩᏇᏗᏯ:Babel	Wikipedia:Babel
Template:User sv-1	Template:User sv-1
Category:ᎠᏂᎪᎢ ᎤᎾᏁᎳᏅᎯ ᎠᏂᎨᏴ	Category:Greek goddesses
Category:ᎠᎹ	Category:Water
Template:User ko-3	Template:User ko-3
Category:User sv-N	Category:User sv-N
Category:User wa	Category:User wa
Category:User wa-N	Category:User wa-N
Category:ᏚᏓᏡᎬ	Category:Articles
Template:User tr-1	Template:User tr-1
Template:User zh-2	Template:User zh-2
Template:Multi-listen end	Template:Multi-listen end
Category:ᎠᎾᎵᏖᎸᎲᏍᎬ ᎦᏁᏰᎩ	Category:Violence
Category:ᏧᏓᎴᏅᏓ ᎫᎵᏍᏔᏅ ᏑᏓᎴᎩ	Category:Chemical elements
Template:User de-4	Template:User de-4
Category:ᎠᏣᏗ	Category:Fish
Category:ᎤᎾᏓᏔᏅ ᎠᎩᏍᏗ	Category:Fruit
Category:ᏙᏯᏗᎳ ᏄᏍᏗᏓᏅ	Category:Climate
Category:Animalia	Category:Animals
Category:ᎠᏂᎪᎢ ᎤᏂᏃᎮᎸᎯ	Category:Greek mythology
Category:ᎠᏂᎩᏍᏙᏗ	Category:Transport
Category:ᎾᎥ ᏄᎾᏓᎸ	Category:Community
Category:ᏧᏴᏢ ᎠᎹᏰᎵ	Category:North America
Template:Uw-test2	Template:Uw-test2
Template:Substituted	Template:Subst only
Template:User fo	Template:User fo
Template:User chr-0	Template:User chr-0
Category:ᎠᏥᎳ	Category:Fire
Category:ᎠᎵᎮᎵᏍᏗ ᎢᎦ	Category:Thanksgiving
Category:ᏗᎧᏃᏗ	Category:Color
Template:Image label begin	Template:Image label begin
Template:Ombox/core	Template:Ombox/core
Category:User en-1	Category:User en-1
Category:User de-1	Category:User de-1
Template:PD-art	Template:PD-art
Template:Uw-advert2	Template:Uw-advert2
Template:User chr-4	Template:User chr-4
Template:Wstress3d	Template:Wstress3d
Template:User chr-2	Template:User chr-2
Wikipedia:VOTE	Wikipedia:Polling is not a substitute for discussion
Template:User chr-3	Template:User chr-3
Wikipedia:STALK	Wikipedia:Harassment
ᎧᎹᎹ (ᏨᏍᎪᏱ)	Butterfly
Wikipedia:Deletion log	Wikipedia:Deletion log
Template:Multi-listen item	Template:Multi-listen item
Template:Twinkle standard installation	Template:Twinkle standard installation
Special:RecentChanges	Special:RecentChanges
Module:HtmlBuilder	Module:HtmlBuilder
