非洲	Africa
日本	Japan
南美洲	South America
Nò-vî	Norway
Sû-kak-làn	Scotland
Vî-ngì-sṳ̂	Wales
Pet Oi-ngì-làn	Northern Ireland
Hiûng-ngà-li	Hungary
Sî-pân-ngà	Spain
Mî-koet	United States
Pí-li-sṳ̀	Belgium
Lù-sêm-pó	Luxembourg
Yî-chhiu	Universe
Thi-khiù	Earth
Sâng-miang	Life
Ngìn-lui	Human
George Washington	George Washington
Fûn-làn	Finland
Shuì-tién	Sweden
Tan-ma̍k	Denmark
Pô-làn	Poland
Li̍p-thâu-vón	Lithuania
Yi-thai-li	Italy
Shuì-sṳ	Switzerland
O-thi-li	Austria
Hî-lia̍p	Greece
Thú-ngí-khì	Turkey
Phù-thò-ngà	Portugal
歐洲	Europe
亞洲	Asia
北美洲	North America
南極洲	Antarctica
Vì-kî Pak-khô	Wikipedia
Hò-làn	Netherlands
Néu-yok-sṳ	New York City
Fà-sṳ̀n-tun Kô-lùn-pí-â Thi̍t-khî	Washington, D.C.
Khiu-kîm-sân	San Francisco
Pak-lìm	Berlin
Lo̍k-chhám-kî	Los Angeles
Thien-nó	Computer
Mióng-chi-mióng-lu	Internet
Barack Obama	Barack Obama
Vû-lâ-kûi	Uruguay
Lùn-tûn	London
Phìn-kó	Apple
Pâ-lì-sṳ	Paris
Â-pak-lâ-hón Lìm-khén	Abraham Lincoln
Google	Google
Me̍t-sî-kô	Mexico
Thai-sî-yòng	Atlantic Ocean
Thai-phìn-yòng	Pacific Ocean
Kâ-li-fuk-nì-â	California
Pô-sṳ-tun	Boston
Fó-sên	Mars
Âi-set-ngò-pí-â	Ethiopia
Sṳ̂-é	Lion
Fap-koet	France
Sṳ-kie-ngî	Esperanto
Kiéu-è	Dog
Yîn-koet	United Kingdom
Meu-é	Cat
中華人民共和國	China
Fap-ngî	French language
Ǹg-è	Fish
Pâ-sî	Brazil
François Hollande	François Hollande
Ngò-lò-sṳ̂	Russia
Kîn-ǹg	Cetacea
Chang-fông-hìn	Square
Mong-kó	Mango
Tô-lùn-tô	Toronto
Â-lâ-pâ-mâ	Alabama
Québec-sén	Quebec
Boeing 747	Boeing 747
Jimmy Wales	Jimmy Wales
Tet-koet	Germany
Pha̍k-ngò-lò-sṳ̂	Belarus
Tet-ngî	German language
Pên-tó	Iceland
Song-ti	God
Oi-sâ-nì-â	Estonia
David Cameron	David Cameron
Thú-sên	Saturn
Ku-thin-yi̍t Fî-kî	Airplane
1	1 (number)
2	2 (number)
3	3 (number)
4	4 (number)
5	5 (number)
George W. Bush	George W. Bush
Lâ-thot-vì-â	Latvia
Vû-khiet-làn	Ukraine
Tshia̍p-khiet	Czech Republic
Sṳ̂-lo̍k-vì-nì-â	Slovenia
Lò-mâ-nì-â	Romania
Pó-kâ-li-â	Bulgaria
Lò-mâ	Rome
Mâ-khì-tun	Republic of Macedonia
Â-ngì-pâ-nì-â	Albania
Khiet-lò-âi-sî-â	Croatia
Pô-sṳ-nì-â lâu Het-set-kô-vì-ná	Bosnia and Herzegovina
Â-set-pai-kiông	Azerbaijan
Set-phû-lu-sṳ̂	Cyprus
Kak-lû-kit-â	Georgia (country)
Hâ-sat-khiet-sṳ̂-thán	Kazakhstan
Mí-li-thai	Malta
Mô-na̍p-kô	Monaco
Mùng-thi̍t-nui-kô-lò	Montenegro
Sṳn Mâ-li-nok	San Marino
Kú-pâ	Cuba
Eiffel Thiet-thap	Eiffel Tower
Yin-thu-nì-sî-â	Indonesia
Wolfgang Amadeus Mozart	Wolfgang Amadeus Mozart
Pi-tô-fûn	Ludwig van Beethoven
Thú-ngí-khì-ngî	Turkish language
Nàm-fî	South Africa
Vû-tsṳ̂-phe̍t-khiet-sṳ̂-thán	Uzbekistan
Pô-tsṳ-nàm	Poznań
Fà-sâ	Warsaw
Súi	Water
Thien-sṳ	Television
Chṳ-li	Chile
Yâ-sû	Jesus
Súi-sên	Mercury (planet)
Li̍t-sṳ́	History
Phìn-kó Kûng-sṳ̂	Apple Inc.
Kîm-sên	Venus
Ngî-ngièn	Language
Muk-sên	Jupiter
Thiên-vòng-sên	Uranus
Pu-lie̍t-thap-nì	Brittany
Hói-vòng-sên	Neptune
Thiên-vùn-ho̍k	Astronomy
Sîn-kâ-po	Singapore
Khô-ho̍k	Science
Montréal	Montreal
Lie̍t-kî-tûn-sṳ-tên	Liechtenstein
Kiam-khiâu	Cambridge
Thi-ngi-chhṳ Sṳ-kie Thai-chan	World War II
Cologne	Cologne
Kak-tên-nì-â	Gdynia
Sṳ̍p-chhiet-chhiâng	Szczecin
Sṳ-ho̍k	Mathematics
Lâ-tên-ngî	Latin
Pâ-lìm	Bahrain
Â-mî-nì-â	Armenia
Set-ngì-vì-â	Serbia
Ngie̍t-khiù	Moon
Àu-thai-li-â	Australia
Vu̍t-lî-ho̍k	Physics
Â-kîn-thìn	Argentina
Pi-lû	Peru
Sâng-vu̍t-ho̍k	Biology
Tsêu-siên Mìn-tsú Tsú-ngi Ngìn-mìn Khiung-fò-koet	North Korea
Kán-pu-chhài	Cambodia
Khiúng-liùng	Dinosaur
Yî-sṳ̂-làn-kau	Islam
Lech Wałęsa	Lech Wałęsa
Lin-é	Wheel
Lyon	Lyon
Êu-chû Lièn-mèn	European Union
Rhône-Alpes	Rhône-Alpes
Chhiòn-khiù Chṳ̂-sín Mióng	World Wide Web
Ńg-ngìn	Woman
Khiûng-tsiâu	Banana
Fâ	Flower
Mâ-lî-â-na̍p-hói	Mariana Trench
Chû-mu̍k-lòng-mâ-fûng	Mount Everest
Sàng-sṳ	City
Nâ-pho-lùn yit-sṳ	Napoleon
Ngit-tèu	Sun
Pâ-sṳ-tet	Louis Pasteur
大洋洲	Oceania
Thai-yòng Hì	Solar System
Pô-lò-tit-hói	Baltic Sea
Ngâ-chhṳ	Tooth
Khîn	Hydrogen
Hoi (氦)	Helium
Angela Merkel	Angela Merkel
Lî	Lithium
Phì	Beryllium
Si	Book
Ngit	Day
Ngièn	Year
Sṳ-ki	Century
Lò-tsṳ (Pô-làn)	Łódź
Khà-thok-vì-chṳ	Katowice
Ngie̍t-sû-fû	Rzeszów
Phìn	Boron
Thàn	Carbon
Tham	Nitrogen
Yòng	Oxygen
Hàng-sên	Planet
Yîm-ngo̍k	Music
Rennes	Rennes
Mo̍k-sṳ̂-khô	Moscow
Fuk	Fluorine
Yi-thai-li-ngî	Italian language
Nái	Neon
Sṳn Pí-tet-páu	Saint Petersburg
Na̍p	Sodium
北	North
Mî	Magnesium
Lî (鋁)	Aluminium
Néu Sî-làn	New Zealand
南	South
Yin-thu	India
Si̍t	Silicon
Fap	Francium
Lìn	Phosphorus
Thiet	Iron
Tûng-kâ	Tonga
西	West
Liù-vòng	Sulfur
東	East
Liu̍k	Chlorine
Pâ-pu-â Néu-kí-nui-â	Papua New Guinea
Vî-lièn Sâ-sṳ-pí-â	William Shakespeare
Â (氬)	Argon
Kap	Potassium
Koi	Calcium
Yèn	Lead
Mùng-kú-koet	Mongolia
Khong (鈧)	Scandium
Thai	Titanium
Genghis Khan	Genghis Khan
Fàm	Vanadium
Mien-yîn	Maine
Kok	Chromium
Mâ	Horse
Thûng-vu̍t	Animal
Sû-li-nàm	Suriname
Màng	Manganese
Pâ-lâ-kûi	Paraguay
Koi-â-nâ	Guyana
Ngi-su̍t	Art
Lòi	Rhenium
Kô-lùn-pí-â	Colombia
Kû	Cobalt
Vû	Tungsten
Ngiap (鎳)	Nickel
Fu̍t-kau	Buddhism
Pô-li-vì-â	Bolivia
Tshṳ̀-nì-tha̍t lâu Tô-pâ-kô	Trinidad and Tobago
Chhṳ̍t-vu̍t	Plant
Sîn	Zinc
Néu Hàn-pu-ha	New Hampshire
Pí-â-vùi-sṳ̂-thok-khiet	Białystok
Ngà-mâi-kâ	Jamaica
Mà-sat-chû-set	Massachusetts
Drenthe-sén	Drenthe
Overijssel-sén	Overijssel
Kûa-thi-mâ-là	Guatemala
Gelderland-sén	Gelderland
Pâ-hâ-mâ	The Bahamas
Không-nái-tí-khiet-chû	Connecticut
Kiê-é	Chicken
Ha-vî-yî	Hawaii
Fùng-tû-lâ-sṳ̂	Honduras
Tô-mí-nì-kâ	Dominica
Tô-mí-nì-kâ Khiung-fò-koet	Dominican Republic
Kâ-chû (Thung-vu̍t)	Domestic pig
Hói-thi	Haiti
Sat-ngì-ngá-tô	El Salvador
Yî-lóng	Iran
Yî-là-khiet	Iraq
Â-lâ-sṳ̂-kâ	Alaska
Kô-sṳ̂-tha̍t Lì-kâ	Costa Rica
Yî-set-lie̍t	Israel
Pâ-nâ-mâ	Panama
Ya̍p-mùn	Yemen
Phiang-thu̍k	Virus
Pô-làn-ngî	Polish language
Yok-tan	Jordan
Nì-kâ-lâ-kûa	Nicaragua
Fu-lò-lî-tha̍t	Florida
Kit-ngí-kit-sṳ̂-thán	Kyrgyzstan
Â-li-sông-ná	Arizona
Khô-vî-thi̍t	Kuwait
Liàu-koet	Laos
Lì-pâ-nun	Lebanon
O-le̍t-kông	Oregon
Gi-tuk-gaau zung geh sin	God in Christianity
Mâ-ngì-thoi-fû	Maldives
Yù-thâ	Utah
Mâ-lòi-sî-â	Malaysia
Mién-thien	Burma
Nì-pok	Nepal
Â-man	Oman
Pâ-kî-sṳ̂-thán	Pakistan
Khà-tha̍t	Qatar
Mióng-khiù	Tennis
Sâ-vû-thi Â-lâ-pak	Saudi Arabia
Sṳ̂-lî-làn-khà	Sri Lanka
Si-li-â	Syria
Kâ	Gallium
Thap-kit-khiet-sṳ̂-thán	Tajikistan
中華民國	Taiwan
YouTube	YouTube
Châ	Germanium
Thai-koet	Thailand
Sṳ̂n	Arsenic
Thú-khû-man-sṳ̂-thán	Turkmenistan
Abakan	Abakan
Sî	Selenium
Yî	Iridium
Â-lâ-pak Lièn-ha̍p Thai-kûng-koet	United Arab Emirates
Tshiù (溴)	Bromine
Pha̍k (鉑)	Platinum
Ye̍t-nàm	Vietnam
Thai-hòn Mìn-koet	South Korea
Khiet	Krypton
Â-fu-hon	Afghanistan
J. R. R. Tolkien	J. R. R. Tolkien
Lù	Rubidium
Kîm	Gold
Men-kâ-lâ-koet	Bangladesh
Ufa	Ufa
Ôn-kô-lâ	Angola
Vùn-lòi	Brunei
Kúng	Mercury (element)
Fî-li̍t-pîn	Philippines
Thò	Thallium
Ngie-sat-khiet Ngiù-tun	Isaac Newton
Albert Einstein	Albert Einstein
Sṳ̂	Strontium
Yet	Yttrium
Pit	Bismuth
Vòng-set	Yellow
Tsan-pí-â	Zambia
Sîn-pâ-pu-vî	Zimbabwe
北京	Beijing
Tuva Khiung-fò-koet	Tuva
Pok-tshṳ-ngá-na̍p	Botswana
Pho (釙)	Polonium
Bayern	Bavaria
Baden-Württemberg	Baden-Württemberg
Ngo (砈)	Astatine
Lòi-sò-thok	Lesotho
Mâ-tha̍t-kâ-sṳ̂-kâ	Madagascar
Mâ-là-vî	Malawi
Stuttgart	Stuttgart
Màu-li-thap-nì-â	Mauritania
Pô-làn-ngìn	Poles
Mo̍k-sông-pí-khiet	Mozambique
Na̍p-mí-pí-â	Namibia
Nai-khi̍p-li-â	Nigeria
Ko	Zirconium
Nì	Niobium
Yû-li-vû-sṳ̂ Khái-sat	Julius Caesar
Sṳ̂-vî-sṳ-làn	Swaziland
Muk	Molybdenum
Thap	Technetium
Hamburg	Hamburg
Thoi-chhia	Metabolism
Miên-yi̍t Hì-thúng	Immune system
Lièn-ha̍p-koet	United Nations
Sîm-chhong	Heart
Thèu-nó	Brain
Phì-fû	Skin
Ló	Rhodium
Làm-set	Blue
Pâ	Palladium
Ngiùn	Silver
Kak	Cadmium
Yîn	Indium
Siak	Tin
Yu	Uranium
Thi (銻)	Antimony
Ti	Tellurium
Pu	Plutonium
Tièn	Iodine
Nai	Neptunium
Set	Caesium
Phù	Protactinium
Pi	Barium
Thú	Thorium
Kap (鉿)	Hafnium
Than (鉭)	Tantalum
Luì	Radium
Tûng	Radon
Alsace	Alsace
Auvergne	Auvergne (region)
Ôn-tet-là-pâng	Andhra Pradesh
Me̍t-hiet-kîn	Michigan
Burgundy	Burgundy
Aquitaine	Aquitaine
Schleswig-Holstein	Schleswig-Holstein
Hâ Saxony	Lower Saxony
Pet Rhine-Westphalia	North Rhine-Westphalia
Saxony	Saxony
Yî-li-nò	Illinois
Thuringia	Thuringia
Saxony-Anhalt	Saxony-Anhalt
Pet Tha̍t-khô-thâ	North Dakota
Brandenburg	Brandenburg
Bremen-chû	Bremen (state)
Nàm Tha̍t-khô-thâ	South Dakota
Mùng-thai-nâ	Montana
Fài-ngò-mìn	Wyoming
Yâ-lu-sat-lâng	Jerusalem
Oi-tha̍t-hòt	Idaho
Fà-sṳn-tun	Washington (state)
Lù (鑪)	Rutherfordium
Nui-fà-tha̍t	Nevada
Hàn (𨧀)	Dubnium
Hí (𨭎)	Seaborgium
Yin-thu-yòng	Indian Ocean
Khô-sò-vok	Kosovo
Kâ-le̍t-pí-hói	Caribbean Sea
Pô (𨨏)	Bohrium
Het (𨭆)	Hassium
Phan Kî-vùn	Ban Ki-moon
Ma̍k (䥑)	Meitnerium
Khô-lò-là-tô	Colorado
Tha̍t	Darmstadtium
Siau-pâng	Frédéric Chopin
Lùn	Roentgenium
Kô (鎶)	Copernicium
分類:Chú-yeu fûn-lui	Category:Contents
Chi-kâ-kô	Chicago
Arnhem	Arnhem
Tûng-kui	Winter
Sî-pân-ngà-ngî	Spanish language
Fî-là-thiet-fî	Philadelphia
Tî-tû	Spider
Hèu-è	Monkey
Kîm-tshièn	Money
Vì-kit-nì-â	Virginia
Sî Vì-kit-nì-â	West Virginia
Tshiâng-tséu	Capsicum annuum
Néu-yok-chû	New York
Sṳ (鈰)	Cerium
Phú	Praseodymium
Lò-tet-tó	Rhode Island
Ńg	Neodymium
Khûn-chhùng	Insect
Mâ-lî-làn	Maryland
Thi̍t-lâ-ngá	Delaware
Yû (銪)	Europium
Ngò-hài-ngò	Ohio
Vì-kit-ngì	Virgil
Machiavelli	Niccolò Machiavelli
Pîn-sé-fap-nì-â	Pennsylvania
Uetersen	Uetersen
O-kú-sṳ̂-tû	Augustus
Néu Chhe̍t-sî-chû	New Jersey
Fûn-làn-ngî	Finnish language
Yin-thi-ôn-na̍p	Indiana
Vì-sṳ̂-pha-siên	Vespasian
Thù-là-chṳ̂n	Trajan
Hâ-tet-liòng	Hadrian
Khièu-tshṳ-â	Georgia (U.S. state)
Mâ-khù-sṳ̂ O-lie̍t-lî-vû-sṳ̂	Marcus Aurelius
Zagreb	Zagreb
Tet-khiet-sat-sṳ̂	Texas
Thai-mí-ngì-na̍p-tet-pâng	Tamil Nadu
Pet Khà-lò-lòi-na̍p	North Carolina
Nàm Khà-lò-lòi-na̍p	South Carolina
Loire-sén	Loire
Pâ-set-lò-nâ	Barcelona
Vòng-lî	Pineapple
Me̍t-sî-sî-pí	Mississippi
Thièn-na̍p-sî	Tennessee
Néu Me̍t-sî-kô	New Mexico
Mìn-nì-sû-tha̍t	Minnesota
Vî-sṳ̂-không-sîn	Wisconsin
Oi-hò-fà	Iowa
Nui-pu-lâ-sṳ̂-kâ	Nebraska
Khâm-sat-sṳ̂	Kansas
Yin-thi-ngî	Hindi
Me̍t-sû-lî	Missouri
Lu-yi-sṳ̂-ôn-ná	Louisiana
Khén-thap-kî	Kentucky
Â-khén-set	Arkansas
Neil Armstrong	Neil Armstrong
O-khiet-lâ-hò-mâ	Oklahoma
Pet-hói	North Sea
Mo̍k-sṳ̂-khô-chû	Moscow Oblast
Kiel	Kiel
Schwerin	Schwerin
Potsdam	Potsdam
Hanover	Hanover
Düsseldorf	Düsseldorf
Mainz	Mainz
Wiesbaden	Wiesbaden
Saarbrücken	Saarbrücken
Mu-nì-het	Munich
Erfurt	Erfurt
Dresden	Dresden
Kaliningrad-chû	Kaliningrad Oblast
Murmansk-chû	Murmansk Oblast
Kak-than-sṳ̂-khiet	Gdańsk
Fap-làn-khiet-fuk	Frankfurt
Fut-lò-tshṳ-ngá-fû	Wrocław
Làn	Lanthanum
Ki (鉕)	Promethium
Sân	Samarium
Â-chhè Thi̍t-phe̍t Hàng-chṳn-khî	Aceh
Nga̍t (釓)	Gadolinium
Thi̍t (鋱)	Terbium
Tit (鏑)	Dysprosium
Sṳn-kîn	Bible
Fó	Holmium
Ngí (鉺)	Erbium
Tiû	Thulium
Yi	Ytterbium
Liu	Lutetium
Hò-nui-sṳ	Hanoi
Chṳ̂n Yâ-sû Kau-fi	True Jesus Church
Yîn-ngî	English language
Màn-kuk	Bangkok
Kit-lùng-po	Kuala Lumpur
Pâng-kâ Vú-lî-thung-sén	Bangka–Belitung Islands
Thòi-pet-sṳ	Taipei
Mî (鋂)	Americium
Arkhangelsk-chû	Arkhangelsk Oblast
Khiu̍k	Curium
Thùng-hói-sṳ	Đồng Hới
Concepción	Concepción, Chile
Pet (鉳)	Berkelium
Khà (鉲)	Californium
Mìn-kú-lû-sén	Bengkulu
Oi	Einsteinium
Fi	Fermium
Mùn	Mendelevium
Na	Nobelium
Ontario-sén	Ontario
Lò	Lawrencium
Karelia Khiung-fò-koet	Republic of Karelia
Końskowola	Końskowola
2002-ngièn	2002
2008-ngièn	2008
Charles de Gaulle	Charles de Gaulle
Cham-pî-sén	Jambi
Komi Khiung-fò-koet	Komi Republic
Nâm-póng-sén	Lampung
Pet Sû-mùn-tap-lia̍p-sén	North Sumatra
Syktyvkar	Syktyvkar
Québec-sṳ	Quebec City
Nenets Chhṳ-chhṳ-khî	Nenets Autonomous Okrug
Liàu-nui-sén	Riau
Leningrad-chû	Leningrad Oblast
Pskov-chû	Pskov Oblast
Liàu-nui Khiùn-tó-sén	Riau Islands Province
Nizhny Novgorod-chû	Nizhny Novgorod Oblast
Nàm Sû-mùn-tap-lia̍p-sén	South Sumatra
Lò-mâ Ti-koet	Roman Empire
Mì-ngiôn Kûng-sṳ̂	Microsoft
Tver-chû	Tver Oblast
Khù-lû-fû	Kurów
Fa-ho̍k	Chemistry
Smolensk-chû	Smolensk Oblast
Yaroslavl-chû	Yaroslavl Oblast
Kostroma-chû	Kostroma Oblast
Ivanovo-chû	Ivanovo Oblast
Arnold Schwarzenegger	Arnold Schwarzenegger
Chiuk-khiù	Association football
Ryazan-chû	Ryazan Oblast
IPhone	IPhone
Sî Sû-mùn-tap-lia̍p-sén	West Sumatra
Tula-chû	Tula Oblast
IPad	IPad
Mâ-tet-lî	Madrid
Bryansk-chû	Bryansk Oblast
Michael Jackson	Michael Jackson
Kaluga-chû	Kaluga Oblast
Loire-Atlantique-sén	Loire-Atlantique
Ain-sén	Ain
Allier-sén	Allier
Khâm-phì-là	Canberra
Sông Alpes-sén	Hautes-Alpes
Oryol-chû	Oryol Oblast
Sit-nì	Sydney
Alpes-de-Haute-Provence-sén	Alpes-de-Haute-Provence
Liu̍k-set	Green
Alpes-Maritimes-sén	Alpes-Maritimes
Hâ-tet-sùn-hò	Hudson River
Me̍t-ngì-pún	Melbourne
Fùng-set	Red
Ardèche-sén	Ardèche
Jena	Jena
Kursk-chû	Kursk Oblast
Ariège-sén	Ariège (department)
Aude-sén	Aude
Aveyron-sén	Aveyron
Sîn Nàm Vî-ngì-sṳ̂-chû	New South Wales
Bouches-du-Rhône-sén	Bouches-du-Rhône
Àu-thai-li-â Sú-tû Liâng-thi	Australian Capital Territory
Cantal-sén	Cantal
Belgorod-chû	Belgorod Oblast
Côte-d'Or-sén	Côte-d'Or
Côtes-d'Armor-sén	Côtes-d'Armor
Drôme-sén	Drôme
Finistère-sén	Finistère
Voronezh-chû	Voronezh Oblast
Sû-mùn-tap-lia̍p	Sumatra
Lipetsk-chû	Lipetsk Oblast
Van-tan-sén	Banten
Chûng Cháu-ôa-sén	Central Java
Fùi-sên	Comet
Rostov-chû	Rostov Oblast
Tûng Cháu-ôa-sén	East Java
Ngâ-kâ-tha̍t Sú-tû Thi̍t-khî	Jakarta
Sî Cháu-ôa-sén	West Java
Adygea Khiung-fò-koet	Adygea
Ngit-ngiâ Thi-fông Thi̍t-khî	Special Region of Yogyakarta
Gera	Gera
Maykop	Maykop
Cháu-ôa-tó	Java
Kâ-lî-man-tân-chû	Kalimantan
Séu Sùn-thâ Khiùn-tó	Lesser Sunda Islands
Sû-lâ-vî-sî-tó	Sulawesi
Mô-lu̍k-kâ Khiùn-tó	Maluku Islands
Chûng Kâ-lî-man-tân-sén	Central Kalimantan
Tûng Kâ-lî-man-tân-sén	East Kalimantan
Nàm Kâ-lî-man-tân-sén	South Kalimantan
Kâ-li-sî-â	Galicia (Spain)
Sî Kâ-lî-man-tân-sén	West Kalimantan
Thai-ho̍k	University
Pretoria	Pretoria
Chok-khiù	Table tennis
Â-sṳ̂-thù-lî-â-sṳ̂	Asturias
Wikipedia:Sandbox	Wikipedia:Sandbox
Astrakhan-chû	Astrakhan Oblast
Kham-thap-pu-lî-â	Cantabria
Kalmykia Khiung-fò-koet	Kalmykia
Weimar	Weimar
Osasco	Osasco
Â-là-kung	Aragon
Kak-là-sṳ̂-kô	Glasgow
Thùng-hói Kî-chhòng	Dong Hoi Airport
Vú-lîn-ngièn Fûng-kín Miàng-sṳn-khî	Wulingyuan
分類:Thòi-vân li̍t-sṳ́	Category:History of Taiwan
Curitiba	Curitiba
Chloë Grace Moretz	Chloë Grace Moretz
Khûng-chṳ́	Confucius
Corbin Bleu	Corbin Bleu
分類:Sṳ-ho̍k	Category:Mathematics
分類:Ngìn-kûng ngî-ngièn	Category:Constructed languages
Pâ-lî-sén	Bali
Mî-kîm	United States dollar
Thi-chûng-hói	Mediterranean Sea
Hông-chû-sṳ	Hangzhou
Kî-tuk-kau	Christianity
Tûng Nú-sâ Tên-kâ-là-sén	East Nusa Tenggara
Sî Nú-sâ Tên-kâ-là-sén	West Nusa Tenggara
Chûng Sû-lâ-vî-sî-sén	Central Sulawesi
Kô-lùn-tá-lo̍k-sén	Gorontalo
Pet Sû-lâ-vî-sî-sén	North Sulawesi
Tûng-nàm Sû-lâ-vî-sî-sén	Southeast Sulawesi
Nàm Sû-lâ-vî-sî-sén	South Sulawesi
Sî Sû-lâ-vî-sî-sén	West Sulawesi
Vò-é	Rice
Mâ-lû-kú-sén	Maluku (province)
Pet Mâ-lû-kú-sén	North Maluku
Pâ-pu-â-sén	Papua (province)
Sî Pâ-pu-â-sén	West Papua (province)
Dagestan Khiung-fò-koet	Dagestan
Sú-tû	Capital city
Monzón	Monzón
Phù-thò-ngà-ngî	Portuguese language
Ngie̍t	Month
Mustafa Kemal Atatürk	Mustafa Kemal Atatürk
Makhachkala	Makhachkala
Chechnya Khiung-fò-koet	Chechnya
Grozny	Grozny
Almazán	Almazán
Vòng Hien-fàm	Huang Xianfan
Ingushetia Khiung-fò-koet	Ingushetia
Magas	Magas
Pet Ossetia–Alania Khiung-fò-koet	North Ossetia–Alania
Kabardino-Balkaria Khiung-fò-koet	Kabardino-Balkaria
Tson-sa̍k	Diamond
Bill Gates	Bill Gates
Ngi̍t-ngî	Japanese language
Pak-khô-chhiòn-sû	Encyclopedia
頭頁	Main Page
Karachay-Cherkessia Khiung-fò-koet	Karachay-Cherkessia
Saratov	Saratov
Saratov-chû	Saratov Oblast
Orenburg-chû	Orenburg Oblast
Mordovia Khiung-fò-koet	Mordovia
Saransk	Saransk
Yâ-khiù	Baseball
Làm-khiù	Basketball
Kirov-chû	Kirov Oblast
Udmurtia Khiung-fò-koet	Udmurtia
Sî-pak-li-â	Siberia
Mari El Khiung-fò-koet	Mari El
Yoshkar-Ola	Yoshkar-Ola
Stellenbosch	Stellenbosch
Sverdlovsk-chû	Sverdlovsk Oblast
Cape Town	Cape Town
Chuvash Khiung-fò-koet	Chuvashia
Durban	Durban
Cheboksary	Cheboksary
Tat-tat-sṳ̂-thán Khiung-fò-koet	Tatarstan
Penza-chû	Penza Oblast
Là-fî-ngì	Raphael
Pí-tet Lû-pún-sṳ̂	Peter Paul Rubens
Ulyanovsk-chû	Ulyanovsk Oblast
Gung-gung-hi-tsaa	Bus
Kâ-thai-lò-nì-â	Catalonia
Bashkortostan Khiung-fò-koet	Bashkortostan
Chelyabinsk-chû	Chelyabinsk Oblast
Pâ-lùn-sî-â Chhṳ-chhṳ-khî	Valencian Community
Khà-sṳ̂-tì-li-â lâu Lòi-ngong	Castile and León
Kurgan-chû	Kurgan Oblast
Mô Chhe̍t-tûng	Mao Zedong
Tyumen-chû	Tyumen Oblast
Omsk-chû	Omsk Oblast
Thai-mí-ngì-ngî	Tamil language
Chet-ho̍k	Philosophy
分類:Candidates for speedy deletion	Category:Candidates for speedy deletion
Altai Khiung-fò-koet	Altai Republic
Kòng-khìm	Piano
Gorno-Altaysk	Gorno-Altaysk
Kemerovo-chû	Kemerovo Oblast
Hebe Camargo	Hebe Camargo
Chṳ̂-pún chú-ngi	Capitalism
Koet-kâ	Country
Mìn-chhu̍k	Nation
Khanty-Mansi Chhṳ-chhṳ-khî	Khanty-Mansi Autonomous Okrug
Yamalo-Nenets Chhṳ-chhṳ-khî	Yamalo-Nenets Autonomous Okrug
Montpellier	Montpellier
分類:Thiên-vùn-ho̍k	Category:Astronomy
Khakassia Khiung-fò-koet	Khakassia
Irkutsk-chû	Irkutsk Oblast
Sakha Khiung-fò-koet	Sakha Republic
Khiet-lò-âi-sî-â-ngî	Croatian language
Hon-pó	Hamburger
Buryatia Khiung-fò-koet	Buryatia
Vû-làn Vû-tet	Ulan-Ude
Amur-chû	Amur Oblast
Ngi-sṳ̍p Sṳ-ki	20th century
Gotha	Gotha
Dijon	Dijon
Kâ-thai-lò-nì-â-ngî	Catalan language
Nordhausen	Nordhausen
Kit-lò-na̍p-sén	Girona
Eisenach	Eisenach
Se-pâu Sâng-vu̍t-ho̍k	Cell biology
Sṳ-kie Ngiùn-hòng Si̍p-thòn	World Bank
A-la-pak Liên-mên	Arab League
Mìn-tsú Tsú-ngi	Democracy
Chhîn-chhèu (秦朝)	Qin dynasty
Pet Thai-sî-yòng Kûng-yok Chû-chṳt	NATO
Chhìn Sṳ Fòng	Qin Shi Huang
Hon-chhèu	Han dynasty
Hon Vú-ti Liù Chha̍t	Emperor Wu of Han
Sâng-vu̍t	Organism
Kiûn-chú-chṳ	Monarchy
Khiung-fò-koet	Republic
Yí-mô-khiù	Badminton
Ngièn-chhèu	Yuan dynasty
Nazi Tet-koet	Nazi Germany
Yù-thai-ngìn	Jews
Chang Fò	Zheng He
Chìn-chhèu	Jin dynasty (265–420)
Ngí	Ear
Phi	Nose
Ngién	Eye
Mûn-é	Mosquito
Mièn-yòng	Sheep
Lo̍k-thò	Camel
Phú-nen thung-vu̍t	Mammal
Siong	Elephant
Ngie-kûng	Ant
Phûng-é	Bee
Hò-làn-ngî	Dutch language
Fà-thi̍t Thit-sṳ-nì Kûng-sṳ̂	The Walt Disney Company
Thot-yong Fu̍t-thông Fu̍t-son	DNA
Khiô	Eggplant
Siet	Snow
Â-pâ	Father
Fûn	Minute
Yù-thai Chhṳ-chhṳ-chû	Jewish Autonomous Oblast
Ngò-lò-sṳ̂-ngî	Russian language
Tûng-nàm-â Koet-kâ Lièn-mèn	Association of Southeast Asian Nations
Sakhalin-chû	Sakhalin Oblast
Mien-pâu	Bread
Sṳ-kie Mo-yi Chû-chṳt	World Trade Organization
漢語	Chinese language
Se-pâu	Cell (biology)
Hiet-yi̍t	Blood
Hi	Lung
Lò-mâ-nì-â-ngî	Romanian language
Pó-kâ-li-â-ngî	Bulgarian language
Magadan-chû	Magadan Oblast
Chhṳ-yèn Khô-ho̍k	Natural science
Het-chhe̍t Mìn	Akira Kurosawa
Franklin D. Roosevelt	Franklin D. Roosevelt
Thi-khiù Khô-ho̍k	Earth science
Sa̍k-thèu	Rock (geology)
Yùn	Cloud
Kí-hò-ho̍k	Geometry
Tet-lu-kú-ngî	Telugu language
Thai-hì-chhèn	Atmosphere
Kak-lû-kit-â-ngî	Georgian language
Kîn-chi-ho̍k	Economics
Pîn-kóng	Pangkal Pinang
漢字	Chinese characters
Sî-lî-ngì Sṳ-mû	Cyrillic script
Lâ-tên sṳ-mû	Latin script
Vùn-ho̍k	Literature
分類:Fap-koet	Category:France
分類:Yîm-ngo̍k	Category:Music
分類:Vùn-ho̍k	Category:Literature
Fù-lì	Fox
La̍p-pá	Trumpet
Â-li̍t-sân-thai sâm-sṳ	Alexander the Great
Kiûn-sṳ-thán-tên Yit-sṳ	Constantine the Great
Set-lû-sṳ thai-ti	Cyrus the Great
Vùn-mìn	Civilization
Kau-yuk	Education
Kâ-thìn	Family
Nàm-ngìn	Man
Fûn-yîn	Marriage
Kiûn-sṳ	Military
Kâ-pî	Coffee
Ngiù-nen	Milk
Sûn Chûng-sân	Sun Yat-sen
Â-yuk-vòng	Ashoka
香港	Hong Kong
Thai-yîn Ti-koet	British Empire
Sú-ngì	Seoul
Kâm-nái-thit Koet-chi Kî-chhòng	John F. Kennedy International Airport
上海	Shanghai
Lùn-tûn Hî-sṳ̂-lu Kî-chhòng	London Heathrow Airport
Lùn-tûn Kak-vet Kî-chhòng	Gatwick Airport
Set-vì-li-â	Seville
Chhîn-chhèu	Qing dynasty
Â-ngì-pâ-nì-â-ngî	Albanian language
Pâ-sṳ̂-khiet-ngî	Basque language
Â-lâ-kung-ngî	Aragonese language
Yîn-koet Hòng-khûng	British Airways
Â-mî-nì-â-ngî	Armenian language
Vû-khiet-làn-ngî	Ukrainian language
Pâ-lùn-sî-â	Valencia
Shuì-tién-ngî	Swedish language
Tan-ma̍k-ngî	Danish language
Nò-vî-ngî	Norwegian language
Kô-thi̍t-fu̍t-lòi-tet Vî-liâm Lòi-pu-nì-tsṳ	Gottfried Wilhelm Leibniz
Tshia̍p-khiet-ngî	Czech language
Sṳ̂-lo̍k-phat-khiet-ngî	Slovak language
Sṳ̂-lo̍k-vì-nì-â-ngî	Slovene language
Hiûng-ngà-li-ngî	Hungarian language
Oi-sâ-nì-â-ngî	Estonian language
Là-thot-vì-â-ngî	Latvian language
Li̍p-thâu-vón-ngî	Lithuanian language
Pha̍k-ngò-lò-sṳ̂-ngî	Belarusian language
Kui-mí-thi̍t-lî Mùn-tet-lie̍t-fû	Dmitri Mendeleev
Ngièn-chṳ́	Atom
Lâ-set-fuk	Ernest Rutherford
Hî-lia̍p-ngî	Greek language
Oi-ngì-làn-ngî	Irish language
Pô-sṳ̂-ngî	Persian language
Chûng-kau	Religion
Chêu-sién-ngî	Korean language
Chhóng-sṳ-ki	Book of Genesis
Kóng-tûng-fa	Cantonese
Chhut-âi-khi̍p-ki	Book of Exodus
Ye̍t-nàm-ngî	Vietnamese language
Pó-lò	Paul the Apostle
Kô-mièn-ngî	Khmer language
Thai-ngî	Thai language
Mâ-lòi-ngî	Malay language
Yin-nì-ngî	Indonesian language
Mùng-kú-ngî	Mongolian language
Hâ-sat-khiet-ngî	Kazakh language
Vû-tsṳ̂-phe̍t-khiet-ngî	Uzbek language
Thú-khù-màn-ngî	Turkmen language
Yù-thai-kau	Judaism
Hî-pak-lói-ngî	Hebrew language
Â-set-pai-kiông-ngî	Azerbaijani language
Mâ-khì-tun-ngî	Macedonian language
Set-ngì-vì-â-ngî	Serbian language
Set-ngì-vì-â Khiet-lò-thi-â-ngî	Serbo-Croatian
Pô-sṳ-nì-â-ngî	Bosnian language
Kâ-lî-sî-â-ngî	Galician language
Vî-ngì-sṳ̂-ngî	Welsh language
Sû-kak-làn Koi-ngì-ngî	Scottish Gaelic
Siak-khiet-kau	Sikhism
John Maynard Keynes	John Maynard Keynes
Lufthansa Hòng-khûng	Lufthansa
Ló-chṳ́	Laozi
Kôn-chhóng	Liver
Shìn	Kidney
Thu-é	Rabbit
Sṳ̀n-kîn Ne-thúng	Nervous system
Sîm-lî-ho̍k	Psychology
Sṳt-kâ-mèu-nì	Gautama Buddha
Mâ-tên Lu-tet	Martin Luther
Yî-kâ	Confucianism
Thiên-chú-kau	Catholic Church
Tho-kau	Taoism
Chit-siói	Spinal cord
Sa̍t	Tongue
Yî-tshóng	Pancreas
Hèu-thèu	Larynx
Fuk-khiet-làn khiùn-tó	Falkland Islands
Vàng-kak-mo̍k	Thoracic diaphragm
Lân-mî	Vermiform appendix
Elizabeth Ngi-sṳ	Elizabeth II
Thòng-chhèu	Tang dynasty
John F. Kennedy	John F. Kennedy
Mìn-chhèu	Ming dynasty
Dwight D. Eisenhower	Dwight D. Eisenhower
Ronald Reagan	Ronald Reagan
Sat-là-kô-sat	Zaragoza
Kîm Tsang-ngit	Kim Jong-il
Ngièn-su Chû-khì-péu	Periodic table
Chû-su̍k	Pig
Mariano Rajoy	Mariano Rajoy
Se-khiûn	Bacteria
Phù-thò	Grape
Phûng-thòng	Honey
Thông	Sugar
Vòng-theu	Soybean
Kûng-chhàng-ho̍k	Engineering
Vùn-fa	Culture
Fan-vun	Sanskrit
Sùn-fàn Hì-thúng	Circulatory system
Sôn	Acid
Yî-ho̍k	Medicine
Néu-Yok Sṳ-kie Mo-yi Chûng-sîm	World Trade Center
Hâ Màn-hâ-tun	Lower Manhattan
Yàm	Salt
分類:Pâ-sî	Category:Brazil
Màn-hâ-tun	Manhattan
Ngièn-su	Chemical element
Kâ-suk-thu	Acceleration
Li̍t	Force
Kú	Drum
Tsṳt-liông	Mass
Thien-yáng	Film
Kîm-su̍k	Metal
Nùng-ngia̍p	Agriculture
Sâng-yîm	Sound
Sṳ̀-kiên	Time
Mien-chit	Area
Kûng-kîn	Kilogram
Kûng-tshak	Metre
Miéu	Second
Pâu-siuk	Maize
Kûng-sṳ̂n	Litre
Fà-ngì-kiê	Wall Street
Tûng-nàm-â	Southeast Asia
Tshùng-khin	Chongqing
Thiên-tsîn	Tianjin
Vú-hon-sṳ	Wuhan
Kú Hî-lia̍p	Ancient Greece
Thomas Jefferson	Thomas Jefferson
Vùi-sṳ̂-khà	Huesca
Tychy	Tychy
El Masnou	El Masnou
Pu-lie̍t-thap-nì-ngî	Breton language
Brittany	Brittany (administrative region)
Lóng	Hearing loss
Chhi̍t-phiang	Disease
Khien-không	Health
Sok-lî-â	Soria
Màn-tó-ngî	Manx language
Chhiâng-môi-su	Penicillin
Nantes	Nantes
Pot-thâm-fó	Tuberculosis
Mà-chiông	Mahjong
模板:Location map Taiwan	Template:Location map Taiwan
Detroit	Detroit
Van-lî Tshòng-sàng	Great Wall of China
Gard-sén	Gard
Gers-sén	Gers
Sông Garonne-sén	Haute-Garonne
Sṳ̀n-sṳn Lò-mâ Ti-koet	Holy Roman Empire
Ille-et-Vilaine-sén	Ille-et-Vilaine
Isère-sén	Isère
Chûng-kau Kói-kiet	Protestant Reformation
Sông Loire-sén	Haute-Loire
Lot-sén	Lot (department)
Lozère-sén	Lozère
Maine-et-Loire-sén	Maine-et-Loire
Nì-pu-kap-nì-sat ngi-sṳ	Nebuchadnezzar II
Mayenne-sén	Mayenne
Morbihan-sén	Morbihan
Nièvre-sén	Nièvre
Nord-sén	Nord (French department)
Calais Hói-hia̍p-sén	Pas-de-Calais
Puy-de-Dôme-sén	Puy-de-Dôme
Sông Pyrénées-sén	Hautes-Pyrénées
Pyrénées-Orientales-sén	Pyrénées-Orientales
Hâ Rhin-sén	Bas-Rhin
Sông Rhin-sén	Haut-Rhin
Saône-et-Loire-sén	Saône-et-Loire
Sarthe-sén	Sarthe
Sông Savoie-sén	Haute-Savoie
Tarn-sén	Tarn (department)
Tarn-et-Garonne-sén	Tarn-et-Garonne
Var-sén	Var (department)
Vaucluse-sén	Vaucluse
Vendée-sén	Vendée
Yonne-sén	Yonne
Yî-pí-li-â Pan-tó	Iberian Peninsula
Lai-kî	Lychee
Yâ-è	Coconut
Sa̍k-liù	Pomegranate
Chong-fa	Zhuang languages
Sông-sok-pu-ngî	Upper Sorbian language
Na̍p-ngá-thi̍t-ngî	Nahuatl
Mí-nàm-kâ-pó-ngî	Minangkabau language
Mirandés-ngî	Mirandese language
Harvard Thai-ho̍k	Harvard University
Néu-yok Chṳn-khèn Kâu-yi-só	New York Stock Exchange
Lie̍t-yî-tha̍t-sén	Province of Lleida
Â-lâ-pak-ngî	Arabic language
Kiú-chiu	Kyushu
Si-koet	Shikoku
O-khiet-ngî	Occitan language
Nàm-fî Hò-làn-ngî	Afrikaans
Lí Mìn-pok	Lee Myung-bak
Lû Vú-hién	Roh Moo-hyun
Kâ Mà-chiok	House sparrow
Kô-thiet	MTR
澳門	Macau
Suhl	Suhl
Mühlhausen	Mühlhausen
Sâ-thièn-khî	Sha Tin District
Fù Kím-Thàu	Hu Jintao
Si̍p Khiûn-phìn	Xi Jinping
Chhòng-kiáng-lu̍k	Giraffe
Phì-âi-mùng-thi̍t-ngî	Piedmontese language
Thap-là-kô-na̍p	Tarragona
Provence-Alpes-Côte d'Azur	Provence-Alpes-Côte d'Azur
Chûng-Wàn-Tshàm／Hiông-Kóng-Tshàm(MTR)	Central Station (MTR)
Chhṳ̂m-chun-sṳ	Shenzhen
Kóng-tûng	Guangdong
Kóng-sî Chong-chhu̍k Chhṳ-chhṳ-khî	Guangxi
Mô-kài	The Lord of the Rings
Borredà	Borredà
Castellar de n'Hug	Castellar de n'Hug
Hiông-kóng Thai-ho̍k	University of Hong Kong
Badajoz	Badajoz
Lu̍k-yì-tó-yen	Kagoshima Prefecture
Kiok	Foot
Sit-thit	Lizard
Altenburg	Altenburg
Kiên	Shoulder
Midi-Pyrénées	Midi-Pyrénées
Wikipedia:Chhâm-siòng	Wikipedia:Village pump
Fu-mùng-thi̍t	Vermont
Hiû-sṳ̂-tûn	Houston
Kóng-chiu-sṳ	Guangzhou
Chiông Kie-sa̍k	Chiang Kai-shek
Vûn Kâ-pó	Wen Jiabao
Nàm-kîn-sṳ	Nanjing
Phiang-yèn	Hospital
Kông-sû	Jiangsu
Chet-kông-sén	Zhejiang
Thèn Séu-phìn	Deng Xiaoping
Pet-phu Calais Hói-hia̍p	Nord-Pas-de-Calais
Pays de la Loire	Pays de la Loire
Languedoc-Roussillon	Languedoc-Roussillon
Thiap-sat-lò-nì-kâ	Thessaloniki
西藏自治區	Tibet Autonomous Region
Hàng-thung Thien-fa	Mobile phone
Thò-niâu	Ostrich
Manchester	Manchester
Pu-lû-khiet-lìm	Brooklyn
Fòng-heu-khî	Queens
Liùng-yìn-sṳ	Yongin
Lòng	Gray wolf
Mâ-lòi Pan-tó	Malay Peninsula
Sîn-yok Sṳn-kîn	New Testament
Fan-lóng-thap-cham-sṳ	Phan Rang–Tháp Chàm
9	9 (number)
Zung-gok Thaai-liuk	Mainland China
Het-liùng-kông	Heilongjiang
Mâ Yîn-kiú	Ma Ying-jeou
Piên-fò-sṳ	Biên Hòa City
Hiông-kóng-tó	Hong Kong Island
Ngà-tsông-sṳ	Nha Trang
Podolsk	Podolsk
Pô-tô Lì-kok Thu̍k-li̍p-tóng	Puerto Rican Independence Party
Lì-è	Donkey
Si-chhôn-sén	Sichuan
Khiu-yok Sṳn-kîn	Old Testament
Sṳn-tan-chiet	Christmas
Lò-màn Ngî-chhu̍k	Romance languages
Sâm-kok-hìn	Triangle
Steve Jobs	Steve Jobs
Yin-Êu Ngî-ne	Indo-European languages
Breinigerberg	Breinigerberg
Lo-fú	Tiger
Fù-ôn Khà-lo̍k-sṳ̂ Yit-sṳ	Juan Carlos I of Spain
Súi-ngièn-sṳ	Suwon
Sâm-sên Si̍p-thòn	Samsung
Louis Couturat	Louis Couturat
Thai-thièn Kóng-vet-sṳ	Daejeon
Kîn-ki-tho	Gyeonggi Province
Sṳ̂-khâm-tit-nâ-vì-â	Scandinavia
Fu̍k-fa̍t-chiet	Easter
Thien-nó Khô-ho̍k	Computer science
Koet-chi Yîm-phiêu	International Phonetic Alphabet
Hò-pet	Hebei
Phú-lìm-sṳ̂-tun Thai-ho̍k	Princeton University
Fôn-hìn-muk	Ciconiiformes
Chhṳ̀n Súi-pién	Chen Shui-bian
Chṳ-fi-hîn Sú-kî	Smartphone
Sa̍k-yù	Petroleum
Hài-è	Shoe
Ngiùn-hòng	Bank
Ngièn-lun Chhṳ-yù	Freedom of speech
Oi-ngì-làn	Ireland
Cheshire	Cheshire
Cumbria	Cumbria
Lancashire	Lancashire
Northumberland	Northumberland
Tyne and Wear	Tyne and Wear
County Durham	County Durham
Pet Yorkshire	North Yorkshire
Lincolnshire	Lincolnshire
Nottinghamshire	Nottinghamshire
Derbyshire	Derbyshire
Merseyside	Merseyside
Leicestershire	Leicestershire
Rutland	Rutland
Lû-sùn	Lu Xun
Northamptonshire	Northamptonshire
Devon	Devon
Oxfordshire	Oxfordshire
Wiltshire	Wiltshire
Hampshire	Hampshire
Buckinghamshire	Buckinghamshire
Surrey	Surrey
West Sussex	West Sussex
East Sussex	East Sussex
Kent	Kent
Thai Lùn-tûn	Greater London
7	7 (number)
8	8 (number)
Lu̍k-é	Deer
Pên	Ice
Chú ke Khì-tó-vùn	Lord's Prayer
Ngìn-lui-ho̍k	Anthropology
Fùng-hói	Red Sea
Oi-tên-páu	Edinburgh
Pha̍k-set	White
Marseille	Marseille
Thai-chhûng-thèu	Onion
6	6 (number)
Kôn-fông ngî-ngièn	Official language
Kháu-kú-ho̍k	Archaeology
George H. W. Bush	George H. W. Bush
Pâ-ngì-kòn pan-tó	Balkans
Dmitry Medvedev	Dmitry Medvedev
Entrena	Entrena
Sîn-kau	Protestantism
Selena	Selena
Mî-koet Thai-khûng Chúng-shu	NASA
Thai Put-lie̍t-tiên-tó	Great Britain
Pâ-le̍t-sṳ̂-thán	Palestine
10	10 (number)
Lila Downs	Lila Downs
Lia̍p-pau	Cheetah
Cleveland (Yîn-koet)	Cleveland, England
Liverpool	Liverpool
Bremen	Bremen
Sîn Nò-vî-ngî	Nynorsk
Meu-thèu-tiâu	Owl
Sṳ̀	Hour
Fap-lò-ngî	Faroese language
Kîm-eu-sṳ	Cà Mau
Meu-khô	Felidae
Koet-chi Thai-khûng Chhàm	International Space Station
Tà-la-sṳ	Da Lat
Tat-tat-ngî	Tatar language
Tshûng-liông	Weight
Tsûng-su	Date palm
Fan-tshiet-sṳ	Phan Thiết
Sî Fut-lî-sî-ngî	Frisian languages
Séu Vòng-chṳ́	The Little Prince
Phiàng-fông kûng-tshak	Square metre
Fó-yam-chhùng	Firefly
Li̍p-fông kûng-tshak	Cubic metre
Fàn-chiet-thûng-vu̍t-mùn	Annelid
Chhú-khô	Muridae
Lû-sêm-nì-â-ngî	Rusyn language
Ede (Hò-làn)	Ede, Netherlands
Sông-ngia̍p	Commerce
Fú-kîn	Killer whale
Sâ-thi̍t-fut-lî-sî-ngî	Saterland Frisian language
Liû-khiù-koet	Ryukyu Kingdom
Pet-fut-lî-sî-â-ngî	North Frisian language
Â-mê-ha̍p-lâ-ngî	Amharic
蝠婆	Bat
Tarnobrzeg	Tarnobrzeg
Vòng Ti	Yellow Emperor
Tiau-ǹg-thòi Lie̍t-yí	Senkaku Islands
Khiung-fò-tóng (Mî-koet)	Republican Party (United States)
Â-sṳ̂-thù-lî-â-sṳ̂-ngî	Asturian language
O-thi-li Pâ-vî-li-â-ngî	Bavarian language
Mìn-chú-tóng (Mî-koet)	Democratic Party (United States)
Tsuk-pet-sṳ	Zhubei
Sàng-tû-sṳ	Chengdu
Âi-sṳ̂-thi̍t-lùi-mâ-thu-lâ-ngî	Extremaduran language
Sàng-fà-khî	Chenghua District
Séu-su mìn-chhu̍k	Minority group
Pô-lòi-kú	Pleiku
Â-ha̍p-sṳ̂-vòng	Ahaz
Chûng-chû-sṳ	Chungju
Yî-liàu Ví-sâng	Health care
Yòng-suk-yen	Yangshuo County
Khiet-là-khô-fû	Kraków
臺灣省	Taiwan Province
Pet-kîn Sú-tû Koet-chi Kî-chhòng	Beijing Capital International Airport
Sîn-kâ-po Hòng-khûng Kûng-sṳ̂	Singapore Airlines
Thien-nó Thôn-chhèn Só-mèu	X-ray computed tomography
Vî-nî-sṳ̂-ngî	Venetian language
Vû-lòi-khî	Wulai District
Koet-li̍p Thòi-vân Thai-ho̍k	National Taiwan University
Vì-phú-sêm-ngî	Veps language
Fu̍t-lò-ngî	Võro language
Pân-mâ	Zebra
Valery Leontiev	Valery Leontiev
Khô-sî-kâ-ngî	Corsican language
Buryat-ngî	Buryat language
Sùn-tho-chûng	Methodism
Mông-kiê-sṳ	Móng Cái
Suk-vú-ngî	Cebuano language
Chavacano-ngî	Chavacano language
Chûng-pí-khô-ngì-ngî	Central Bikol language
Tha̍t-lò-phî-thû Ngî-hì	Dravidian languages
Ló-kiê-sṳ	Lào Cai
客家語	Hakka Chinese
Pet-nèn-sṳ	Bắc Ninh
Liòng-sân-sṳ	Lạng Sơn
Hiuk-tsin-sṳ	Sóc Trăng
Liùng-chhôn-sṳ	Long Xuyên
Mî-tshiu-sṳ	Mỹ Tho
Fut-liù-li-ngî	Friulian language
Pâng-mî-tsuk	Buôn Ma Thuột
Kàm-ngî	Gan Chinese
Pok-vu̍t-kón	Museum
Yin-thu Yî-lóng Ngî-chhu̍k	Indo-Iranian languages
Thai-yùng-meu	Giant panda
Kalmyk-ngî	Kalmyk Oirat
Mân-ngî	Manchu language
Kû-li̍p ngî-ngièn	Language isolate
Kit-là-kî-ngî	Gilaki language
Khà-sû-pí-ngî	Kashubian language
Karachay-Balkar-ngî	Karachay-Balkar language
Maguindanao-ngî	Maguindanao language
Lùn-pâ-tí-ngî	Lombard language
Sú	Hand
Thu fú	Du Fu
Maranao-ngî	Maranao language
O-lî-â-ngî	Oriya language
Ngìn-khiéu	Population
Nò-man-thi-ngî	Norman language
Pâng-â-sî-nâm-ngî	Pangasinan language
Nèn-phìn-sṳ	Ninh Bình
Pet-sat-mí-ngî	Northern Sami language
O-set-thôi-ngî	Ossetian language
Sî-sî-lî-ngî	Sicilian language
Sat-tên-nî-â-ngî	Sardinian language
Nì-ngá-ngì-ngî	Newar language
Valparaíso	Valparaíso
Kóng-ngi-sṳ	Quảng Ngãi
Hò-tshin-sṳ	Hà Tĩnh
Yên-yèn	Actor
Thap-kâ-lo̍k-ngî	Tagalog language
Thùng	Bronze
Surigaonon-ngî	Surigaonon language
Tausūg-ngî	Tausug language
Vlaams-ngî	Flemish
Fà-liùng-ngî	Walloon language
Sú-ngî	Sign language
Yî-ngî	Nuosu language
Międzyrzec Podlaski	Międzyrzec Podlaski
Phiêu-chún Chhông-ngî	Standard Tibetan
Ngá-shuì-ngá-shuì-ngî	Waray-Waray language
Yì-ku-tshu̍k	Yugur
N̂g-ngî	Wu Chinese
Woodrow Wilson	Woodrow Wilson
Fu̍t-sân-sṳ	Foshan
Ngiù-chîn Thai-ho̍k	University of Oxford
Sú-tsṳ́	Digit (anatomy)
Sṳ̍p-thiàu Kie-min	Ten Commandments
Yok-hon-nì-sṳ̂-páu	Johannesburg
Kî-tuk Kau-fi	Christian Church
Pau-é	Leopard
Sîn-kiông	Xinjiang
Muk-kôa	Papaya
Pu-lî-sṳ̂-pân	Brisbane
Â-mî-ngî	Amis language
Vî-liâm Lùn-khìm	Wilhelm Röntgen
Chû-chhèu	Zhou dynasty
Ido-ngî	Ido (language)
Brad Pitt	Brad Pitt
Pa̍k-kiûng	White House
Tha̍t-mâ-thai-ngî	Dalmatian language
Tat-tat-chhu̍k	Tatars
Kô-liáng-sṳ	Cao Lãnh
Thai-fán-sṳ	Osaka
Sên-khiù-ngî	Lingwa de planeta
Kiam-khiâu Thai-ho̍k	University of Cambridge
Kûng-khín	Hectare
Sé-lî	Baptism
Pông-hâ	Asthma
Chuk	Bamboo
Hiligaynon-ngî	Hiligaynon language
Fù Tsṳ-mìn	Ho Chi Minh
Thièn-piên-fú	Điện Biên Phủ
Khûn-sṳ-làn-chû	Queensland
Ha-liùng-sṳ	Hạ Long
Kûi-yìn-sṳ	Qui Nhơn
Mìn-nì-â-pô-li-sṳ̂	Minneapolis
Li̍t-ka-sṳ	Rạch Giá
Li-kú-lî-â-ngî	Ligurian (Romance language)
Phô-lò-chû	Borneo
Khà-phién-phién-kâm-ngî	Kapampangan language
Vù-fâ-kó	Common fig
Sun-fa-sṳ	Huế
Tshòng-thu	Length
Sṳ̂-chhù-chṳ̂-lu	Silk Road
Hói-yòng-sṳ	Hải Dương
Mô-li-ngî	Māori language
Mên-tûng-ngî	Eastern Min
Mên-pet-ngî	Northern Min
Tô-se-pâu sâng-vu̍t	Multicellular organism
Hîn-ôn-sṳ	Hưng Yên
Mên-nàm-ngî	Southern Min
Tshiên-ngièn	Millennium
Ho̍k-miàng	Binomial nomenclature
Vì-tô-li-â-chû	Victoria (Australia)
Chong-chhu̍k	Zhuang people
Sông-hói-fa	Shanghainese
Pet-kông	Bắc Giang
Aung San Suu Kyi翁山蘇姬	Aung San Suu Kyi
Tshèu-chû-fa	Teochew dialect
Yok-hon-fuk-yîm	Gospel of John
William Vòng-chṳ́	Prince William, Duke of Cambridge
Kâm-tsà	Sugarcane
Chhṳ̀n Kóng-sâng	Jackie Chan
12	12 (number)
Vok-là-phú-khiet-ngî	Volapük
Toshiro Mifune	Toshiro Mifune
Kám-lám-su	Olive
Só-lò-mùn-vòng	Solomon
O-khiet-làn	Auckland
Chhṳ̍t-sien	Line (geometry)
11	11 (number)
13	13 (number)
Sûn-chṳ́	Sun Tzu
Sṳn-lìn	Holy Spirit
Lû-pu-lìm	Lublin
Thì-thèu	Peanut
100	100 (number)
Tshit-thèu	Knee
Tô-piên-hìn	Polygon
Nàm Chûng-koet Hói	South China Sea
Campora San Giovanni	Campora San Giovanni
Pien-set-liùng	Chameleon
Bloemfontein	Bloemfontein
Ngiam-set-thí	Chromosome
O-khiet-làn Vùn-fap Ho̍k-káu	Auckland Grammar School
Ngióng-kông	Yangon
Ma̍k-tông-lò Kûng-sṳ̂	McDonald's
1000000	Million
Meu-miàng-sṳ	Maoming
Liú-chiu-sṳ	Liuzhou
Pet-pan-khiù	Northern Hemisphere
Ló-chhú	Mouse
Thí-tsit	Volume
Het-tsṳ̂	Hertz
Pak-pân-khiet	Burbank, California
Sien-lia̍p-thí	Mitochondrion
Yî-sên	Physician
Ki-sa̍k-chhṳn	Stonehenge
Chúng-thí Kîn-chi-ho̍k	Macroeconomics
Ágreda	Ágreda
Lu-kâ-fuk-yîm	Gospel of Luke
Sîn Kí-nui-â	New Guinea
Sṳ́-thù-hàng-chhon	Acts of the Apostles
Mô-hái	Crab
PH	PH
Khì-tó	Prayer
Ôn-fui-sén	Anhui
Chûng-chhîn Pet-tho	North Chungcheong Province
Chûng-chhîn Nàm-tho	South Chungcheong Province
Kông-ngièn-tho (Hôn-koet)	Gangwon Province (South Korea)
Nui Mùng-kú	Inner Mongolia
Kîm Ngit-sṳ̀n	Kim Il-sung
Chhái-na̍p Koet-chi Phú-chhu Ngî-ngièn Thoi-péu-thòn	Delegation for the Adoption of an International Auxiliary Language
Pí-tet-kô-sṳ̍p	Bydgoszcz
Nottingham	Nottingham
Thai-ví-vòng	David
Li-vi-ki	Book of Leviticus
Sṳ̂-thán-fuk Thai-ho̍k	Stanford University
Fuk-kian	Fujian
Kûng-khiet	Gram
Mùng-kú-tshu̍k	Mongols
Khí-sṳ-liu̍k	Book of Revelation
Kong-lîn-sṳ	Gangneung
Kiê-liùng-sṳ	Gyeryong
Kô-yòng-sṳ	Goyang
Kûng-chû-sṳ	Gongju
Kó-chhôn-sṳ	Gwacheon
Kông-mìn-sṳ	Gwangmyeong
Kóng-chû-sṳ (Hôn-koet)	Gwangju, Gyeonggi
Kiú-lî-sṳ	Guri
Kiûn-phú-sṳ	Gunpo
Kîm-phú-sṳ	Gimpo
Nàm-yòng-chû-sṳ	Namyangju
Lun-sân-sṳ	Nonsan
Thông-chîn-sṳ (Hôn-koet)	Dangjin
Tûng-theu-chhôn-sṳ	Dongducheon
Tûng-hói-sṳ (Hôn-koet)	Donghae City
Pó-nèn-sṳ	Boryeong
Fu-chhôn-sṳ	Bucheon
Sâm-chit-sṳ	Samcheok
Shuì-sân-sṳ	Seosan
Sàng-nàm-sṳ	Seongnam
Suk-chhó-sṳ	Sokcho
Sṳ́-hîn-sṳ	Siheung
Ngà-sân-sṳ	Asan
Ôn-sân-sṳ	Ansan
Ôn-sàng-sṳ (Hôn-koet)	Anseong
Ôn-yông-sṳ	Anyang, Gyeonggi
Yòng-chû-sṳ	Yangju
Vû-sân-sṳ	Osan
Ngièn-chû-sṳ	Wonju
Ngi-vòng-sṳ	Uiwang
Ngi-chṳn-fú-sṳ	Uijeongbu
Li-chhôn-sṳ (Hôn-koet)	Icheon
Thî-chhôn-sṳ	Jecheon
Thiên-ôn-sṳ	Cheonan
Chhîn-chû-sṳ	Cheongju
Chhûn-chhôn-sṳ	Chuncheon
Thai-pha̍k-sṳ	Taebaek
Po-chû-sṳ	Paju
Phìn-tshe̍t-sṳ	Pyeongtaek
Phàu-chhôn-sṳ	Pocheon
Hò-nàm-sṳ	Hanam
Fà-sàng-sṳ	Hwaseong, Gyeonggi
Buckingham Kiûng	Buckingham Palace
Hói-nàm	Hainan
Yén-tûng	Far East
Ngiên-kiu	Research
Kâm-suk	Gansu
Pha̍k Se-pâu	White blood cell
York	York
Tsiú	Elbow
Sṳ̂n-min-ki	Book of Deuteronomy
Sû-chû-sṳ	Suzhou
Vûn-chû-sṳ	Wenzhou
Windsor Sàng-páu	Windsor Castle
Hòn-chhu̍k	Han Chinese
Nèn-pô-sṳ	Ningbo
Tet-koet-ngìn	Germans
Ko-men	Allergy
Fù-khì	Leech
Kîm-yùng	Finance
1000	1000 (number)
Mìn-su-ki	Book of Numbers
Liu̍k Khiet-vùn	Kevin Rudd
Ngo̍k-ǹg	Crocodylidae
Yùn-nàm	Yunnan
Vû-â	Corvus (genus)
Plymouth	Plymouth
Sân-tûng	Shandong
Pí	Arm
Derby-sṳ	Derby
Thàn-khîn Fa-ha̍p-vu̍t	Hydrocarbon
Hò-nàm	Henan
Montehermoso	Montehermoso
Liâu-nèn	Liaoning
El Cid	El Cid
Jim Morrison	Jim Morrison
Sin-ngi-hiông	Xinyi, Nantou
Kóng-khiéu	Port
Thòi-vân Thò-yèn Koet-chi Kî-chhòng	Taoyuan International Airport
Kit-lìm	Jilin
Fù-nàm	Hunan
Chhiâng-hói	Qinghai
Vì-ngâ-ngì-tshu̍k	Uyghur people
Rhône-sén	Rhône (department)
Koet-kâ Kûng-yèn	National park
Pâ-lì Charles-de-Gaulle Koet-chi Kî-chhòng	Charles de Gaulle Airport
Chṳ̂-sán	Asset
O-le̍t-liòng	Aurelian
Fù-pet	Hubei
Sân-sî	Shanxi
Hòng-khûng Kûng-sṳ̂	Airline
Hò-khiéu-vân	Estuary
Chûng-set	Brown
Kui-chû	Guizhou
Berkelland	Berkelland
Chûng-khi Sṳ̀n-kîn Ne-thúng	Central nervous system
Yî-fut-só	Ephesus
Ôn-tha̍t-màn Hói	Andaman Sea
Yok-sû-â-ki	Book of Joshua
Sî-pet Yîn-kak-làn	North West England
Shám-sî-sén	Shaanxi
Tûng-pet Yîn-kak-làn	North East England
Tûng Midlands	East Midlands
Tûng Yîn-kak-làn	East of England
Tûng-nàm Yîn-kak-làn	South East England
Sî-nàm Yîn-kak-làn	South West England
模板:Commonscat	Template:Commons category
Sî Midlands	West Midlands (region)
Yorkshire lâu Humber	Yorkshire and the Humber
Kòn Se-pâu	Stem cell
Lò-mâ-sû	Epistle to the Romans
Mâ-liuk-kap Hói-hia̍p	Strait of Malacca
Yù-thai Vòng-koet	Kingdom of Judah
Mî-koet Pha̍k-ngìn	White American
Fî-yí Mî-koet Het-ngìn	African American
Mà-sat-chû-set Lî-kûng Ho̍k-yen	Massachusetts Institute of Technology
Pô-sṳ-tun Thai-ho̍k	Boston University
Yâ-lû Thai-ho̍k	Yale University
Lû-khái-ngî	Rukai language
Nàm-pet-chêu	Southern and Northern Dynasties
Liû-Sùng	Liu Song dynasty
Fûn-lî	Wedding
Pan Chúng-thúng-chṳ	Semi-presidential system
Kâ-phìn-khiùn	Gapyeong County
Kô-sàng-khiùn (Hôn-koet)	Goseong County, Gangwon
Fâi-sân-khiùn	Goesan County
Kím-sân-khiùn	Geumsan County
Tan-yòng-khiùn (Hôn-koet)	Danyang County
Po-ên-khiùn	Boeun County
Fù-yì-khiùn	Buyeo County
Sû-chhôn-khiùn	Seocheon County
Yòng-khiéu-khiùn	Yanggu County, Gangwon
Siong-yòng-khiùn	Yangyang County
Yòng-phìn-khiùn	Yangpyeong County
Lî-chû-sṳ	Yeoju
Liên-chhôn-khiùn	Yeoncheon County
Yún-thùng-khiùn	Yeongdong County
Nèn-ye̍t-khiùn	Yeongwol County
Lî-sân-khiùn	Yesan County
Vok-chhôn-khiùn	Okcheon County
Yîm-sàng-khiùn	Eumseong County
Lîn-thài-khiùn	Inje County
Tsin-san-khiùn	Jeongseon County
Chên-phiàng-khiùn	Jeungpyeong County
Chṳ́n-chhôn-khiùn	Jincheon County
Thiet-ngièn-khiùn	Cheorwon County
Chhiâng-yòng-khiùn	Cheongyang County
Thai-ôn-khiùn	Taean County
Fùng-sàng-khiùn	Hongseong County
Fùng-chhôn-khiùn	Hongcheon County
Fà-chhôn-khiùn	Hwacheon County
Vàng-sàng-khiùn	Hoengseong County
Ên-phìn-sṳ	Eunpyeong District
Fî-li̍p-pí-sû	Epistle to the Philippians
Thiên-koet Pat-fuk	Beatitudes
Mî-koet Lièn-pâng Chún-phi Ne-thúng	Federal Reserve System
Kúai-é	Frog
Hâ Sî-lî-sî-â-sén	Lower Silesian Voivodeship
Khù-â-vì - Pô-mî-là-nì-â-sén	Kuyavian-Pomeranian Voivodeship
Lû-pu-lìm-sén	Lublin Voivodeship
Lû-pu-sṳ̂-khà-sén	Lubusz Voivodeship
Lò-tsṳ-sén	Łódź Voivodeship
Séu Pô-làn-sén	Lesser Poland Voivodeship
Mâ-tsó-fû-sá-sén	Masovian Voivodeship
O-pô-lòi-sén	Opole Voivodeship
Khak-ngì-pâ-yèn-sân-sén	Podkarpackie Voivodeship
Pô-tet-là-chhia-sén	Podlaskie Voivodeship
Pô-mî-là-nì-â-sén	Pomeranian Voivodeship
Sî-lî-sî-â-sén	Silesian Voivodeship
Sṳn-sṳ̍p-sṳ-sén	Świętokrzyskie Voivodeship
Sî Pô-mî-là-nì-â-sén	West Pomeranian Voivodeship
Pâ-lùn-sî-â-sén	Province of Valencia
Sat-là-kô-sat-sén	Zaragoza (province)
Vùi-sṳ̂-khà-sén	Province of Huesca
Baak-gaa-seng	Hundred Family Surnames
Sok-lî-â-sén	Province of Soria
Hien-thoi Khì-chhâ	Hyundai Motor Company
Sûng-hâi-khî	Shuangxi District
Kîm Tsang-ên	Kim Jong-un
Pu-nùng-ngî	Bunun language
Phû-sien-ngî	Pu-Xian Min
Kông-sî	Jiangxi
Wernher von Braun	Wernher von Braun
Nèn-ha	Ningxia
Lí Hién-liùng	Lee Hsien Loong
Kîm-fà-sṳ	Jinhua
Thòi-chû-sṳ	Taizhou, Zhejiang
Phòng-châ-phú-ngî	Punjabi language
Phú-sṳ̍p-thok-ngî	Pashto language
Yâ-chû	Wild boar
Chû-hói-sṳ	Zhuhai
Sân-thèu-sṳ	Shantou
Shâu-kûan-sṳ	Shaoguan
Kông-mùn-sṳ	Jiangmen
Chhám-kông-sṳ	Zhanjiang
Shàu-khin-sṳ	Zhaoqing
Fi-chiu-sṳ	Huizhou
Mòi-chiu-sṳ	Meizhou
San-mî-sṳ	Shanwei
Hò-ngièn-sṳ	Heyuan
Yòng-kông-sṳ	Yangjiang
Chhîn-yén-sṳ	Qingyuan
Tûng-kôn-sṳ	Dongguan
Chûng-sân-sṳ	Zhongshan
Chhèu-chiu-sṳ	Chaozhou
Thiên-tén-yen	Tiandeng County
Liùng-chiu-yen	Longzhou County
Nèn-mìn-yen	Ningming County
Thai-sîn-yen	Daxin County
Sâ-chhà-chiòng	Shacha sauce
Mâ-liuk-kap-sṳ	Malacca City
Khiâu-chhṳ-sṳ	George Town, Penang
IPhone 5	IPhone 5
Nàm-Chhî	Southern Qi
Mèu-li̍t-yen	Miaoli County
Sṳn-chhôn-lî	Eucharist
Fuk-chiu-sṳ	Fuzhou
Nàm-phìn-sṳ	Nanping
Phû-thièn-sṳ	Putian
Sâm-mìn-sṳ	Sanming
Tshièn-chiu-sṳ	Quanzhou
Hà-mûn-sṳ	Xiamen
Chông-chiu-sṳ	Zhangzhou
Liùng-ngâm-sṳ	Longyan
Nèn-tet-sṳ	Ningde
Sî-pak-li-â Fú	Siberian tiger
Thiên-ngô-yen	Tian'e County
Nàm-tan-yen	Nandan County
Fung-sân-yen	Fengshan County
Tûng-làn-yen	Donglan County
Buren	Buren
Pat-tet-sṳ	Bade District
Sîn-chuk-yen	Hsinchu County
Thông Ngiâ-mong	Johann Adam Schall von Bell
Yáng-chhiong Chín-thôn-ho̍k	Radiology
Rumia	Rumia
Kluczbork	Kluczbork
La̍p-tsuk	Candle
Hiet-chiong	Blood plasma
Southampton	Southampton
Lu-tet-ki	Book of Ruth
Hâ-sat-khiet-chhu̍k	Kazakhs
Yòng-mî	Dragonfly
Chit-fûn-ho̍k	Integral
Kô-lìm-tô-chhièn-sû	First Epistle to the Corinthians
Sî-pân-ngà Ti-koet	Spanish Empire
Pha̍k-yùn-khî (Kóng-chiu-sṳ)	Baiyun District, Guangzhou
Sṳ-sṳ̂-ki	Book of Judges
Po-lîn-chhòi	Spinach
Pâ-set-lò-nâ-sén	Province of Barcelona
Nàm-thèu-yen	Nantou County
Liuk-piên-hìn	Hexagon
Thòi-pet 101	Taipei 101
Lùn-tûn Thap-khiâu	Tower Bridge
Luì-kûng	Thunder
Siù-li Yún-kòn-sien-chhùng	Caenorhabditis elegans
O-pô-lòi	Opole
Sopot	Sopot
Â-sṳ̂-thù-lî-â-sṳ̂-sén Chhṳ̍t-hot-sṳ	List of municipalities in Asturias
Kám-lám-yù	Olive oil
Chim-sin-fi	Baptists
Lie̍t-yî-tha̍t-sén Chhṳ̍t-hot-sṳ	List of municipalities in Lleida
Vú-yî-sân-sṳ	Wuyishan, Fujian
Set-vì-li-â-sén	Province of Seville
Thap-là-kô-na̍p-sén	Province of Tarragona
Provence-sén	Provence
Kî-hài Kûng-chhàng	Mechanical engineering
Apeldoorn	Apeldoorn
Lìm-pó-ngî	Limburgish language
Khái-ngì-chhái	Kielce
Bytom	Bytom
Ôn-sit-ngit	Shabbat
Khìm-sṳ̂-thok-khok-ngá	Częstochowa
Zabrze	Zabrze
Ôn-sit-ngit-fi	Seventh-day Adventist Church
Jean Michel Jarre	Jean Michel Jarre
Thai Pô-làn Thi-khî Kô-yî-fû	Gorzów Wielkopolski
Là-tô-mê	Radom
Lo̍k-chham-ki-yen	Los Angeles County, California
Słupsk	Słupsk
Sosnowiec	Sosnowiec
Gliwice	Gliwice
Yo̍k-sṳ̂	Pharmacist
Hi-kôn Yì-chhṳ̍t	Organ transplantation
Pâ-lùn-sî-â-sén Chhṳ̍t-hot-sṳ	List of municipalities in Valencia
Bielsko-Biała	Bielsko-Biała
Rybnik	Rybnik
Tân-fu̍t Se-pâu	Monocyte
Mâ-khó-fuk-yîm	Gospel of Mark
Ruda Śląska	Ruda Śląska
Yok-thán-vòng	Jotham of Judah
Thò-yèn-yen	Taoyuan City
10000000	10000000 (number)
Nò-mí	Glutinous rice
Kîn-tû-fú	Kyoto Prefecture
Kau-su	Professor
Thai-fán-fú	Osaka Prefecture
Fuk-kông-yen	Fukuoka Prefecture
Oi-yèn-yen	Ehime Prefecture
Kô-lìm-tô-heu-sû	Second Epistle to the Corinthians
Khien-mî	Bodybuilding
Chhùng-hièn	Earthworm
Port Elizabeth	Port Elizabeth
Kimberley (Nàm-fî)	Kimberley, Northern Cape
Yok-sâ-fap-vòng	Jehoshaphat
Thòi-vân Hói-hia̍p	Taiwan Strait
Sî Khôi-phú-sén	Western Cape
Yamaguchi-yen	Yamaguchi Prefecture
Khiâu-chhṳ Sâm-sṳ	George III of the United Kingdom
Chûng-koet Thi-fông	Chūgoku region
Mî-koet Thu̍k-li̍p Siên-ngièn	United States Declaration of Independence
Sâm-tshûng-yen	Mie Prefecture
Yù-mu̍k mìn-chhu̍k	Nomad
Hiông-pak-su	Cedrus
Hî-pak-lòi-sû	Epistle to the Hebrews
Kâ-lâ-thai-sû	Epistle to the Galatians
Màn-é	Eel
Sông-chhèu	Shang dynasty
Thai-thúi	Thigh
Pîn-khù-yen	Hyōgo Prefecture
Kiûng-khì-yen	Miyazaki Prefecture
Yùng-pún-yen	Kumamoto Prefecture
Fò-phìn-sṳ	Hòa Bình
Stamford Raffles	Stamford Raffles
Sha̍m-é	Cicada
Tûng Khôi-phú-sén	Eastern Cape
Fap-koet Hòng-khûng	Air France
Kô-lò-sî-sû	Epistle to the Colossians
Ngâ-kok-sû	Epistle of James
Yok-hon-yit-sû	First Epistle of John
Fî-li-mùn-sû	Epistle to Philemon
Thiap-sat-lò-nì-kâ-heu-sû	Second Epistle to the Thessalonians
Thiap-sat-lò-nì-kâ-chhièn-sû	First Epistle to the Thessalonians
Pí-tet-chhièn-sû	First Epistle of Peter
Thì-mô-thai-chhièn-sû	First Epistle to Timothy
Lí Kông-yeu	Lee Kuan Yew
Chṳ̂-kâ-kô Thai-ho̍k	University of Chicago
Tsṳ̂-fo-yen	Shiga Prefecture
Mu-nì-het Kî-chhòng	Munich Airport
Yok-hon-ngi-sû	Second Epistle of John
Thì-mô-thai-heu-sû	Second Epistle to Timothy
Thì-tô-sû	Epistle to Titus
Yî-sṳ̂-lâ-ki	Book of Ezra
Nì-hî-mí-ki	Book of Nehemiah
Pietersburg	Polokwane
Séu Pha̍k-Lù	Little egret
Chhòn-ngiam-phiang	Infectious disease
Kôn-yàm	Hepatitis
Chhûn-chiet	Chinese New Year
Shinzō Abe	Shinzō Abe
Mpumalanga-sén	Mpumalanga
Pet Khôi-phú-sén	Northern Cape
Tó-kîn-yen	Shimane Prefecture
Kông-sân-yen	Okayama Prefecture
Gauteng-sén	Gauteng
Thung-fûng	Gout
Chông-fa-yen	Changhua County
Thai-fûn-yen	Ōita Prefecture
Tiâu-tshí-yen	Tottori Prefecture
Nùng-la̍k	Chinese calendar
Kô-tî-yen	Kōchi Prefecture
Liû-liên	Durian
Pha̍k-hèu	Diphtheria
Exeter	Exeter
Saint Lawrence-hò	Saint Lawrence River
Limpopo-sén	Limpopo
Kô-tén Kau-yuk	Higher education
Sân-tá-kîn	Sandakan
Â-pí	Kota Kinabalu
Hak-kâ-tóng	Hakka Party
Ngi̍t-pún thúng-tshṳ sṳ̀-thoi (Thòi-vân)	Taiwan under Japanese rule
Phok Kiún-fi	Park Geun-hye
Tûng-sṳ-khî	Dongshi District
Berthierville, Québec	Berthierville
Lévis	Lévis, Quebec
Thòi-fûng	Typhoon
Thòi-nàm-sṳ	Tainan
Laval (Québec)	Laval, Quebec
Charlemagne, Québec	Charlemagne, Quebec
Mâ-lòi Pô-lî-nì-sî-â Ngî-chhu̍k	Malayo-Polynesian languages
Fên-yòng-sṳ	Hengyang
Pet-lûn-khî	Beilun District
Mân-chiu-tshu̍k	Manchu people
Zambrów	Zambrów
Doetinchem	Doetinchem
Zamość	Zamość
Malbork	Malbork
Mì-chit-fûn-ho̍k	Calculus
Mì-fûn	Differential calculus
Ngo̍k-yòng-sṳ	Yueyang
BP	BP
Sú-thiàu	French fries
Yùn-lìm-yen	Yunlin County
Fù-khiéu-hiông	Hukou, Hsinchu
Kiok-tsṳ́	Toe
Vî-liâm Â-li̍t-sân-thai (Hò-làn)	Willem-Alexander of the Netherlands
Krasnystaw	Krasnystaw
Sî-fù-khî (Hông-chû-sṳ)	Xihu District, Hangzhou
Vì-tô-li-â Kóng	Victoria Harbour
Sî-kung-khî	Sai Kung District
Mâ-nâ-sî-vòng	Manasseh of Judah
Kî-kîm-fi	Foundation (nonprofit)
A-hîn Kôn-yàm	Hepatitis A
Yù-tsiâm-vong-khî	Yau Tsim Mong District
Fûng-sái	Diospyros kaki
Tshṳ̍t-tshòng	Rectum
Chhṳ-yù Pâng-sén	Free State (province)
Tsó-fo-yen	Saga Prefecture
Tet-tó-yen	Tokushima Prefecture
Sî-pân-ngà-ngìn	Spanish people
Fu̍t-chhṳ̂ Khiung-chṳn Sṳ̀n-siong	Magnetic resonance imaging
Hiông-tshon-yen	Kagawa Prefecture
Reading, Berkshire	Reading, Berkshire
Kâ-chû Lî-kûng Ho̍k-yen	California Institute of Technology
Vì-ngì-tshṳ-páu Thai-ho̍k	University of Würzburg
Fên-yòng-yen	Hengyang County
Êu-kí-lî-tet Kí-hò	Euclidean geometry
Si̍t-kuk	Silicon Valley
Barneveld	Barneveld
Khiu Tha̍t-sîn	Thaksin Shinawatra
Thòi-sân-sṳ	Taishan
Lièn-phìn-yen	Lianping County
Kîm-kôa	Pumpkin
Thai Sùn-thâ Khiùn-tó	Greater Sunda Islands
Elburg	Elburg
Doesburg	Doesburg
Sî-pet-sén	North West (South African province)
Sien-thon	Line segment
Kâ-ngi-yen	Chiayi County
Vûn-tai	Temperate climate
Â-kûng	Grandparent
Thai-khi̍t-khièn	Tai chi
Kiok-khwá	Ankle
Hò-làn Tâi-thi Sat-khiet-sùn-ngî	West Low German
Pân-kiêu-é	European turtle dove
Tshòng-khì-yen	Nagasaki Prefecture
Hà-chhèu	Xia dynasty
Chû-vì Sṳ̀n-kîn Ne-thúng	Peripheral nervous system
Lùn-tûn Thai-ho̍k	University of London
Kip-sú	Series (mathematics)
Nelspruit	Nelspruit
Sâ-là-ye̍t-chû	Sarawak
Â-chû Thai-phìn-yòng Kîn-tsi Ha̍p-tsok Fi-ngi	Asia-Pacific Economic Cooperation
Kôan-chiet-yàm	Arthritis
Geldermalsen	Geldermalsen
Ngò-piên Yì-chhu̍k Chhṳ-chhṳ-yen	Ebian Yi Autonomous County
Chûng-la̍k-sṳ	Zhongli District
Montauban	Montauban
Chhòng-sâ-sṳ	Changsha
Thai Put-lie̍t-tiên lâu Oi-ngì-làn Lièn-ha̍p Vòng-koet	United Kingdom of Great Britain and Ireland
Kiok-kiên	Heel
Kûng-fûn	Centimetre
Lièn-ha̍p Hòng-khûng	United Airlines
Yen-thèu	Pharynx
Hò-mí	Millimetre
Tsûng-tsang-khî (Thòi-pet-sṳ)	Zhongzheng District
Mì-mí	Micrometre
Pâ-mâ Yâu-chhu̍k Chhṳ-chhṳ-yen	Bama Yao Autonomous County
Khi̍t-han (Sú-ho̍k)	Limit (mathematics)
Theu-fú	Tofu
Phù-sat	Bodhisattva
Chóng-ló Kau-fi	Presbyterianism
Hien-thoi Veloster	Hyundai Veloster
Nai-mí	Nanometre
Berlanga de Duero	Berlanga de Duero
Pâ-chûng-sṳ	Bazhong
Fu̍t-kông-yen	Fogang County
Sâ-pâ-chû	Sabah
Nàm-nèn-sṳ	Nanning
Ngâ-li-ôn-ngìn	Aryan
Yù-sṳn-mî-thi Koet-kâ Kûng-yèn	Yosemite National Park
Chhiâng-set	Cyan
Ho̍k-yen	Faculty (division)
Kô-hiùng-sṳ	Kaohsiung
Pet-mî Chhṳ-yù Mo-yi Hia̍p-ngi	North American Free Trade Agreement
Sû-kak-làn-ngìn	Scottish people
Rustenburg	Rustenburg
Yen-tsong-fui	Concert
Yù-fu̍t-chû	Johor
Ngò-lò-sṳ̂ Lièn-pâng Chhṳ̍t-hot-sṳ	Federal cities of Russia
Fì-tshu̍k	Hui people
Sha̍k-sṳ	Master's degree
Preston, Lancashire	Preston, Lancashire
Sî-tí-kâ-vòng	Zedekiah
Sâm-koet	Three Kingdoms
Chhûn-chhiû Sṳ̀-khì	Spring and Autumn period
Chan-koet Sṳ̀-khì	Warring States period
Mâ-liuk-kap-chû	Malacca
Pietermaritzburg	Pietermaritzburg
Sú-vón	Wrist
Kit-làn-tan-chû	Kelantan
Tshông-tshu̍k	Tibetan people
Pîn-sàng-chû	Penang
Blackburn	Blackburn
Chûng-sin Pha̍k-hiet-khiû	Neutrophil granulocyte
Pâng-kâ-tó	Bangka Island
Phìn-chhông-khiùn	Pyeongchang County
Thai-koet Koet-chi Hòng-khûng Kûng-sṳ̂	Thai Airways
Thai Ngi̍t-pún Ti-koet	Empire of Japan
Hiûng-nù	Xiongnu
Phit-li̍t-chû	Perak
Lùn-tûn Ti-koet Ho̍k-yen	Imperial College London
Tsen-sàng-sṳ	Zengcheng District
Kui-lìm-sṳ	Guilin
Siet-làn-ngô-chû	Selangor
Tui-kok-sien	Diagonal
Fi-li-phi Liuk-sṳ	Felipe VI of Spain
Kûng-tún	Tonne
Phàng-hên-chû	Pahang
中國象棋	Xiangqi
Pit-sṳn-hak	Pizza Hut
Yim-suk Siáu-tsṳ́	Sonic the Hedgehog (character)
Ngo̍k-vûn-khiet-tshu̍k	Evenks
Kiu-ên	Salvation
Nàm-kîn Thai-thù-sat	Nanking Massacre
Yún Chṳ-Hau	Yun Chi-ho
Phì-mí	Picometre
Chûng-koet 2010-ngièn Sông-hói Sṳ-kie Pok-lám-fi	Expo 2010
Ngiù-ngiuk	Beef
Carlisle, Cumbria	Carlisle, Cumbria
Sandomierz	Sandomierz
Ngit-tèu-kông	Sunlight
Khwon-kûan-tsiet	Hip
Fûn-kî-hon-khiûn	Mycobacterium
Chàu-yòng-sṳ	Shaoyang
Phìn-tûng-yen	Pingtung County
Chông-fa-sṳ	Changhua City
Hién-mì-kiang	Microscope
Chông-phìn-sṳ	Zhangping
Chông-kâ-kie-sṳ	Zhangjiajie
Tsàu-ôn-yen	Zhao'an County
Chau-phìn-yen	Zhaoping County
Chṳ Sṳ̀n-kûng	Koxinga
Tsṳn-fò-yen	Zhenghe County
Chin-siong-khî	Zhengxiang District
Chṳ́n-hói-khî (Nèn-pô-sṳ)	Zhenhai District
Tsà-yùng-yen	Zherong County
Chûng-fò-khî	Zhonghe District
Chûng-kông-yen	Zhongjiang County
Chung-sân-yen	Zhongshan County
Tsû-nèn-yen	Zhouning County
Chon-hiuk	Zhuanxu
Chu-chû-sṳ	Zhuzhou
Nàm-sâ-khî	Nansha District
Kûng-tshun	Decimetre
McGill Thai-ho̍k	McGill University
Sâm-fòng Ńg-ti	Three Sovereigns and Five Emperors
Sanok	Sanok
Tsṳ́-kîm-yen	Zijin County
Chhṳ-liù-chiáng-khî	Ziliujing District
Mâ-tshâ	Chariot
Milton Keynes	Milton Keynes
Â-mî-tshu̍k	Amis people
Ên-tién	Grace (Christianity)
Hiong-sàng-khî	Xiangcheng District, Zhangzhou
Hî-lìn-tên-khî	London Borough of Hillingdon
Chṳ̂-hîn-sṳ	Zixing
Chṳ̂-yòng-sṳ	Ziyang
Chṳ̂-ngièn-yen	Ziyuan County
Sṳ̀n-chhùng	Imago
Chang Thien-chṳ́ Fat-sa Kie-son-kî Thôn-chhèn Só-mèu	Positron emission tomography
Przemyśl	Przemyśl
Chhiòn-khiû Sàng-sṳ	Global city
Pî-mí	Femtometre
Burnley	Burnley
Tûng Lùn-tûn, Tûng Khôi-phú-sén	East London, Eastern Cape
Biała Podlaska	Biała Podlaska
Mèu-tshu̍k	Miao people
Pet-hói-sṳ	Beihai
Mafikeng	Mahikeng
Mí-sâ-yên Khiùn-tó	Visayas
Yông-muì-sṳ	Yangmei District
Lò-pô-ôn-vòng	Rehoboam
Slough	Slough
Thì-mô-thai	Saint Timothy
Chho̍k-sṳ̂-lia̍p	Centromere
Tûng-hò, Néu-yok-sṳ	East River
Chhêu-fông-hìn	Hypercube
Sêm-mî-làn-chû	Negeri Sembilan
Brzeg	Brzeg
Fidel Valdez Ramos	Fidel V. Ramos
Łomża	Łomża
Siong-thâm-sṳ	Xiangtan
Thûng-tshu̍k	Dong people
Pak-fo Kûng-sṳ̂	Department store
Thòi-vân Ngièn-tshu-mìn	Taiwanese aborigines
騷靈現象	Poltergeist
Tha̍t-vat-ngì-tshu̍k	Daur people
Na̍p-sî-tshu̍k	Nakhi people
Kô-hiùng-yen	Kaohsiung County
Outaouais	Outaouais
Kuî-é	Turtle
Pak-sâ-sat	Belshazzar
Tshièn-pí	Forearm
Yî-set-lie̍t Vòng-koet	Kingdom of Israel (Samaria)
Tshòn-fì Yâ-lu-sat-lâng Yun-thung	Back to Jerusalem movement
Sîn-sân-sṳ	Johor Bahru
Khiu-kîm-sân Vân	San Francisco Bay
Li Mâ-teu	Matteo Ricci
Tshài Yîn-vùn	Tsai Ing-wen
Chełm	Chełm
Pha̍k-ngìn	White people
Â-ha̍p-vòng	Ahab
Suwałki	Suwałki
Ngì-làn-yen	Yilan County, Taiwan
Sî-làn-ngî	Zeelandic
Epe	Epe
Maidenhead	Maidenhead
Chû Khiet-lùn	Jay Chou
Winburg	Winburg
Kiú-liùng	Kowloon
Nâ-pô-nì-tha̍t	Nabonidus
Kiap-kông-yen	Jiajiang County
Hâ-phú-yen	Xiapu County
Ngie-mí-li-ôn Lò-mâ-nok-ngî	Emiliano-Romagnolo language
Sîn-pet-sṳ	New Taipei City
Hî-sî-kâ-vòng	Hezekiah
Thòi-chûng-sṳ	Taichung
IPhone 4S	IPhone 4S
Jędrzejów	Jędrzejów
Fâ-lièn-yen	Hualien County
Kîm-mùn-yen	Kinmen
Thòi-tûng-yen	Taitung County
Sîn-chuk-sṳ	Hsinchu
Kâ-ngi-sṳ	Chiayi City
Kî-lùng-sṳ	Keelung
Pet-thèu-khî (Thòi-pet-sṳ)	Beitou
Thai-ôn-khî (Thòi-pet-sṳ)	Da'an District, Taipei
Sṳ-lìm-khî (Thòi-pet-sṳ)	Shilin District
Busko-Zdrój	Busko-Zdrój
Àu-thai-li-â Ngièn	Australian dollar
Thùng-lû-yen	Tonglu County
Tûng-yín-hiông	Dongyin, Lienchiang
Fuk-tshîn-sṳ	Fuqing
Tûng-sṳ-hiông	Dongshi, Yunlin
Mò Chhiang-li ke Thung-vu̍t	Unclean animal
Nyèn-sân-khî	Yanshan District
Tûng-sa̍k-hiông	Dongshi, Chiayi
Kroonstad	Kroonstad
Chṳ́-khiâu-khiùn	Cầu Giấy District
Ngo̍k-thòng-khî	Yuetang District
Hon-ho̍k	Sinology
Thai-thùng-khî (Thòi-pet-sṳ)	Datong District, Taipei
Nàm-kóng-khî (Thòi-pet-sṳ)	Nangang District, Taipei
Nui-fù-khî (Thòi-pet-sṳ)	Neihu District
Tshiùng-sân-khî (Thòi-pet-sṳ)	Songshan District, Taipei
Van-fà-khî (Thòi-pet-sṳ)	Wanhua District
Vùn-sân-khî (Thòi-pet-sṳ)	Wenshan District
Sin-ngi-khî (Thòi-pet-sṳ)	Xinyi District
Tsûng-sân-khî (Thòi-pet-sṳ)	Zhongshan District, Taipei
Yî-pó-sṳ	Ipoh
Ná-pô-pha-lâ-sâ-ngì	Nabopolassar
Â-pí-ngâ-vòng	Abijah of Judah
Sûn N̂g	Eastern Wu
Pha̍k-chhu̍k	Bai people
Pińczów	Pińczów
Aalten	Aalten
Xuxa	Xuxa
Ap-chû	Ap Chau
Hajnówka	Hajnówka
Phiâng-sân-sîn-khî	Pingshan New District
Chàu-tûng-yen	Shaodong County
Lai-phú-yen	Lipu County
Lubartów	Lubartów
Hâu-kông-khî	Haojiang District
Yòng-sân-yen	Yangshan County
Kông-mìn-sîn-khî	Guangming New District
Lucélia Santos	Lucélia Santos
Montréal-tó	Island of Montreal
IPhone 3GS	IPhone 3GS
IPhone 4	IPhone 4
IPhone 3G	IPhone 3G
Alan Dawa Dolma	Alan Dawa Dolma
Mâ-lòi-sî-â Hòng-khûng	Malaysia Airlines
Lì-tshu̍k	Li people
Chûng-sî-khî (Hiông-kóng)	Central and Western District
Mí-nâ-hien-vòng	Menahem
Â-ha̍p-chhia-vòng (Yî-set-lie̍t)	Ahaziah of Israel
Â-ha̍p-chhia-vòng (Yù-thai)	Ahaziah of Judah
Yok-làn-vòng (Yù-thai)	Jehoram of Judah
Â-sat-li-ngâ	Uzziah
Peter Nalitch	Peter Nalitch
Yâ-lò-pô-ôn yit-sṳ	Jeroboam
Am-li-vòng	Omri
Nâ-tap-vòng	Nadab of Israel
Pâ-sâ-vòng	Baasha of Israel
Yâ-fu-vòng	Jehu
Yok-sî-â-vòng	Josiah
Yok-â-sṳ̂-vòng (Yù-thai)	Jehoash of Judah
Sîm-li-vòng	Zimri (king)
Yâ-lò-pô-ôn ngi-sṳ	Jeroboam II
Yî-vi-mí-lò-tha̍t	Amel-Marduk
Â-mâ-chhia-vòng	Amaziah of Judah
Yî-sṳ̂-pô-sat-vòng	Ish-bosheth
N̂g Chok-tùng	Goh Chok Tong
Â-sat-vòng	Asa of Judah
Â-mùn-vòng	Amon of Judah
Chong Koet-yùng（Chong Fat-chûng）	Leslie Cheung
Lí Tên-Fî	Lee Teng-hui
Yî-lâ-vòng	King Elah
Yok-ngâ-kin-vòng	Jehoiakim
Hò-se-â-vòng	Hoshea
Yok-ngâ-kîn-vòng	Jeconiah
Biłgoraj	Biłgoraj
Chhî Chai-Phit	Seo Jae-pil
Puławy	Puławy
Chuk Hon	Shu Han
Chhâu Ngùi	Cao Wei
Abitibi-Témiscamingue	Abitibi-Témiscamingue
Staszów	Staszów
Mò-tóng-sit	Independent politician
Iwakuni-sṳ	Iwakuni
Soi-ha-tshu̍k	Saisiyat people
Kâu-thûng kûng-khí	Mode of transport
Phok Hièn-yún	Pak Hon-yong
Sat-kâ-li-ngâ-vòng	Zechariah of Israel
Yok-ha̍p-sṳ̂-vòng	Jehoahaz of Israel
Fùng Siù-chhiòn	Hong Xiuquan
Yok-â-sṳ̂-vòng (Yî-set-lie̍t)	Jehoash of Israel
Yok-làn-vòng (Yî-set-lie̍t)	Jehoram of Israel
Pí-kâ-vòng	Pekah
Sâ-liùng-vòng	Shallum of Israel
Pí-kâ-hot-vòng	Pekahiah
Khiu Sṳ̀n-thûng	Shing-Tung Yau
Fùng Puk-kím Kiê	Golden pheasant
Grajewo	Grajewo
Sat-lâ-tshu̍k	Salar people
Yok-ha̍p-sṳ-vòng	Jehoahaz of Judah
Sîn-tiam-khî	Xindian District
Łapy	Łapy
Sin-ngióng	Bride
Pâ-set-fi	Basel Mission
Chhiâng-pa̍k-kông-khî	Qingbaijiang District
Mî-yî-mî-fi	Methodist Episcopal Church
瑤族	Yao people
Thú-sàng-khî	Tucheng District
Sîn-chông-khî	Xinzhuang District
Hagi-sṳ	Hagi, Yamaguchi
Wong Hi-zi	Wang Xizhi
Meu-nàm-khî	Maonan District
Chûng-chhiû-chiet	Mid-Autumn Festival
Nài-lî-kak-li-sâ-ngì	Neriglissar
Fùng-theu	Adzuki bean
Łuków	Łuków
Łęczna	Łęczna
Świdnik	Świdnik
Pô-sṳ̂ Ti-koet	Achaemenid Empire
Nagato-sṳ	Nagato, Yamaguchi
Sî-lìm-yen	Xilin County
Mâ-thai-fuk-yîm	Gospel of Matthew
Sṳ̍p-sṳ-ka	Christian cross
Â-chû Hòng-khûng X	AirAsia X
Â-chû Hòng-khûng	AirAsia
Yî-fut-só-sû	Epistle to the Ephesians
Sòng-tet-sṳ	Changde
Yit-yòng-sṳ	Yiyang
Chhim-chû-sṳ	Chenzhou
Tshî Kông-khí	Xu Guangqi
Yî-lò-khén-nok-ngî	Ilocano
Sàng-khî (San-mî-sṳ)	Chengqu
Súi-nèn-sṳ	Suining
Nui-kông-sṳ	Neijiang
Tha̍t-chû-sṳ	Dazhou, Sichuan
Ngá-ôn-sṳ	Ya'an
10000	10000 (number)
Fú-kûa	Momordica charantia
Fún-fùng-set	Pink
Nâ-sat-le̍t	Nazareth
Thòi-vân kâu-thûng	Transportation in Taiwan
Yî-tshu̍k	Yi people
Mî-koet Kûng-lî-fi Chhâ-fi	American Board of Commissioners for Foreign Missions
Â-thâ-li-ngâ	Athaliah
Augustów	Augustów
Windsor, Berkshire	Windsor, Berkshire
Kô Khô-kî	High tech
Hí Chṳ̂n-shuk	Heo Jong-suk
Tai Tet-sâng	Hudson Taylor
Hòn Hòn	Han Han
Pet-kóng-tsṳ́n	Beigang, Yunlin
Tczew	Tczew
Hâ-nì-tshu̍k	Hani people
Thòi-nàm-yen	Tainan County
Fù-chṳ-mìn-sṳ Kî-chhòng	Tan Son Nhat International Airport
Hien-thoi Accent	Hyundai Accent
Hien-thoi Sonata	Hyundai Sonata
Hien-thoi Elantra	Hyundai Elantra
Hien-thoi Equus	Hyundai Equus
Vû-tsṳ-phe̍t-khiet-chhu̍k	Uzbeks
Hien-thoi Genesis Coupé	Hyundai Genesis Coupe
Thap-kit-khiet-tshu̍k	Tajik people
Wal-Mart Kûng-sṳ̂	Walmart
緋彈个婭里婭	Aria the Scarlet Ammo
Yùn-tôn yun-son	Cloud computing
Ńg-sùn-chiet Yun-thung	Pentecostalism
Liu̍k-theu	Mung bean
Chêu-siên-chhu̍k	Koreans
Khúa-ngì-khiet-tsṳ-tshu̍k	Kyrgyz people
Burgo de Osma-Ciudad de Osma	Burgo de Osma-Ciudad de Osma
Sông-hói Ha̍p-tsok Tsû-tsṳt	Shanghai Cooperation Organisation
Yì Kit-chùn	Yu Kil-chun
Reus	Reus
San Esteban de Gormaz	San Esteban de Gormaz
Hien-thoi Santa Fe	Hyundai Santa Fe
Sâm-sên Fó-châi Hói-song Pó-hiám	Samsung Fire & Marine Insurance
Yî-ho̍k-yen	Medical school
Het-mien Phî-lù	Black-faced spoonbill
Sṳ̀n-chheu-fi	Assemblies of God
Phok Chhùng-yòng	Park Jung-yang
Fâ-tû-khî	Huadu District
Sâ-â-nàm	Shah Alam
Kit-lùng-po Koet-chi Kî-chhòng	Kuala Lumpur International Airport
Ngiu̍k-Sân	Yushan (mountain)
Hōfu-sṳ	Hōfu
Thai-yí-sân	Lantau Island
Starogard Gdański	Starogard Gdański
Het-tsat-tshu̍k	Nanai people
Sîn-chhèu	Xin dynasty
Mauricie	Mauricie
Strzelce Opolskie	Strzelce Opolskie
Hò-làn Tâi-thi Sat-khiet-sêm-ngî	Dutch Low Saxon
Yîn-kô-khî	Yingge District
Kâu-thûng	Road transport
Khiùn	Commandery (China)
Vû-yìn	Muscidae
Tha̍t-mâ-thai	Dalmatia
Witwatersrand Thai-ho̍k	University of the Witwatersrand
Edenville	Edenville
Pat-phu-khî	Babu District
Ôn-fa-yen	Anhua County
Hà (Sṳ̍p-liuk-koet)	Xia (Sixteen Kingdoms)
Hò-tûng-sṳ	Hà Đông
Sîn-chîn-yen	Xinjin County
Mâ-lî-sûn	Robert Morrison (missionary)
Mùng-sân-yen	Mengshan County
Thai-lî-khî	Dali District
Fûng-ngièn-sṳ	Fengyuan District
Thai-phìn-sṳ	Taiping District, Taichung
Thai-kap-tsṳ́n	Dajia District
Tshîn-súi-tsṳ́n	Qingshui District
Sâ-lu̍k-tsṳ́n	Shalu District
Ǹg-tshi-tsṳ́n	Wuqi District
Thai-ôn-hiông (Thòi-chûng)	Da'an District, Taichung
Thai-tú-hiông	Dadu District, Taichung
Thai-ngâ-hiông	Daya District
Fò-phìn-khî	Heping District, Taichung
Heu-lî-hiông	Houli District
Liùng-tsiáng-hiông	Longjing District
Sṳ̀n-kông-hiông	Shengang District
Sa̍k-kóng-hiông	Shigang District
Thâm-tsṳ́-hiông	Tanzi District
Ngoi-phû-hiông	Waipu District
Vú-fûng-hiông	Wufeng District
Vû-ngit-hiông	Wuri District
Sîn-sa-hiông	Xinshe District
Pat-lî-khî	Bali District
Pán-khièu-khî	Banqiao District
Kung-liàu-khî	Gongliao District
Kîm-sân-khî	Jinshan District, New Taipei
Nà-khiéu-khî	Linkou District
Lù-chû-khî	Luzhou District
Phiâng-lìm-khî	Pinglin District
Phìn-hâi-khî	Pingxi District
Lui-fông-khî	Ruifang District
Sâm-chhùng-khî	Sanchong District
Sâm-hia̍p-khî	Sanxia District
Sâm-chṳ-khî	Sanzhi District
Chhṳ̂m-hâng-khî	Shenkeng District
Sa̍k-tàng-khî	Shiding District
Sa̍k-mùn-khî	Shimen District
Su-nà-khî	Shulin District
Thai-sân-khî	Taishan District, New Taipei
Thâm-súi	Tamsui District
Van-lî-khî	Wanli District, New Taipei
Ńg-kú-khî	Wugu District
Sip-chṳ-khî	Xizhi District
Yún-fò-khî	Yonghe District
Fû-lùn-pi-ngì-sṳ	Hulunbuir
Ngo̍k-vûn-khiet-tshu̍k Tshṳ-tshṳ-khî	Evenk Autonomous Banner
Thòi-yit-sien	Provincial Highway 1 (Taiwan)
Ǹg-chiu-sṳ	Wuzhou
Fòng-sàng-kóng-sṳ	Fangchenggang
Khîm-chiu-sṳ	Qinzhou
Kui-kóng-sṳ	Guigang
Ngiu̍k-lìm-sṳ	Yulin, Guangxi
Pak-set-sṳ	Baise
Fo-chiu-sṳ	Hezhou
Hò-chhṳ̀-sṳ	Hechi
Lòi-pîn-sṳ	Laibin
Fuk-thièn-khî	Futian District
Chhùng-chó-sṳ	Chongzuo
Thòi-kiú-sien	Provincial Highway 9 (Taiwan)
Kôn-liâu	Bureaucrat
Lùng-fi-yen	Longhui County
Thú-kâ-tshu̍k	Tujia people
Lai-vân-khî	Liwan District
Hîn-nèn-khî	Xingning District
Siau-sân-khî	Xiaoshan District
Fûng-khôi-yen	Fengkai County
Dewetsdorp	Dewetsdorp
Sîn-kie	New Territories
Khôi-phìn-sṳ	Kaiping
Tsit-sa̍k-sân Pó-ôn-tshu̍k Tûng-hiông-tshu̍k Sat-lâ-tshu̍k Tshṳ-tshṳ-yen	Jishishan Bonan, Dongxiang and Salar Autonomous County
Mo-yi	Trade
Kô-mìn-khî	Gaoming District
Saam-zi-gang	Three Character Classic
Thí-lîn-sṳ	Liling
Kędzierzyn-Koźle	Kędzierzyn-Koźle
Kóng-hon-sṳ	Guanghan
Meu-yen	Mao County
Ôn-hiông-yen	Anxiang County
Ôn-hâi-yen	Anxi County
Duiven	Duiven
Yo̍k-ho̍k	Pharmacy
Chhiâng-yòng-khî	Qingyang District
Fi-yòng-khî	Huiyang District
Kóng-tó-yen	Hiroshima Prefecture
Thu̍k-liùng-tshu̍k	Derung people
Tseu-tshu̍k	Tsou people
IPhone (Thi-yit thoi)	IPhone (1st generation)
Ye̍t-nàm-ngî sṳ-mû	Vietnamese alphabet
Ólvega	Ólvega
Sîn Pâ-pí-lùn Vòng-koet	Neo-Babylonian Empire
Fuk-tín-sṳ	Fuding
Fung-sân-sṳ	Fongshan District
Khîm-nàm-khî	Qinnan District
Thú-ngí-khì-ngî sṳ-mû	Turkish alphabet
Kien-yòng-sṳ	Jianyang District
Shūnan-sṳ	Shūnan
Skarżysko-Kamienna	Skarżysko-Kamienna
Longás	Longás
Kô-tá-ha̍p-lû-sṳ	Kota Bharu
Sú-chiuk-khiéu-phiang	Hand, foot and mouth disease
Kông-phú	Spectrum
Chhṳ̂m-súi-phu-khî	Sham Shui Po District
Mielec	Mielec
Yùn-siau-yen	Yunxiao County
客家	Hakka people
Vù-kau-piáng	Flatbread
Téu-liuk-sṳ	Douliu
Wejherowo	Wejherowo
Pu-yî-chhu̍k	Bouyei people
Mí-yi-yen	Miyi County
Nâ-po-yen	Napo County
Ngì-làn-sṳ	Yilan City
Ńg-fù Sṳ̍p-liuk-koet	Sixteen Kingdoms
Néu-yok Tû-fi-khî	New York metropolitan area
歷峯雧團	Richemont
Ng̀-tshon-sṳ	Wuchuan, Guangdong
Lanaudière	Lanaudière
Thap-lùn-ti-nò-ngî	Tarantino dialect
Vòng Sîm-lìn	Cyndi Wang
Vòng Yún-khin	Wang Yung-ching
Thùng-lò-hiông	Tongluo, Miaoli
Chhṳ̀n Kâ-fà	Ella Chen
Lo̍k-chhîn-sṳ	Yueqing
Eu-hói-khî	Ouhai District
Mâ-kûng-sṳ	Magong, Taiwan
Sîn-yàng-sṳ	Xinying District
Tshu-theu-fú	Stinky tofu
Thai-pó-sṳ	Taibao
Sû-o-tsṳ́n	Su-ao, Yilan
Chong Lìn-sâng	Zhang Lingsheng
Làn-yí	Orchid Island
Mèu-li̍t-sṳ	Miaoli City
2009-ngièn sṳ-kie yun-thung-fi	World Games 2009
Nàm-o-hiông	Nan-ao, Yilan
Tshṳ̀n Ví-ngia̍p	Albert Chan
Thai-ngâ-tshu̍k	Atayal people
Thòi-chûng-yen	Taichung County
Thòi-ngi-sien	Provincial Highway 2 (Taiwan)
Joy	Joy (band)
Liu̍k-tó-hiông	Green Island, Taiwan
Lu̍k-kóng-tsṳ́n	Lukang, Changhua
Kîm-mùn Koet-kâ Kûng-yèn	Kinmen National Park
Thòi-pet Lìn-liòng-thòng	Bread of Life Church
Pu-nùng-tshu̍k	Bunun people
Vòng Ngiuk-mìn	Raymond Wong Yuk-man
Nàm-kôn-hiông	Nangan, Lienchiang
Liùng-vân-khî	Longwan District
Lu̍k-sàng-khî	Lucheng District
Phìn-yòng-yen	Pingyang County
Yún-kâ-yen	Yongjia County
Thung-thèu-yen	Dongtou County
Tûng-sân-hiông (Thòi-nàm)	Dongshan District, Tainan
Ǹg-yèn	Fish ball
Chhṳ̀-hâi-sṳ	Cixi City
Lò-tûng-tsṳ́n	Luodong, Yilan
Tûng-sân-hiông	Dongshan, Yilan
Thèu-sàng-tsṳ́n	Toucheng, Yilan
Pet-mùn-hiông	Beimen District
Sîn-sṳ-hiông	Xinshi District, Tainan
Thai-hâi-tsṳ́n	Daxi District
Tshit-mî-hiông	Qimei, Penghu
Pî-nàm-tshu̍k	Puyuma people
Kit-ôn-hiông	Ji'an, Hualien
Yún-không-sṳ	Yongkang District
Kông-sân-tsṳ́n	Gangshan District
Phú-chṳ́-sṳ	Puzi
Sâm-sên-hiông	Sanxing
Tha̍t-ngu-tshu̍k	Yami people
Thòi-vân Ngiùn-hòng	Bank of Taiwan
Kîm-sàng-tsṳ́n	Jincheng, Kinmen
Phû-lî-tsṳ́n	Puli, Nantou
Vû-hiu-hiông	Wuqiu, Kinmen
Thai-thùng-hiông	Datong, Yilan
Mâ-hâi	George Leslie Mackay
Ngit-chhut-khòng-sàng	LOHAS Park
Tsiông-kiûn-hiông	Jiangjun District
Koet-li̍p Thòi-vân Pok-vu̍t-kón	National Taiwan Museum
Thai-su-hiông	Dashu District
Pô-chûng-hiông	Baozhong, Yunlin
Tsiâu-hâi-hiông	Jiaoxi, Yilan
Mong-ôn-hiông	Wang-an, Penghu
Mà-theu-tsṳ́n	Madou District
Mî-nùng-tsṳ́n	Meinong District
Theui-waan Thin-get Lin-mang	Taiwan Solidarity Union
Thai-lû-kok Koet-kâ Kûng-yèn	Taroko National Park
Â-lî-sân Koet-kâ Sêm-lìm Yù-lo̍k-khî	Alishan National Scenic Area
Tûng-kóng-tsṳ́n	Donggang, Pingtung
Tshòng-tshṳ-hiông	Changzhi, Pingtung
Sṳ̂-é-hiông	Shihzih Township
Tsham-lìm-hiông	Shanlin District
Van-yùng-hiông	Wanrong, Hualien
Tsuk-thièn-hiông	Jhutian Township
Mâ-kâ-hiông	Majia, Pingtung
Mì-thò-hiông	Mituo District
Yèn-tshâu-hiông	Yanchao District
Piông-liàu-hiông	Fangliao
Tsṳ́-kôn-hiông	Ziguan District
Piông-sân-hiông	Fangshan, Pingtung
Méu-tân-hiông	Mudan, Pingtung
Yèn-sân-hiông	Yuanshan, Yilan
Lu-tsuk-hiông	Lujhu District
Khén-tên Koet-kâ Kûng-yèn	Kenting National Park
Su-fûng-hiông	Shoufeng, Hualien
Fu-lî-hiông	Fuli, Hualien
Siet-pa Koet-kâ Kûng-yèn	Shei-Pa National Park
Siu-lìm-hiông	Xiulin, Hualien
Kông-fu̍k-hiông	Guangfu, Hualien
Nàm-chû-hiông	Nanzhou, Pingtung
Cho̍k-hâi-hiông	Zhuoxi, Hualien
Mân-chû-hiông	Manzhou, Pingtung
Kham-táng-hiông	Kanding, Pingtung
Yâm-phû-hiông	Yenpu Township
Pet-kôn-hiông	Beigan, Lienchiang
Lie̍t-yí-hiông	Lieyu, Kinmen
Ńg-kiet-hiông	Wujie, Yilan
Van-lòng-hiông	Wanluan, Pingtung
Kô-su-hiông	Gaushu Township
Kâ-tûng-hiông	Jiadong, Pingtung
Lòi-ngi-hiông	Laiyi, Pingtung
Fûng-pîn-hiông	Fengbin, Hualien
Nâ-mâ-ha-hiông	Namasia District
Lìm-lo̍k-hiông	Linluo, Pingtung
Liùng-khì-hiông	Longqi District
Thai-vú-hiông (Phìn-tûng)	Taiwu, Pingtung
Vu-thòi-hiông	Wutai, Pingtung
Meu-lìm-hiông	Maolin District
Kiú-yì-hiông	Jiuru
Ho̍k-kap-tsṳ́n	Xuejia District
Yún-ôn-hiông	Yong'an District
Tiâu-tshiùng-hiông	Niaosong District
Tsó-tsṳ́n-hiông	Zuozhen District
Thièn-liàu-hiông	Tianliao District
Khiâu-thèu-hiông	Ciaotou District
Thai-sa-hiông	Dashe District
Yàm-súi-tsṳ́n	Yanshui District
Liù-khiù-hiông	Liouciou Township
Lìm-yèn-hiông	Linyuan District
Lìm-piên-hiông	Linbian, Pingtung
Tshûn-ngit-hiông	Chunri, Pingtung
Lî-kóng-hiông	Ligang, Pingtung
Thò-ngièn-hiông	Taoyuan District, Kaohsiung
Nui-mùn-hiông	Neimen District
Â-lièn-hiông	Alian District
Vòng Sṳ́m-tî	Wang Shenzhi
Nàm-fa-hiông	Nanhua District
Si̍p-si̍p-tsṳ́n	Jiji, Nantou
Tsuk-sân-tsṳ́n	Zhushan, Nantou
Tshó-thùn-tsṳ́n	Caotun, Nantou
Yìn-oi-hiông	Ren-ai, Nantou
Yìn-tet-hiông	Rende District
Ôn-thin-hiông	Anding District, Tainan
Sṳ̀n-kûng-tsṳ́n	Chenggong, Taitung
Súi-lî-hiông	Shueili Township
Yìn-vú-hiông	Renwu District
Koet-siang-hiông	Guoxing
San-fa-tsṳ́n	Shanhua District
Tshit-kú-hiông	Qigu District
Ngiu̍k-tsiáng-hiông	Yujing District
Ǹg-tshṳ̀-hiông	Yuchi, Nantou
Sân-song-hiông	Shanshang District
Ha-yàng-hiông	Xiaying District
Nàm-sî-hiông	Nanxi District, Tainan
Kûi-yìn-hiông	Guiren District
Liuk-kap-hiông	Liujia District
Miàng-kiên-hiông	Mingjian, Nantou
Liú-yàng-hiông	Liuying District
Tshèu-chû-tsṳ́n	Chaojhou, Pingtung
Fú-mî-tsṳ́n	Huwei, Yunlin
Thú-khù-tsṳ́n	Tuku, Yunlin
Van-tân-hiông	Wandan, Pingtung
Hâi-chû-hiông	Xizhou, Changhua
Kûan-sân-tsṳ́n	Guanshan, Taitung
Heu-piak-hiông	Houbi District
Sî-kóng-hiông	Xigang District, Tainan
Ngiu̍k-lî-tsṳ́n	Yuli, Hualien
Thai-nui-hiông	Danei District
Kôn-thièn-hiông	Guantian District
Ngô-mì-hiông	Emei, Hsinchu
Pha̍k-hò-tsṳ́n	Baihe District
Yòng-mìn-sân Koet-kâ Kûng-yèn	Yangmingshan
Sî-yí-hiông	Siyu, Penghu
Hak-kâ chhoi	Hakka cuisine
Â-lî-sân-hiông	Alishan, Chiayi
Fù-sî-hiông	Husi, Penghu
Fù-nui-hiông	Hunei District
Lìm-nui-hiông	Linnei, Yunlin
Téu-nàm-tsṳ́n	Dounan, Yunlin
Ma̍k-liàu-hiông	Mailiao, Yunlin
Kâ-lî-tsṳ́n	Jiali District
Ngièn-tshòng-hiông	Yuanchang, Yunlin
Sîn-phî-hiông	Xinpi
Thòi-sî-hiông	Taixi, Yunlin
Lûn-poi-hiông	Lunbei, Yunlin
Tshṳ̀-thùng-hiông	Citong, Yunlin
Thai-tshûn-hiông	Dacun, Changhua
Hèn-tshûn-tsṳ́n	Hengchun
Kú-hâng-hiông	Gukeng, Yunlin
Sî-lô-tsṳ́n	Xiluo, Yunlin
Thai-phî-hiông	Dapi, Yunlin
Tûng-ông Sân-ma̍k	Central Mountain Range
Si-fù-hiông	Sihu, Yunlin
Wong Gaa-khi	Wong Ka Kui
Phìn-fông Kûng-lî	Square kilometre
Phùn-tshoi	Poon choi
Pha̍k-sâ-hiông	Baisha, Penghu
Tshòng-pîn-hiông	Changbin, Taitung
Tûng-hò-hiông	Donghe, Taitung
Pî-nàm-hiông	Beinan, Taitung
Sîn-phû-tsṳ́n	Xinpu, Hsinchu
Kîm-nèn-hiông	Jinning, Kinmen
Liòng Kuet-hiùng	Leung Kwok-hung
Lu̍k-kuk-hiông	Lugu, Nantou
Lu̍k-yâ-hiông	Luye, Taitung
Liuk-kuî-hiông	Liouguei District
Ngi-lûn-hiông	Erlun, Yunlin
Súi-lìm-hiông	Shuilin, Yunlin
Kôn-yîm-hiông	Guanyin District
Thòi-pet tû-fi khî	Taipei–Keelung metropolitan area
Khì-sân-tsṳ́n	Cishan District
Tsong-vì-hiông	Zhuangwei, Yilan
Lui-sui-hiông	Ruisui, Hualien
Fò-mî-tsṳ́n	Hemei, Changhua
Hak-kâ Thien-sṳ-thòi	Hakka TV
Yèn-phìn-hiông	Yanping, Taitung
Sîn-sàng-hiông	Xincheng, Hualien
Thai-mà-lî-hiông	Taimali, Taitung
Tshâ-sàng-hiông	Checheng, Pingtung
Kîm-fûng-hiông	Jinfeng, Taitung
Thai-vú-hiông	Dawu, Taitung
Kîm-fù-tsṳ́n	Jinhu, Kinmen
Thûng-sêu-tsṳ́n	Tongxiao, Miaoli
Sâm-thi-mùn-hiông	Sandimen, Pingtung
Hói-tôn-hiông	Haiduan, Taitung
Kîm-sâ-tsṳ́n	Jinsha, Kinmen
Sîn-fûng-hiông	Xinfeng, Hsinchu
Tsiâm-sa̍k-hiông	Jianshi, Hsinchu
Yen-lî-tsṳ́n	Yuanli, Miaoli
Fâ-lièn-sṳ	Hualien City
Kuî-sân-hiông	Guishan District
Yèn-lìm-tsṳ́n	Yuanlin, Changhua
Phìn-tsṳ́n-sṳ	Pingzhen District
Liùng-thâm-hiông	Longtan District, Taoyuan
Shuì-ôn-sṳ	Rui'an
Lù-tsuk-hiông	Luzhu District
Fung-fa-sṳ	Fenghua
Phìn-tûng-sṳ	Pingtung City
Thòi-tûng-sṳ	Taitung City
Thai-liàu-hiông	Daliao District
F4	F4 (band)
Chùng-chṳ́	Zongzi
Pet-phû-hiông	Beipu
Heu-liùng-tsṳ́n	Houlong, Miaoli
Vàng-sân-hiông	Hengshan, Hsinchu
Kûng-kón-hiông	Gongguan, Miaoli
Nàm-chông-hiông	Nanzhuang, Miaoli
Ńg-fûng-hiông	Wufeng, Hsinchu
Sîn-yèn-hiông	Sinyuan, Pingtung
Kûan-sî-tsṳ́n	Guanxi, Hsinchu
Sî-fù-hiông	Xihu, Miaoli
Tsuk-nàm-tsṳ́n	Zhunan, Miaoli
Sṳ̂-thàn-hiông	Shitan, Miaoli
Khiûng-lìm-hiông	Qionglin, Hsinchu
Chûng-liàu-hiông	Jhongliao Township
Fung-lìm-tsṳ́n	Fenglin, Hualien
Thèu-vuk-hiông	Touwu, Miaoli
Lui-phû-hiông	Neipu, Pingtung
Thèu-fun-tsṳ́n	Toufen, Miaoli
Thai-ôn-hiông	Tai-an, Miaoli
Pó-sân-hiông	Baoshan, Hsinchu
Cho-khièu-hiông	Zaoqiao, Miaoli
Tha̍t-yìn-hiông	Daren, Taitung
Cho̍k-làn-tsṳ́n	Zhuolan, Miaoli
Siet-sân Sân-ma̍k	Xueshan Range
Tsuk-tûng-tsṳ́n	Zhudong, Hsinchu
Thai-fù-hiông	Dahu, Miaoli
Hâi-khiéu-hiông	Xikou, Chiayi
Sâm-vân-hiông	Sanwan, Miaoli
Liuk-kiok-hiông	Liujiao, Chiayi
Mìn-hiùng-hiông	Minxiong, Chiayi
Sâm-ngi-hiông	Sanyi, Miaoli
Thai-phû-hiông	Dapu, Chiayi
Phû-sîm-hiông	Puxin, Changhua
Yún-tshìn-hiông	Yongjing, Changhua
Hak-kâ Yòng-theu-fú	Yong Tau Foo
Ya̍p Â-lòi	Yap Ah Loy
Then Yí-hièn	Teng Yu-hsien
Thòi-fûng Mo̍k-Là-Khiet (2009-ngièn)	Typhoon Morakot
Tshûn-kóng-hiông	Shengang, Changhua
Thòi-pet Tshia̍p-yun	Taipei Metro
Kí-kóng-hiông	Juguang, Lienchiang
Chhòn-yùng Hòng-khûng	EVA Air
Kôn-yîm	Guanyin
Nàm-thèu-sṳ	Nantou City
Phài-vân-tshu̍k	Paiwan people
Thòi-vân nàm-tó ngî-ngièn	Formosan languages
Lìm-pâ Se-pâu	Lymphocyte
Fông-yen-hiông	Fangyuan, Changhua
Thièn-mî-hiông	Tianwei, Changhua
Phài-vân-ngî	Paiwan language
Thai-ngâ-ngî	Atayal language
Sa-thèu-hiông	Shetou, Changhua
Hâi-fù-tsṳ́n	Xihu, Changhua
Pu-thoi-tsṳ́n	Budai, Chiayi
Lu̍k-tshó-hiông	Lucao, Chiayi
Sîn-vuk-hiông	Xinwu District
Kap-siên-hiông	Jiasian District
Thò-yèn-sṳ	Taoyuan District
Lû-khái-tshu̍k	Rukai people
Tseu-ngî	Tsou language
Pî-nàm-ngî	Puyuma language
Soi-ha-ngî	Saisiyat language
Khiéu-fù-hiông	Kouhu, Yunlin
Thòi-vân Thú-thi Ngiùn-hòng	Land Bank of Taiwan
Hak-kâ thú-lèu	Fujian Tulou
Khòng-sàng-chhàm (Hiông-kóng)	LOHAS Park Station
Sien-sî-hiông	Xianxi, Changhua
Sîn-kóng-hiông	Xingang, Chiayi
Chûng-phû-hiông	Zhongpu, Chiayi
Fâ-thàn-hiông	Huatan
Tsuk-thòng-hiông	Zhutang, Changhua
Chûng-fà Thai-ho̍k	Chung Hua University
Phû-yàm-hiông	Puyan, Changhua
Tsuk-khì-hiông	Zhuqi, Chiayi
Thai-sàng-hiông	Dacheng, Changhua
Ngi-súi-hiông	Ershui, Changhua
Ngi-tsuk-hiông	Yizhu, Chiayi
Súi-song-hiông	Shuishang, Chiayi
Fu̍k-hîn-hiông	Fuxing District, Taoyuan
Thai-lìm-tsṳ́n	Dalin, Chiayi
Thai-yèn-hiông	Dayuan District
Phî-thèu-hiông	Pitou, Changhua
Mòi-sân-hiông	Meishan, Chiayi
Fuk-hîn-hiông (Chông-fa)	Fuxing, Changhua
Pet-téu-tsṳ́n	Beidou, Changhua
Fân-lu-hiông	Fanlu, Chiayi
Fûn-yèn-hiông	Fenyuan, Changhua
Ngi-lìm-tsṳ́n	Erlin, Changhua
Thièn-chûng-tsṳ́n	Tianzhong, Changhua
Siu-súi-hiông	Xiushui, Changhua
100000	100000 (number)
Kô-sîn-shì	Emperor Ku
Jarosław	Jarosław
Tûng-khî (Hiông-kóng)	Eastern District (Hong Kong)
Â-chû Thien-sṳ Yû-han Kûng-sṳ̂ (Hiông-kóng)	Asia Television
Gaspésie–Îles-de-la-Madeleine	Gaspésie–Îles-de-la-Madeleine
Pok-lò-yen	Boluo County
Ostrowiec Świętokrzyski	Ostrowiec Świętokrzyski
Sa̍k-fûng-khî	Shifeng District
Tshiâ-tshu̍k	She people
Sîn-kâ-po Koet-li̍p Thai-ho̍k	National University of Singapore
Sên-sán	Production (economics)
Chojnice	Chojnice
Bronckhorst	Bronckhorst
Thi-kip-sṳ	Prefecture-level city
Mine-sṳ	Mine, Yamaguchi
Mì-fûn-ho̍k	Differential of a function
Tûng-hiông-tshu̍k	Dongxiangs
Lâ-fú-tshu̍k	Lahu people
Włodawa	Włodawa
Starachowice	Starachowice
Stalowa Wola	Stalowa Wola
Chat-ho̍k Pok-sṳ	Doctor of Philosophy
Lì-tó-khî	Islands District
Ermelo	Ermelo
Thông-phûng	Apidae
Tshûng-shîn-yen	Okinawa Prefecture
Tshòng-lo̍k-sṳ	Changle
Yí-fù-khî	Yuhu District
Sâm-súi-khî	Sanshui District
Nàm-thin-sṳ	Nam Định
Montpellier Thai-ho̍k	University of Montpellier
Końskie	Końskie
Luceni	Luceni
Fà-khièu	Overseas Chinese
Kien-nèn-yen	Jianning County
Lô-kông-khî	Luogang District
Madrid Chhṳ-chhṳ Thai-ho̍k	Autonomous University of Madrid
Tshṳ-tshṳ-chû	Autonomous prefectures of China
Medway	Medway
Pó-ôn-khî	Bao'an District
Pet-liù-sṳ	Beiliu
Nysa, Pô-làn	Nysa, Poland
Belver de Cinca	Belver de Cinca
Pó-ôn-chhu̍k	Bonans
Culemborg	Culemborg
Kôan-tan-sṳ	Kuantan
Sokółka	Sokółka
Thâu-thông-shì	Emperor Yao
Hikari-sṳ	Hikari, Yamaguchi
Krosno	Krosno
Kûng-lî	Kilometre
Almarza	Almarza
Aldealices	Aldealices
Aldealafuente	Aldealafuente
Alentisque	Alentisque
Adradas	Adradas
Alconaba	Alconaba
Abejar	Abejar
Aldealpozo	Aldealpozo
Alcubilla de las Peñas	Alcubilla de las Peñas
Aldealseñor	Aldealseñor
Alcubilla de Avellaneda	Alcubilla de Avellaneda
Covaleda	Covaleda
Almazul	Almazul
Arcos de Jalón	Arcos de Jalón
Aldehuela de Periáñez	Aldehuela de Periáñez
Almenar de Soria	Almenar de Soria
Vinuesa	Vinuesa
Sû-chiu-fa	Suzhou dialect
Duruelo de la Sierra	Duruelo de la Sierra
San Leonardo de Yagüe	San Leonardo de Yagüe
Sṳ̂-é-sân (Hiông-kóng)	Lion Rock
Chhṳ̀-yùn-sân	Tsz Wan Shan
白話	Standard Chinese (disambiguation)
Vòng-thai-siên Tshàm	Wong Tai Sin Station
Shâu-sân-sṳ	Shaoshan
Tshiên-vân Chhàm(TSW)	Tsuen Wan Station
Chhṳ̂m-súi-phu Tshàm	Sham Shui Po Station
梅縣話	Meixian dialect
Yù-thòng Tshàm(YAT)	Yau Tong Station
Tai-tshu̍k	Dai people
Mùn-pâ-tshu̍k	Monpa people
Kudamatsu-sṳ	Kudamatsu
Kiong-tshu̍k	Qiang people
Afrikaner-ngìn	Afrikaner
Sâ-thèu-kok	Sha Tau Kok
Yîn-koet-ngìn	British people
Ngá-tshu̍k	Wa people
Brummen	Brummen
Kûng-yîn	Hectometre
Fû-yûng-sṳ	Seremban
Jasło	Jasło
Â-chhông-chhu̍k	Achang people
Bielsk Podlaski	Bielsk Podlaski
Beuningen	Beuningen
Thú-tshu̍k	Monguor people
Kîn-mí	Gigametre
Sîn-lòng	Bridegroom
Pân-kap	Speckled pigeon
Súi-tshu̍k	Sui people
Nyet-láu-tshu̍k	Gelao people
Kín-phó-tshu̍k	Jingpo people
Lo̍k-pâ-tshu̍k	Lhoba people
Li̍t-siuk-tshu̍k	Lisu people
Vì-kî Pak-khô Ngî-ngièn Lie̍t-péu	List of Wikipedias
Siên-pî-chhu̍k	Xianbei
Sanyo-Onoda-sṳ	Sanyo-Onoda
Petrusburg	Petrusburg
Billingham	Billingham
Pin-kông-khî	Binjiang District
Fap-ho̍k	Legal education
Pet-khî (Hiông-kóng)	North District (Hong Kong)
Mô-nàm-tshu̍k	Maonan people
Nu-tshu̍k	Nu people
Mu̍k-láu-tshu̍k	Mulao people
Sî-sûng-pán-na̍p Thài-tshu̍k Tshṳ-tshṳ-chû	Xishuangbanna Dai Autonomous Prefecture
Ngièn-lóng-khî	Yuen Long District
Kôn-thòng-khî	Kwun Tong District
Khwûi-tshiâng-khî	Kwai Tsing District
Phù-mí-tshu̍k	Pumi people
Thai-pu-khî	Tai Po District
Tet-ngo-tshu̍k	Palaung people
Vòng-thai-siên-khî	Wong Tai Sin District
Tshiên-vân-khî	Tsuen Wan District
Pu-lóng-chhu̍k	Blang people
Pok-pha̍k-yen	Bobai County
Chhîn-sîn-yen	Qingxin District
Pâ-thìn-khiùn	Ba Đình District
Bracknell Sêm-lìm	Bracknell Forest
Mìn-chú Chin-phu-tóng	Democratic Progressive Party
Tomaszów Lubelski	Tomaszów Lubelski
Liú-kông-yen	Liujiang County
Thiên-hò-khî	Tianhe District
Po-thèu-khî	Potou District
Hàng-thung Chok-ngia̍p Ne-thúng	Mobile operating system
Hrubieszów	Hrubieszów
Liùng-mùn-yen	Longmen County
Hói-tshong-khî	Haicang District
Pet Québec Thi-khî	Nord-du-Québec
Montérégie	Montérégie
Druten	Druten
Nàm-hiùng-sṳ	Nanxiong
Hói-nàm-fa	Hainanese
Tshiùng-thâu Mèu-tshu̍k Tshṳ-tshṳ-yen	Songtao Miao Autonomous County
Chhièn-Liòng	Former Liang
Liú-sàng-yen	Liucheng County
Sun-tet-khî	Shunde District
Dębica	Dębica
Fân-nyî-khî	Panyu District
Québec-ngìn Tóng	Parti Québécois
Grahamstown	Grahamstown
Cape Town Thai-ho̍k	University of Cape Town
Phìn-lo̍k-yen	Pingle County
Kui-phìn-sṳ	Guiping
Sasolburg	Sasolburg
Kûng-nèn-hîn Sú-kî	Feature phone
Tûng-sân-yen	Dongshan County
Hò-thòng-khî	Hetang District
Si̍p-mî-khî	Jimei District
Ǹg-fûng-khî	Yufeng District
Daniele Suzuki	Daniele Suzuki
Kraśnik	Kraśnik
Dęblin	Dęblin
Radzyń Podlaski	Radzyń Podlaski
Pet-thâm-yúng	Pak Tam Chung
Kú-thung Tshàm(Tûng-Thiet-Sien)古洞站（東鐵綫）	Kwu Tung Station
Kú-thung	Kwu Tung
Hiông-kóng Piên-kin Kim-khî	Frontier Closed Area
Thûn-mùn-khî	Tuen Mun District
Kiú-liùng-sàng-khî	Kowloon City District
Nàm-khî (Hiông-kóng)	Southern District (Hong Kong)
Vân-chái-khî	Wan Chai District
Prudnik	Prudnik
Villanueva de Sigena	Villanueva de Sigena
Tûng-Thiet-Sien	East Rail Line
Tseung Kwan O Line	Tseung Kwan O Line
Stockton-on-Tees	Stockton-on-Tees
Kóng-nèn-yen	Guangning County
Bultfontein	Bultfontein
Sî-Liòng	Western Liang (Sixteen Kingdoms)
Phiàng-Chhià	Ping Che
Lo̍k-mâ-chû	Lok Ma Chau
Kiú-liùng--thòng Tshàm	Kowloon Tong Station
Wokingham	Wokingham
Fûng-hâi-khî	Fengxi District
Kô-lò-sî	Colossae
Lò-fù-khî	Luohu District
Yàm-thièn-khî	Yantian District
Khiâm-nàm Pu-yî-tshu̍k Mèu-tshu̍k Tshṳ-tshṳ-chû	Qiannan Buyei and Miao Autonomous Prefecture
Lìm-ha Fì-tshu̍k Tshṳ-tshṳ-chû	Linxia Hui Autonomous Prefecture
Liùng-kông-khî	Longgang District, Shenzhen
Middelburg, Tûng Khôi-phú-sén	Middelburg, Eastern Cape
Graaff-Reinet	Graaff-Reinet
Orania	Orania, Northern Cape
Fu-yòng-sṳ	Fuyang District
Yì-yâu-sṳ	Yuyao
Â-pa Chhong-chhu̍k Kiông-chhu̍k Chhṳ-chhṳ-chû	Ngawa Tibetan and Qiang Autonomous Prefecture
Vong-kok Tshàm(MOK)	Mong Kok Station
Welkom	Welkom
Vú-mîn-yen	Wuming District
Hoedspruit	Hoedspruit
Lìm-ôn-sṳ	Lin'an City
Hói-tsû-khî	Haizhu District
Ye̍t-siù-khî	Yuexiu District
Vryheid	Vryheid
Swellendam	Swellendam
Kwun-lò-sṳ	Miluo City
Vòng-pu-khî	Huangpu District, Guangzhou
Nàm-hói-khî	Nanhai District
Sin-nî-sṳ	Xinyi, Guangdong
Lùng-ôn-yen	Long'an County
Tû-kông-yén-sṳ	Dujiangyan City
Mâ-sân-yen	Mashan County
Sîn-fi-khî	Xinhui District
Tshiùng-fa-sṳ	Conghua District
Lièn-sân Chong-chhu̍k Yâu-chhu̍k Chhṳ-chhṳ-yen	Lianshan Zhuang and Yao Autonomous County
Lo̍k-tshông-sṳ	Lechang
Lièn-chiu-sṳ	Lianzhou
Kô-yêu-sṳ	Gaoyao
Fû-yûng-khî	Furong District
Hîn-nèn-sṳ	Xingning, Guangdong
Ho̍k-sân-sṳ	Heshan, Guangdong
Yòng-chhûn-sṳ	Yangchun
Mo̍k-li̍t Tha̍t-ngá Tha̍t-vat-ngì-tshu̍k Tshṳ-tshṳ-khì	Morin Dawa Daur Autonomous Banner
Thùng-ôn-khî	Tong'an District
Liu̍k-fûng-sṳ	Lufeng, Guangdong
Thòi-kông-khî	Taijiang District
Liùng-hói-sṳ	Longhai City
Sa̍k-sṳ̂-sṳ	Shishi, Fujian
Siông-ôn-khî	Xiang'an District
Mên-hêu-yen	Minhou County
Lìm-siong-sṳ	Linxiang, Hunan
Liù-yòng-sṳ	Liuyang
Lói-yòng-sṳ	Leiyang
Tsàu-vú-sṳ	Shaowu
Hói-shù-khî	Haishu District
Sa-fi Mìn-tsú Lièn-sien	League of Social Democrats
Kien-tet-sṳ	Jiande
Phî-yen	Pi County
Sîn-tû-khî	Xindu District
Phìn-siông-sṳ	Pingxiang, Guangxi
Nî-chiu-sṳ	Yizhou
Tshîn-hói-khî	Chenghai District
Yîn-tet-sṳ	Yingde
Sṳ̍p-fong-sṳ	Shifang
Vi	Stomach
Tsìn-kông-sṳ	Jin River (Fujian)
Tshông-sân-khî	Cangshan District
Chhông-ǹg-yen	Cangwu County
Liùng-hâ	Lobster
Pak-van-mí	Megametre
Kî-nok-tshu̍k	Jino people
Chhém-hâi-sṳ	Cenxi
Ngo̍k-lùn-tshùn-tshu̍k	Oroqen people
Chhà-lîn-yen	Chaling County
Shèn-sàng-khî	Chancheng District
Chhòng-sâ-yen	Changsha County
Tshòng-thai-yen	Changtai County
Tshòng-tin-yen	Changting County
Chhòng-chû-khî	Changzhou District
Tshèu-ôn-yen	Chao'an District
Chaudière-Appalaches	Chaudière-Appalaches
Sî-Chû	Western Zhou
Liông (Nàm-chhèu)	Liang dynasty
Sṳ̀n-Hòn	Cheng Han
Sàng-phu Mèu-chhu̍k Chhṳ-chhṳ-yen	Chengbu Miao Autonomous County
Sàng-siong-khî	Chengxiang District
Tshak-kham-khî	Chikan District
Chhùng-chû-sṳ	Chongzhou
Christiana (Nàm-fî)	Christiana, North West
Sùn-ôn-yen	Chun'an County
Lí-sàng-khî	Licheng District, Quanzhou
Thaai-phin-cang-ziu	Dajiao
Pet-ngan Thi-khî (Québec)	Côte-Nord
Mí-nàm-kâ-pó-ngìn	Minangkabau people
Tshṳ̀-song-hiông	Chishang, Taitung
Néu-yok-kóng	New York Harbor
Tha̍k-é	Dizi (instrument)
Kiet-chhu̍k	Jie people
Su-nèn-yen	Shouning County
Sâ-vân-khî	Shawan District
Thûng-chhôn-khî	Tongchuan District
Sṳ-chûng-khî (Lo̍k-Sân-sṳ)	Shizhong District, Leshan
Mâ-piên Yì-chhu̍k Chhṳ-chhṳ-yen	Mabian Yi Autonomous County
Thai-song-ló-kiûn	Daode Tianzun
Thai-phû-yen	Dabu County
Thai-fa Yâu-chhu̍k Chhṳ-chhṳ-yen	Dahua Yao Autonomous County
Tân-yit kón-lî-khî	Unitary authority
Kú-thièn-yen	Gutian County
Tet-pó-yen	Debao County
Tet-fa-yen	Dehua County
Sîn-fa-tsṳ́n	Xinhua District, Tainan
Kûan-meu-hiông	Guanmiao District
Hiông-kóng Thit-sṳ-nì Lo̍k-yèn Thu-ká-khî	Hong Kong Disneyland Resort
Ńg-kuk	Five Grains
Tet-khin-yen	Deqing County, Guangdong
Tí-chhu̍k	Di (Five Barbarians)
Fi-sàng-khî	Huicheng District
Chiáng-ngân-yen	Jingyan County
Fài-si̍p-yen	Huaiji County
Khien-vì-yen	Qianwei County
Ńg-thûng-khiàu-khî	Wutongqiao District
Kông-hói-khî	Jianghai District
Khì-yen	Qu County
Sun-khin-khî	Shunqing District
Kô-phiàng-khî	Gaoping District
Mu̍k-chhôn-yen	Muchuan County
Liú-pet-khî	Liubei District
Liú-nàm-khî	Liunan District
Thien-pha̍k-yen	Dianbai District
Sông-lìm-yen	Shanglin County
Thâm-thòng-khî	Qintang District
Mòi-yen	Meixian District
Chṳ̂-yòng-khî	Ziyang District
Sâm-kông Thûng-chhu̍k Chhṳ-chhṳ-yen	Sanjiang Dong Autonomous County
Na̍p-hâi-khî	Naxi District
Mièn-chuk-sṳ	Mianzhu
Lièn-sàng-yen	Liancheng County
Kô-chiu-sṳ	Gaozhou
Khiûng-lôi-sṳ	Qionglai City
Si-fi-sṳ	Sihui
Ngièu-phìn-yen	Raoping County
Lùi-chiu-sṳ	Leizhou
Sun-tshông-yen	Shunchang County
Lò-ngièn-yen	Luoyuan County
Phîn-nàm-yen	Pingnan County, Fujian
Phìn-thâm-yen	Pingtan County
Nàm-ôn-sṳ	Nan'an, Fujian
Àu-choi Fôn	Saddle-billed stork
Thia̍p-chhái-khî	Diecai District
Ya̍k-sân-khî	Dieshan District
Tín-sàng-khî	Dingcheng District
Tín-fù-khî	Dinghu District
Chhîn-sàng-khî	Qingcheng District
Tûng-khî (Pan-kî-fâ-sṳ)	Dongqu, Panzhihua
Tûng-hîn-sṳ	Dongxing, Guangxi
Tûng-ngièn-yen	Dongyuan County
Kî-chhòng	Airport
Téu-mùn-khî	Doumen District
Liu̍k-chhôn-yen	Luchuan County
Tû-ôn Yâu-chhu̍k Chhṳ-chhṳ-yen	Du'an Yao Autonomous County
Tôn-chiu-khî	Duanzhou District
Tsen-zi-wun	Thousand Character Classic
Ha̍p-phû-yen	Hepu County
Lî Ngâ-kok	James Legge
Yen	Counties of the People's Republic of China
Lò-kông-yen	Luojiang County
Thèn-yen	Teng County
Thi-fông Kau-fi	Local churches (affiliation)
Ngiù-Chhâ-Súi	Chinatown, Singapore
Nàm-Yèn	Southern Yan
Nàm-Liòng	Southern Liang
Fûng-sun-yen	Fengshun County
Siong-sân-yen	Xiangshan County, Zhejiang
Ngiûn-chû-khî	Yinzhou District, Ningbo
Kông-pet-khî (Nèn-pô-sṳ)	Jiangbei District, Ningbo
Nèn-hói-yen (Chet-kông-sén)	Ninghai County
Kông-kòn-khî	Jianggan District
Ngò-mì-sân-sṳ	Emeishan City
Siù-yí-khî	Xiuyu District
Yún-tshûn-yen	Yongchun County
Chàu-yòng-yen	Shaoyang County
Sa̍k-kú-khî	Shigu District
Tsiau-sàng-khî	Jiaocheng District
Sien-yù-yen	Xianyou County
Fên-sân-yen	Hengshan County, Hunan
Yèn-phìn-khî	Yanping District
Sîn-lò-khî	Xinluo District
Phú-sàng-yen	Pucheng County, Fujian
Sâm-ngièn-khî	Sanyuan District
Ngièn-fung-khî	Yanfeng District
Hâm-kông-khî	Hanjiang District, Putian
Fûng-tshe̍t-khî	Fengze District
Lai-sàng-khî	Licheng District, Putian
Sông-hông-yen	Shanghang County
Tshiùng-hâi-yen	Songxi County
Fên-nàm-yen	Hengnan County
Vú-phìn-yen	Wuping County
Fên-tûng-yen	Hengdong County
Nàm-tshìn-yen	Nanjing County
Khî-tûng-yen	Qidong County, Hunan
Lù-siung-khî	Lusong District
Kâ-vò-yen	Jiahe County
Sû-sien-khî	Suxian District
Thâu-ngièn-yen	Taoyuan County
Liùng-fù-khî	Longhu District
Sông-chhṳ̍t-yen	Sangzhi County
Het-sân-khî	Heshan District, Yiyang
Kông-sàng-khî	Jiangcheng District
Phûng-kông-khî	Pengjiang District
Yòng-sî-yen	Yangxi County
Hon-su-yen	Hanshou County
Sa̍k-mùn-yen	Shimen County
Lìm-lí-yen	Linli County
Lìm-vú-yen	Linwu County
Kui-yòng-yen	Guiyang County
Yòng-tûng-yen	Yangdong District
Hiông-chû-khî	Xiangzhou District, Zhuhai
Liùng-mâ-thâm-khî	Longmatan District
Ngiùn-hói-khî	Yinhai District
Vú-siên-yen	Wuxuan County
Kóng-nàm-khî (Kui-kóng-sṳ)	Gangnan District
Yùng-yen (Chhṳ-kung-sṳ)	Rong County, Sichuan
Meu-kóng-khî	Maogang District
Kîm-phìn-khî	Jinping District
Yùng-yen	Rong County, Guangxi
Lû-yen	Lu County
Siong-sân-khî	Xiangshan District, Guilin
Chin-yòng-khî	Jingyang District
Ket-sî-yen	Jiexi County
Siù-fûng-khî	Xiufeng District
Thièn-yòng-yen	Tianyang County
Chhìn-sî-yen	Jingxi County
Yún-fuk-yen	Yongfu County
Thièn-tûng-yen	Tiandong County
Kiûng-sàng Yâu-chhu̍k Chhṳ-chhṳ-yen	Gongcheng Yao Autonomous County
Kung-chiáng-khî	Gongjing District
Mòi-kông-khî	Meijiang District
Hîn-pîn-khî	Xingbin District
Siong-khiâu-khî	Xiangqiao District
Hîn-ngia̍p-yen	Xingye County
Kú-nìn-yen	Gulin County
Lìn-yùn-yen	Lingyun County
Lò-sàng Mu-láu-chhu̍k Chhṳ-chhṳ-yen	Luocheng Mulao Autonomous County
Yàm-piên-yen	Yanbian County
Lìm-kui-yen	Lingui District
Ket-tûng-yen	Jiedong District
Sî-khî (Pan-kî-fâ-sṳ)	Xiqu, Panzhihua
Kon-yòng-yen	Guanyang County
Kîm-sàng-kông-khî	Jinchengjiang District
Kóng-héu-khî	Gangkou District
Phû-pet-yen	Pubei County
Ngiu̍k-chiu-khî	Yuzhou District
Yùng-ôn-yen	Rong'an County
Lìn-chhôn-yen	Lingchuan County, Guangxi
Chhiòn-chiu-yen	Quanzhou County
Van-siu-khî	Wanxiu District
Khîm-pet-khî	Qinbei District
Sîn-fûng-yen	Xinfeng County, Guangdong
Fò-phìn-yen	Heping County
Sé-kiok-lî	Foot washing
Kîm-vân-khî	Jinwan District
Ngìn-kûng Hi-kôn	Artificial organ
Liùng-sṳn-kok-chhu̍k Chhṳ-chhṳ-yen	Longsheng Various Nationalities Autonomous County
Sîn-sàng-yen	Xincheng County
Thiet-sân-kóng-khî	Tieshangang District
Siong-chiu-yen	Xiangzhou County
Kîm-siu Yâu-chhu̍k Chhṳ-chhṳ-yen	Jinxiu Yao Autonomous County
Lùng-lìn Kok-chhu̍k Chhṳ-chhṳ-yen	Longlin Various Nationalities Autonomous County
Chhiâng-siù-khî	Qingxiu District
Chhit-sên-khî	Qixing District
Thièn-lìm-yen	Tianlin County
Liòng-khin-khî	Liangqing District
Phìn-nàm-yen	Pingnan County, Guangxi
Hói-sàng-khî	Haicheng District
Phìn-kó-yen	Pingguo County
Yung-nèn-khî	Yongning District
Fòng-sàng-khî	Fangcheng District
Sông-sṳ̂-yen	Shangsi County
Lìn-sân-yen	Lingshan County
Lu̍k-tshài-yen	Luzhai County
Hîn-ôn-yen	Xing'an County
Phû-kông-yen	Pujiang County, Sichuan
Kîm-thòng-yen	Jintang County
Vûn-kông-khî	Wenjiang District
Phìn-yén-yen	Pingyuan County, Guangdong
Hói-fûng-yen	Haifeng County
Lièn-nàm Yâu-chhu̍k Chhṳ-chhṳ-yen	Liannan Yao Autonomous County
Liùng-tshôn-yen	Longchuan County, Guangdong
Liu̍k-hò-yen	Luhe County
Vú-hêu-khî	Wuhou District
Liùng-chhièn-yi̍t-khî	Longquanyi District
Chiau-liang-yen	Jiaoling County
Kông-chiu-khî	Jiangzhou District
Yu-kông-khî	Youjiang District
Ha̍p-sân-sṳ	Heshan, Guangxi
Kîm-ngiù-khî	Jinniu District
Kím-kông-khî	Jinjiang District
Phàng-chû-sṳ	Pengzhou
Kông-tûng-khî (Nèn-pô-sṳ)	Jiangdong District
Hâ-sàng-khî	Xiacheng District
Kiúng-shú-khî	Gongshu District
Yì-hông-khî	Yuhang District
Sông-sàng-khî	Shangcheng District
Lo̍k-ngia̍p-yen	Leye County
Sân-sî Sṳ-sa	Sơn Tây (Hanoi)
Chûng-koet Ngò-lò-sṳ̂-tshu̍k	Russians in China
Windsor lâu Maidenhead	Royal Borough of Windsor and Maidenhead
Â-ha̍p-sùi-lû-vòng	Ahasuerus
Mà-tsông-khî	Mazhang District
Ńg-fà-yen	Wuhua County
Súi-hâi-yen	Suixi County, Guangdong
Sui-nèn-yen	Suining County, Hunan
Tshî-vùn-yen	Xuwen County
Fuk-ôn-sṳ	Fu'an
Nàm-àu-yen	Nan'ao County
Tsung Kâ-Hiûn	Linda Chung
Chîn-sṳ-sṳ	Jinshi, Hunan
Liâm-kông-sṳ	Lianjiang, Guangdong
Mên-tshîn-yen	Minqing County
Hâ-sân-khî	Xiashan District
Vung-ngièn-yen	Wengyuan County
Fa-chiu-sṳ	Huazhou, Guangdong
Kien-eu-sṳ	Jian'ou
Mâ-mî-khî	Mawei District
Yún-thai-yen	Yongtai County
Nèn-hiông-yen	Ningxiang County
Liùng-vùn-khî	Longwen District
Sṳ-mìn-khî	Siming District
Yí-fâ-khî	Yuhua District, Changsha
Ngiên-kông-sṳ	Yuanjiang
Fi-tûng-yen	Huidong County, Guangdong
Siong-thâm-yen	Xiangtan County
Phìn-fò-yen	Pinghe County
Thai-nèn-yen	Taining County
Kông-tshe̍t-yen	Guangze County
Yún-ôn-sṳ	Yong'an
Thí-ngoi Mo̍k-yòng-ha̍p	Extracorporeal membrane oxygenation
Lìm Tan	Lin Dan
分類:Tet-koet	Category:Germany
分類:Yi-thai-li	Category:Italy
分類:Kâ-nâ-thai	Category:Canada
分類:Sî-pân-ngà	Category:Spain
分類:Chûng-koet	Category:China
分類:Ngi̍t-pún	Category:Japan
分類:Àu-thai-li-â	Category:Australia
分類:Yin-thu	Category:India
分類:Yî-set-lie̍t	Category:Israel
分類:Nàm-fî	Category:South Africa
Koet-li̍p Thòi-vân Thai-ho̍k Yî-ho̍k-yèn Fu-sat Yî-yèn	National Taiwan University Hospital
Thiên-sái (Hiông-kóng)	The Cullinan
Redcar and Cleveland	Redcar and Cleveland
分類:Yin-thu-nì-sî-â	Category:Indonesia
分類:Pâ-kî-sṳ̂-thán	Category:Pakistan
分類:Pô-làn	Category:Poland
分類:Sîn-kâ-po	Category:Singapore
分類:Hòn-koet	Category:South Korea
分類:Thai-koet	Category:Thailand
分類:Ye̍t-nàm	Category:Vietnam
分類:Phú-nen-lui	Category:Mammals
分類:Tiâu	Category:Birds
分類:Chhṳ̍t-vu̍t	Category:Plants
分類:Vu̍t-lí-ho̍k	Category:Physics
分類:Chhṳ-yèn Khô-ho̍k	Category:Natural sciences
分類:Sâng-vu̍t-ho̍k	Category:Biology
分類:Fa-ho̍k	Category:Chemistry
分類:Li̍t-sṳ́	Category:History
分類:Thi-lî	Category:Geography
分類:Sa-fi	Category:Society
分類:Chûng-kau	Category:Religion
分類:Thí-yuk	Category:Sports
分類:Khô-ho̍k	Category:Science
分類:Lièn-ha̍p-koet	Category:United Nations
分類:Êu-chû Lièn-mèn	Category:European Union
分類:Kien-chuk-vu̍t	Category:Buildings and structures
分類:Thûng-sin	Category:Communication
分類:Thi-khiù	Category:Earth
Chhièn-Chhîn	Former Qin
Chhièn-Yèn	Former Yan
Sî Berkshire	West Berkshire
Hiông-kóng Thiet-lu Yû-han Kûng-sṳ̂	MTR Corporation
Thai-mo-sân	Tai Mo Shan
Heu-Yèn	Later Yan
Pet-Liòng	Northern Liang
Chhièn-Chhàu	Han Zhao
Zuera	Zuera
Brotton	Brotton
Langa del Castillo	Langa del Castillo
Contamina	Contamina
Louis Trichardt	Louis Trichardt
Abiego	Abiego
Abanto	Abanto
Sî-Chhîn	Western Qin
Song-Súi Tshàm(Hiông-Kóng Tûng-Thiet-Sien)	Sheung Shui Station
Fó-than-chham	Fo Tan Station
Tson-sa̍k-sân Tshàm	Diamond Hill Station
Yî-lien-chióng	Prix Stanislas Julien
Heu-Chhîn	Later Qin
Kú Lò-mâ	Ancient Rome
La Fueva	La Fueva
Ibanag-ngî	Ibanag language
Sân-thi-mâ-lî-ngî	Hill Mari language
Tsui-heu ke Sṳ́m-phan	Last Judgment
Greenwich Thai-ho̍k	University of Greenwich
Eston	Eston
Middelburg, Mpumalanga-sén	Middelburg, Mpumalanga
Yok-hon-nì-sṳ̂-páu Thai-ho̍k	University of Johannesburg
分類:Chet-ho̍k	Category:Philosophy
分類:Fu̍t-kau	Category:Buddhism
分類:Kî-tuk-kau	Category:Christianity
分類:Yù-thai-kau	Category:Judaism
Hoopstad	Hoopstad
Ventersdorp	Ventersdorp
Pet-Yèn	Northern Yan
Sià-ok Sṳn-kîn	Wicked Bible
Kôn-thòng Chhàm(KWT)	Kwun Tong Station
Ên-tiâu	Eagle
Kiú-liùng Chhàm (Hiông-kóng)	Kowloon Station (MTR)
Yî-kín-vân	Discovery Bay
Wesselsbron	Wesselsbron
Ngùi Pó-lò	Paul Wei
Heu-Liòng	Later Liang (Sixteen Kingdoms)
Heu-Chhàu	Later Zhao
Tsṳ́n (Thòi-vân)	Township (Taiwan)
Bochotnica	Bochotnica
Trompsburg	Trompsburg
Jagersfontein	Jagersfontein
Reddersburg	Reddersburg
Zung-kok tsen-thung zit-nit	Traditional Chinese holidays
Viljoenskroon	Viljoenskroon
Jacobsdal	Jacobsdal
Chong Pâ-nâ-pâ	Barnabas Zhang
Ngi̍t-pún Khûn-chhùng Ki	The Insect Woman
Chiông-Kiûn-Àu	Tseung Kwan O
Chûng-koet Ngî-ngièn	Varieties of Chinese
Bothaville	Bothaville
Brandfort	Brandfort
Theunissen	Theunissen
琴浦同學	Kotoura-san
Fung-fông-sân (Hiông-kóng)	Lantau Peak
分類:Hàng-sên	Category:Planets
分類:Vùn-fa	Category:Culture
分類:Ngìn-vùn Khô-ho̍k	Category:Human sciences
分類:Tî-sṳt	Category:Knowledge
Nàm-tshông Thiet-lu Tshàm（Hiông-kóng）	Nam Cheong Station
Gurrea de Gállego	Religion in Cuba
Hiông-kóng Sṳp-thi Kûng-yèn	Hong Kong Wetland Park
Sàng-sṳ Fûng-sû Kau-fi	City Harvest Church
Ngiù-yèn	Beef ball
Chṳ́-set	Purple
Hòn Sân-mìn	Theodore Hamberg
Phiàng-fa-sṳ	Foochow Romanized
Notre-Dame-du-Mont-Carmel, Québec	Notre-Dame-du-Mont-Carmel, Quebec
Ngiu̍k-sân Koet-kâ Kûng-yèn	Yushan National Park
Thai-phìn-thiên-koet	Taiping Heavenly Kingdom
Cebuano-ngî	Cebuano people
Ventersburg	Ventersburg
Edenburg	Edenburg
Vierfontein	Vierfontein
Hennenman	Hennenman
Odendaalsrus	Odendaalsrus
Steynsrus	Steynsrus
Hiông (Thòi-vân)	Districts of Indonesia
Ap-è	Duck
Kâm Vì-lîm	William Campbell (missionary)
分類:Yên-yèn	Category:Actors
模板:Tl	Template:Tl
模板:Userbox	Template:Userbox
Thòi-sâm-sien	Provincial Highway 3 (Taiwan)
Thòi-vân tû-fi khî	List of metropolitan areas in Taiwan
蛤塘	Kap Tong
Vùn-kím-thu	Man Kam To
Thòi-chûng tû-fi khî	Taichung–Changhua metropolitan area
Thòi-11-sien	Provincial Highway 11 (Taiwan)
Pha̍k-fa-sṳ	Pha̍k-fa-sṳ
Pak-thòng-chṳ́n	Baitang, Guangdong
Nèn-pô-fa	Ningbo dialect
Kâ-ngi chhṳ tû-fi khî	Chiayi metropolitan area
Sòn-Vân-káu-yâ kûng-yèn	Plover Cove Country Park
Hen-Fâ-tshûn	Heng Fa Chuen
Li-kó-teu	Lai Chi Wo
Thò-yèn tû-fi khî	Taoyuan–Zhongli metropolitan area
Thòi-si-sien	Provincial Highway 4 (Taiwan)
Thòi-64-sien	Provincial Highway 64 (Taiwan)
Thòi-18-sien	Provincial Highway 18 (Taiwan)
Sîn Tshóng-tsho Kau-fi	New Creation Church
Yâ-sû Kâ-thìn	Jesus Family
Kóng-thiet CRC-Stock EMU（Bombardier MOVIA C6554-07E） tshâ-hin Lie̍t-tshâ	MTR CNR Changchun EMU
Thòi-16-sien	Provincial Highway 16 (Taiwan)
Mâ Ngâ-kok	James Laidlaw Maxwell
Só-lò-phùn	So Lo Pun
Lûi-chhâ	Lei cha
Thòi-ńg-sien	Provincial Highway 5 (Taiwan)
Sîn-tsuk chhṳ tû-fi khî	Hsinchu metropolitan area
Maria Cordero	Maria Cordero
Lu̍k-Kiáng	Luk Keng (North District)
Thòi-21-sien	Provincial Highway 21 (Taiwan)
Thòi-chû-fa	Taizhou dialect
模板:Wikipedialang	Template:Wikipedia languages
分類:Koet-kâ	Category:Countries
Wikipedia:Kón-lî-yèn	Wikipedia:Administrators
分類:Chûng-fà Mìn-chhu̍k	Category:Ethnic groups in China
分類:Ngìn-vu̍t	Category:People
分類:Mìn-chhu̍k	Category:Ethnic groups
Wikipedia:Hàng-tsṳn-yèn	Wikipedia:Bureaucrats
Wikipedia:IP chhà-fûng li-ngoi-chá	Wikipedia:IP block exemption
Wikipedia:Kî-hi-ngìn	Wikipedia:Bots
分類:Sṳ̀-kiên	Category:Time
分類:Chhṳ-yèn	Category:Nature
分類:Kûng-chhàng	Category:Engineering
分類:Yî-ho̍k	Category:Medicine
分類:Chṳn-chṳ	Category:Politics
分類:Kau-yuk	Category:Education
分類:Kông-ho̍k	Category:Optics
Âi-khi̍p	Egypt
分類:Chat-ho̍k-kâ	Category:Philosophers
模板:Bot	Template:Bot
Kâ-nâ-thai	Canada
分類:Hiûng-ngà-li	Category:Hungary
分類:Hî-lia̍p	Category:Greece
分類:Lâ-thot-vì-â	Category:Latvia
分類:Yù-hi	Category:Games
Thiên-koet	Heaven
Zong Thaai-pheng	Zhang Dapeng
Phi Chhṳ-vùn	Elijah Coleman Bridgman
分類:Êu-chû koet-kâ	Category:Countries in Europe
分類:Êu-chû	Category:Europe
模板:Documentation	Template:Documentation
Wikipedia:Yung-fu	Wikipedia:User access levels
Pok-sṳ	Doctor (title)
Wikipedia:Sa-khî	Wikipedia:Community portal
分類:Wikipedians by language	Category:Wikipedians by language
Sṳ̀n Chhai-kî	Sung Jae-gi
Kî-kèu	Agency (sociology)
Khi-néu Kî-chhòng	Airline hub
Khî-ngia̍p	Business
Ngiuk-yèn	Meatball
Vò-yông-sân	Wo Yang Shan
模板:Softredirect	Template:Soft redirect
模板:Delete	Template:Db
分類:Kî-su̍t	Category:Technology
分類:Ngî-ngièn	Category:Languages
Wikipedia:Chhóng-kien Sîn Thiàu-muk	Wikipedia:Starting an article
分類:還無索引嘅頁面	Category:Noindexed pages
分類:含有損壞文件鏈接嘅頁面	Category:Pages with missing files
模板:Navbox	Template:Navbox
Thoi-chhú	Kangaroo
Chùng-ha̍p Kô-kip Chûng-ho̍k	Comprehensive high school
Fòng-kok-sa̍k Kau-fi	Cornerstone Community Church
Pak-ha̍p-fâ	Lilium
Ma̍k Kâ-thì	Divie Bethune McCartee
Yîn-koet Chóng-ló-fi Chhâi-fi	English Presbyterian Mission
模板:!-	Template:!-
模板:Tnavbar	Template:Navbar
模板:Unicode	Template:Unicode
模板:Smallcaps	Template:Smallcaps
模板:Small	Template:Small
模板:Nowrap	Template:Nowrap
Kiên-sin Tsim-sin Kau-fi	Faith Community Baptist Church
分類:Fî-chû	Category:Africa
分類:Chhṳ-yù Pâng-sén	Category:Free State (province)
分類:Tûng Khôi-phú-sén	Category:Eastern Cape
分類:Gauteng-sén	Category:Gauteng
分類:KwaZulu-Natal-sén	Category:KwaZulu-Natal
分類:Mpumalanga-sén	Category:Mpumalanga
分類:Pet Khôi-phú-sén	Category:Northern Cape
分類:Sṳn-kîn	Category:Bible
分類:Limpopo-sén	Category:Limpopo
分類:Sî Khôi-phú-sén	Category:Western Cape
分類:Sî-pet-sén	Category:North West (South African province)
分類:Si	Category:Books
模板:Pâ-phe̍t	Template:Babel
模板:Reflist	Template:Reflist
模板:Stub	Template:Stub
模板:User ca-1	Template:User ca-1
模板:User de	Template:User de
模板:User de-1	Template:User de-1
模板:User en-3	Template:User en-3
模板:User en-1	Template:User en-1
模板:User en-2	Template:User en-2
模板:User en-4	Template:User en-4
模板:User en-0	Template:User en-0
模板:User en	Template:User en
模板:User de-2	Template:User de-2
分類:Yî-chhiu	Category:Universe
模板:User fr-2	Template:User fr-2
模板:User ja-1	Template:User ja-1
模板:User fr	Template:User fr
模板:Location map/Info	Template:Location map/Info
分類:Khûn-chhùng	Category:Insects
分類:Â-chû	Category:Asia
分類:Chṳ-li	Category:Chile
分類:Sok-lî-â-sén	Category:Province of Soria
分類:Nàm-mî-chû	Category:South America
分類:Khà-sṳ̂-tì-li-â lâu Lòi-ngong	Category:Castile and León
模板:Esoteric	Template:Intricate template
分類:Mâ-lòi-sî-â	Category:Malaysia
分類:Sṳ̍t-phín	Category:Foods
模板:Mod	Template:Mod
模板:SIL	Template:Infobox language/codelist
模板:User es-2	Template:User es-2
模板:Fôn-ngiàng	Template:Welcome
分類:Thiàu-mi-liau	Category:Condiments
分類:Chû-chṳt	Category:Organizations
分類:Ngî-ngièn-ho̍k	Category:Linguistics
模板:ITA	Template:ITA
模板:非洲行政區劃	Template:Countries of Africa
模板:SVK	Template:SVK
模板:Infobox Country	Template:Infobox country
模板:Documentation/docname	Template:Documentation/docname
模板:TUR	Template:TUR
分類:User en-4	Category:User en-4
分類:User en	Category:User en
分類:User zh	Category:User zh
分類:User zh-N	Category:User zh-N
分類:User en-2	Category:User en-2
模板:User zh	Template:User zh
模板:Documentation/start box	Template:Documentation/start box
模板:Cite web	Template:Cite web
Haak-gaa-saan-goh	Hakka hill song
模板:Ombox	Template:Ombox
分類:Hòng-khûng	Category:Aviation
模板:Country data	Template:Country data
分類:Yím-sṳ̍t	Category:Food and drink
模板:Fong-wui	Template:Compass direction
模板:BS3	Template:BS3
分類:Tsúng-thúng	Category:Presidents
模板:IPA	Template:IPA
分類:Chṳn-chṳ Ngìn-lui	Category:Politicians
分類:Mî-chû	Category:Americas
模板:其他	Template:Other uses
分類:Language user templates	Category:Language user templates
模板:User language-N	Template:User blank
模板:Imbox	Template:Imbox
Wikipedia:GNU自由文檔協議證書	Wikipedia:Text of the GNU Free Documentation License
模板:Topicon	Template:Top icon
模板:Fmbox	Template:Fmbox
模板:大洋洲行政區劃	Template:Countries and territories of Oceania
分類:Vùn-ho̍k-kâ	Category:Writers
分類:Kiûn-sṳ	Category:Military
模板:Country data Malaysia	Template:Country data Malaysia
模板:Lang-he	Template:Lang-he
模板:Both	Template:Both
分類:Sṳ-kie Pok-lám-fi	Category:World's Fairs
分類:Chûng-fà Ngìn-mìn Khiung-fò-koet Chú-sit	Category:Presidents of the People's Republic of China
模板:Documentation subpage	Template:Documentation subpage
分類:Fu̍k-tsông	Category:Buddhist monks
模板:FIN	Template:FIN
模板:Purge	Template:Purge
模板:Lang-de	Template:Lang-de
模板:DNK	Template:DNK
模板:Provinces of China	Template:Province-level divisions of China
模板:Userpage	Template:User page
模板:DEU	Template:DEU
模板:SWE	Template:SWE
模板:User language-4	Template:User blank-4
分類:Ye̍t-nàm kî-chhòng	Category:Airports in Vietnam
Kiet-tshòng	Colon (anatomy)
分類:Kûng-sṳ̂	Category:Companies
模板:User fr-3	Template:User fr-3
模板:Allcaps	Template:Allcaps
模板:JPN	Template:JPN
分類:Thien-nó	Category:Computers
模板:MKD	Template:MKD
模板:LTU	Template:LTU
100000000	100000000 (number)
分類:Sṳ-chhòng	Category:Retail markets
Mô-li-ngìn	Māori people
分類:Tho-lu	Category:Streets and roads
模板:Disambig	Template:Disambiguation
模板:Tick	Template:Tick
分類:Khien-không Khô-ho̍k	Category:Health sciences
模板:Smallcaps all	Template:Smallcaps all
分類:Hàng-thung Thien-fa	Category:Mobile phones
模板:User nan	Template:User nan
模板:User nan-1	Template:User nan-1
模板:GRC	Template:GRC
模板:Lang-grc	Template:Lang-grc
模板:CZE	Template:CZE
模板:Lifetime	Template:Lifetime
模板:Lang-en	Template:Lang-en
分類:Chhòn-ngiam-phiang	Category:Infectious diseases
分類:Sîn-kau	Category:Protestantism
模板:GBR	Template:GBR
分類:Sâng-vu̍t	Category:Organisms
模板:SVN	Template:SVN
模板:FRA	Template:FRA
模板:Hiông-kóng Hàng-tsṳn Khî-va̍k	Template:Districts of Hong Kong
模板:User pt-2	Template:User pt-2
分類:Kâ-li-sî-â	Category:Galicia (Spain)
模板:歐洲行政區劃	Template:Sovereign states of Europe
分類:User yue	Category:User yue
分類:User fr	Category:User fr
分類:User ja	Category:User ja
分類:User pt	Category:User pt
分類:User nl-3	Category:User nl-3
分類:User fr-2	Category:User fr-2
分類:User ja-2	Category:User ja-2
分類:User ko-N	Category:User ko-N
分類:User fr-N	Category:User fr-N
分類:Vùn-sṳ	Category:Writing systems
分類:Tho-kau	Category:Taoism
分類:User ca	Category:User ca
分類:User ca-1	Category:User ca-1
分類:User de	Category:User de
分類:User de-2	Category:User de-2
分類:User de-N	Category:User de-N
分類:User en-3	Category:User en-3
分類:User en-N	Category:User en-N
分類:User es	Category:User es
分類:User es-2	Category:User es-2
分類:User es-N	Category:User es-N
分類:Hiông-kóng Thi-lî	Category:Geography of Hong Kong
模板:Lang-lv	Template:Lang-lv
分類:Yî-set-lie̍t kiûn-vòng	Category:Kings of ancient Israel
分類:Yù-thai kiûn-vòng	Category:Kings of ancient Judah
Fî-ngô-sân (Hiông-kóng)	Kowloon Peak
分類:Kí-hò-ho̍k	Category:Geometry
模板:Ye̍t-nàm	Template:Subdivisions of Vietnam
分類:User ja-1	Category:User ja-1
分類:User ko	Category:User ko
Hà-mà	Toad
模板:Lang-vi	Template:Lang-vi
分類:Thiên-hi	Category:Weather
分類:Lièn-ha̍p-koet Pi-sû-chóng	Category:United Nations Secretaries-General
分類:Hói-yòng	Category:Seas
分類:Ido-ngî	Category:Ido (language)
模板:LUX	Template:LUX
分類:Thai-yòng-ne	Category:Solar System
分類:Chhîn-su̍k Ne-thúng	Category:Kinship and descent
分類:Kóng-tûng-sén	Category:Guangdong
分類:Fuk-kian	Category:Fujian
分類:Kîn-chi	Category:Economies
分類:Koet-chi Chû-chṳt	Category:International organizations
分類:Fat-mìn-kâ	Category:Inventors
分類:Yím-liau	Category:Beverages
Sṳ̂-é-sân káu-yâ kûng-yèn (Hiông-kóng)	Lion Rock Country Park
分類:User nan-1	Category:User nan-1
分類:User nan-2	Category:User nan-2
分類:User nan-3	Category:User nan-3
分類:User nan-N	Category:User nan-N
分類:Sa-fi Khô-ho̍k	Category:Social sciences
分類:Mî-koet Koet-kâ Kûng-yèn	Category:National parks of the United States
分類:Kô-tén Kau-yuk	Category:Higher education
模板:!w	Template:!wrap
分類:Thi-hìn	Category:Landforms
分類:Pâ-lùn-sî-â Chhṳ-chhṳ-khî	Category:Valencian Community
模板:User ja-2	Template:User ja-2
分類:Thiên-chú-kau	Category:Catholicism
分類:User yue-N	Category:User yue-N
分類:Yîm-ngo̍k-kâ	Category:Musicians
模板:!((	Template:!((
模板:))!	Template:))!
模板:Lang	Template:Lang
分類:Fa-kâ	Category:Painters
分類:Yin-thu chûng-kau	Category:Religion in India
分類:Ho̍k-su̍t	Category:Academia
分類:Sa-fi chṳ-thu	Category:Social institutions
羅香林	Lo Hsiang-lin
模板:.w	Template:•wrap
分類:Ngìn-lui	Category:Humans
模板:CYP	Template:CYP
分類:Yin-thu Thi-lî	Category:Geography of India
分類:Sông-ngia̍p	Category:Commerce
分類:Kiú-liùng	Category:Kowloon
分類:Fap-koet fòng-ti	Category:French emperors
模板:EST	Template:EST
模板:Nocaps	Template:Nocaps
模板:AUT	Template:AUT
分類:Meu-khô	Category:Felids
分類:Kâ-le̍t-pí-hói	Category:Caribbean Sea
分類:Thòi-vân Thi-lî	Category:Geography of Taiwan
模板:User zh-3	Template:User zh-3
模板:User zh-4	Template:User zh-4
Kuet-tho	National Highway
分類:Nì-pok Thi-lî	Category:Geography of Nepal
分類:Thai-khûng-ngìn	Category:Astronauts
分類:Chûng-fà Mìn-tshu̍k Tshṳ-tshṳ-chû	Category:Autonomous prefectures of the People's Republic of China
分類:Khî-ngia̍p-kâ	Category:Businesspeople
分類:Fî-li̍t-pîn	Category:Philippines
分類:User nl	Category:User nl
分類:User zh-1	Category:User zh-1
分類:User zh-4	Category:User zh-4
分類:User zh-3	Category:User zh-3
分類:User zh-2	Category:User zh-2
分類:Yin-thu kiûn-chú	Category:Indian monarchs
分類:Â-chû Thien-sṳ Yû-han Kûng-sṳ	Category:Asia Television Limited
分類:Ho̍k-vi	Category:Academic degrees
分類:Pô-sṳ̂ koet-vòng	Category:Monarchs of Persia
分類:Kîm-yùng	Category:Finance
分類:Chûng-fà mìn-koet tsúng-thúng	Category:Presidents of the Republic of China
分類:Thien-sṳ	Category:Television
分類:Chhòn-kau-sṳ	Category:Missionaries
分類:Hói-hia̍p	Category:Straits
粵語	Yue Chinese
分類:Yin-Êu Ngî-ne	Category:Indo-European languages
分類:Kî-chhòng	Category:Airports
分類:Fa-ho̍k ngièn-su	Category:Chemical elements
分類:Khô-ho̍k-kâ	Category:Scientists
分類:Pâ-kî-sṳ̂-thán Thi-lî	Category:Geography of Pakistan
分類:Nì-pok	Category:Nepal
分類:Thòi-vân	Category:Taiwan
分類:Chûng-koet chhèu-thoi	Category:Imperial Chinese dynasties
分類:Nàm-Â koet-kâ	Category:South Asian countries
分類:Pet-mî-chû koet-kâ	Category:Countries in North America
分類:Sṳ-tshòi	Category:Vegetables
分類:Súi-kó	Category:Fruit
分類:Khiu-yok Sṳn-kîn	Category:Old Testament
分類:Pok-vu̍t-kón	Category:Museums
分類:Hì-hèu	Category:Climate
分類:Â-chû Thi-lî	Category:Geography of Asia
分類:Ngìn-lui-ho̍k	Category:Anthropology
分類:Thai-khûng Chhàm	Category:Space stations
分類:Fap-koet Thai-ho̍k	Category:Universities in France
模板:ESP	Template:ESP
分類:Thung-vu̍t	Category:Animals
分類:Chit-chhûi Thung-vu̍t	Category:Vertebrates
分類:Ngî-yîm-ho̍k	Category:Phonetics
分類:Hòng-khûng Kûng-sṳ̂	Category:Airlines
分類:Ngìn-khièn	Category:Human rights
Chuk-kô-vân	Penny's Bay
分類:Ngo̍k-hi	Category:Musical instruments
分類:Ngî-ne	Category:Language families
分類:Hon-sṳ	Category:Chinese characters
分類:Pó-sa̍k	Category:Gemstones
分類:Koet-kâ Kûng-yèn	Category:National parks
分類:Hi-siong-ho̍k	Category:Meteorology
分類:Chûng-mî-chû	Category:Central America
分類:Fî-kîm-su̍k	Category:Nonmetals
分類:Hiông-kóng	Category:Hong Kong
分類:Kóng-sî-sén	Category:Guangxi
分類:Thòi-vân tû-fi khî	Category:Metropolitan areas of Taiwan
分類:Yên-liau	Category:Fuels
分類:Sông-hói	Category:Shanghai
分類:Sin-sit kî-su̍t	Category:Information technology
分類:Ngiuk-lui	Category:Meat
分類:Yo̍k-ho̍k	Category:Pharmacy
分類:Sú-tû	Category:Capitals
分類:Nàm-Â	Category:South Asia
分類:Kham-thap-pu-lî-â	Category:Cantabria
分類:Â-sṳ̂-thù-lî-â-sṳ̂-sén	Category:Asturias
分類:Kîm-su̍k	Category:Metals
分類:Thòi-pet-sṳ	Category:Taipei
分類:Lò-màn Ngî-chhu̍k	Category:Romance languages
分類:Kâu-thûng	Category:Transport
分類:Ngiên-kiu	Category:Research
分類:Thông-lui	Category:Carbohydrates
分類:Fòng-ti	Category:Emperors
分類:Nàm-tó ngî-hì	Category:Austronesian languages
分類:Pet-mî-chû	Category:North America
分類:Kô-sú	Category:Singers
分類:Si-chhòng	Category:Tibet
分類:Sú-ho̍k-kâ	Category:Mathematicians
分類:Vu̍t-lî ho̍k-kâ	Category:Physicists
分類:Kîn-chi ho̍k-kâ	Category:Economists
分類:Mìn-tsú	Category:Democracy
分類:Kî-tuk-kau Li̍t-sṳ́	Category:History of Christianity
分類:Àu-mûn	Category:Macau
分類:Hàng-sên-ne	Category:Planetary systems
分類:Hiông-kóng pan-tó	Category:Islands of Hong Kong
分類:Thòi-vân ngî-ngièn	Category:Languages of Taiwan
分類:Thòi-vân Koet-kâ Kûng-yèn	Category:National parks of Taiwan
分類:Khiù-lui Yun-thung	Category:Ball games
分類:Ngiùn-hòng	Category:Banks
Fu̍k-vu	Service (economics)
分類:Kâ-thai-lò-nì-â	Category:Catalonia
Kap-kut-vùn	Oracle bone script
分類:Khien-không	Category:Health
模板:Lang-pl	Template:Lang-pl
Trojany	Trojany, Masovian Voivodeship
分類:Pâ-pí-lùn-ngìn	Category:Babylonian people
Yîn-fà Sû-yen	Ying Wa College
分類:Â-chû koet-kâ	Category:Countries in Asia
分類:Mî-chû koet-kâ	Category:Countries in the Americas
分類:Yùn-lìm-yen	Category:Yunlin County
分類:Ngièn-lóng-khî	Category:Yuen Long District
分類:Ngì-làn-yen	Category:Yilan County, Taiwan
分類:Yù-tsiâm-vong-khî	Category:Yau Tsim Mong District
分類:Vòng-thai-siên-khî	Category:Wong Tai Sin District
模板:Chûng-fà Mìn-chhu̍k	Template:Ethnic groups in China
模板:User nan-2	Template:User nan-2
模板:User cdo	Template:User cdo
模板:MLT	Template:MLT
模板:Lang-roa	Template:Lang-roa
模板:User zh-classical-2	Template:User lzh-2
分類:Vân-chái-khî	Category:Wan Chai District
分類:Hak-kâ	Category:Hakka
分類:Kûng-yèn	Category:Parks
分類:Thòi-vân Ngiùn-hòng	Category:Banks of Taiwan
分類:Chûng-sî-khî (Hiông-kóng)	Category:Central and Western District, Hong Kong
分類:Kâ-ngi-yen	Category:Chiayi County
分類:Sùn-fàn Hì-thúng	Category:Circulatory system
分類:Tûng-khî (Hiông-kóng)	Category:Eastern District, Hong Kong
分類:Thòi-vân ngièn-tshu-mìn ngî-ngièn	Category:Formosan languages
分類:Nàm-Â Thi-lî	Category:Geography of South Asia
分類:Si-chhòng Thi-lî	Category:Geography of Tibet
分類:Hak-kâ Vùn-fa	Category:Hakka culture
分類:Hak-kâ-ngî	Category:Hakka Chinese
模板:Lts	Template:Lts
分類:Hiông-kóng-tó	Category:Hong Kong Island
分類:Sîn-tsuk-yen	Category:Hsinchu County
分類:Fâ-lièn-yen	Category:Hualien County
分類:Nui-mùng-kú Tshṳ-tshṳ-khî	Category:Inner Mongolia
分類:Koet-tsi kîn-tsi tsû-tsṳt	Category:International economic organizations
分類:Lì-tó-khî	Category:Islands District
分類:Kî-lùng-sṳ	Category:Keelung
分類:Kiú-liùng-sàng-khî	Category:Kowloon City District
分類:Khwûi-tshiâng-khî	Category:Kwai Tsing District
分類:Kôn-thòng-khî	Category:Kwun Tong District
分類:Lâ-tên Mî-chû	Category:Latin America
分類:Chúng-chhu̍k	Category:Race (human classification)
分類:Mèu-li̍t-yen	Category:Miaoli County
分類:Mîn-ngî	Category:Min Chinese
分類:Hiông-kóng Sân-Fûng	Category:Mountains, peaks and hills of Hong Kong
分類:Chûng-fà Mìn-koet	Category:Republic of China
分類:Nàm-thèu-yen	Category:Nantou County
分類:Sîn-kie	Category:New Territories
分類:Pet-khî (Hiông-kóng)	Category:North District, Hong Kong
分類:Sî-kung-khî	Category:Sai Kung District
分類:Sâ-thièn-khî	Category:Sha Tin District
分類:Siak-khiet-kau	Category:Sikhism
分類:Sa-fi Mìn-tsú Tsú-ngi	Category:Social democracy
分類:Phìn-tûng-yen	Category:Pingtung County
模板:BEL	Template:BEL
分類:Nàm-khî (Hiông-kóng)	Category:Southern District, Hong Kong
分類:Kú-thoi chhu̍k-khiùn	Category:Ancient peoples
分類:Vùi-sṳ̂-khà-sén	Category:Province of Huesca
分類:Thap-là-kô-na̍p-sén	Category:Province of Tarragona
分類:Pâ-set-lò-nâ-sén	Category:Province of Barcelona
分類:Pâ-lùn-sî-â-sén	Category:Province of Valencia
分類:Chûng-kau-ho̍k	Category:Study of religion
分類:Thai-pu-khî	Category:Tai Po District
分類:Thòi-tûng-yen	Category:Taitung County
分類:Thòi-vàn Ngièn-chhu-mìn	Category:Taiwanese aborigines
分類:Thò-yèn-yen	Category:Taoyuan City
分類:User hak	Category:User hak
分類:Thien-fa	Category:Telephony
模板:TPE	Template:TPE
分類:Ngân-set	Category:Color
分類:Tshiên-vân-khî	Category:Tsuen Wan District
分類:Thûn-mùn-khî	Category:Tuen Mun District
分類:Â-là-kung	Category:Aragon
分類:User cdo	Category:User cdo
分類:User zh-min-dong-N	Category:User cdo-N
分類:User hak-1	Category:User hak-1
分類:User hak-3	Category:User hak-3
分類:User hak-4	Category:User hak-4
分類:User hak-N	Category:User hak-N
分類:Chông-fa-yen	Category:Changhua County
分類:Tseu-mìn	Category:Lighting
分類:Phòng-châ-phú	Category:Punjab
分類:Phàng-fù-yen	Category:Penghu County
分類:Hak-kâ-ngìn	Category:Hakka people
模板:Chûng-fà Mìn-koet Hàng-chṳn Khî-va̍k	Template:Administrative divisions of Taiwan
分類:Lie̍t-yî-tha̍t-sén	Category:Province of Lleida
甲型流感病毒H7N9亞型	Influenza A virus subtype H7N9
分類:User lzh	Category:User lzh
分類:Sat-là-kô-sat-sén	Category:Province of Zaragoza
模板:HUN	Template:HUN
模板:Yin-thu-nì-sî-â	Template:Provinces of Indonesia
分類:User hak-2	Category:User hak-2
Vòng-phûng	Wasp
模板:Kóng-sî Hàng-chṳn Khî-va̍k	Template:Guangxi
模板:Kóng-tûng Hàng-chṳn Khî-va̍k	Template:Guangdong
分類:User en-1	Category:User en-1
分類:User de-1	Category:User de-1
模板:Thòi-pet-sṳ	Template:TaipeiDistricts
Liû-khiû Khiùn-tó	Ryukyu Islands
模板:User ru-3	Template:User ru-3
Thòi-23-sien	Provincial Highway 23 (Taiwan)
模板:Phìn-tûng-yen	Template:Taiwan Pingtung divisions
模板:Ngì-làn-yen	Template:Taiwan Yilan divisions
模板:User nl-3	Template:User nl-3
模板:Sîn-pet-sṳ	Template:New Taipei divisions
模板:Yùn-lìm-yen	Template:Taiwan Yunlin divisions
模板:Si-chhôn Hàng-chṳn Khî-va̍k	Template:Sichuan
模板:Nàm-thèu-yen	Template:Taiwan Nantou divisions
模板:Fâ-lièn-yen	Template:Taiwan Hualien divisions
模板:MTR	Template:MTR
模板:Kâ-ngi-yen	Template:Taiwan Chiayi divisions
模板:Thòi-chûng-sṳ	Template:TaichungDistricts
模板:Sîn-tsuk-yen	Template:Taiwan Hsinchu divisions
模板:Chông-fa-yen	Template:Taiwan Changhua divisions
模板:Thò-yèn-yen	Template:Taiwan Taoyuan divisions
模板:Mèu-li̍t-yen	Template:Taiwan Miaoli divisions
模板:Thòi-nàm-yen	Template:TainanDistricts
模板:Thòi-tûng-yen	Template:Taiwan Taitung divisions
Fi-chiu Thai-â-vân Kîn-tsi Kî-su̍t Khôi-fat-khî	Huizhou Daya Bay Economic and Technological Development Zone
Sin-Kóng Chûng-sîm (Hiông-kóng)	Silvercord
2013-ngièn Lù-sân Thi-chṳ́n	2013 Lushan earthquake
Yòng-ya̍p-é	Butterfly
Chûng-koet Chhèu-thoi	Dynasties in Chinese history
模板:Documentation/end box	Template:Documentation/end box
Ngiên-kiu-só	Graduate school
模板:User hak-2	Template:User zh-hakka-2
Hak-ngî Sṳn-kîn: Hien-thoi Thòi-vân Hak-ngî Yi̍t-pún	Hakka Bible: Today's Taiwan Hakka Version
模板:Style/IPA	Template:Style/IPA
模板:Style/yid	Template:Style/yid
Lì Li̍t-kî	Rudolf Lechler
模板:Ping	Template:Reply to
IPhone 5S	IPhone 5S
IPhone 5C	IPhone 5C
Sûng-kú Lô-siên	Nucleic acid double helix
Yun Hyon-seok	Yun Hyon-seok
特殊:最近更改	Special:RecentChanges
模組:HtmlBuilder	Module:HtmlBuilder
模組:Navbar	Module:Navbar
模組:Navbox	Module:Navbox
模板:台灣語言	Template:Languages of Taiwan
Phû Lû-sṳ	William N. Brewster
Siak-pak-tshu̍k	Xibo
分類:Yit-chhùng	Category:Beneficial insects
馬來西亞航空17號班機空難	Malaysia Airlines Flight 17
Khóa Vùn-chet	Ko Wen-je
Hîn-fa Phìn-fa-sṳ	Hinghwa Romanized
Kien-nèn Lò-mâ-sṳ	Kienning Colloquial Romanized
