ʻApelika	Africa
Iāpana	Japan
‘Amelika Hema	South America
Nolewai	Norway
ʻIlelani	Republic of Ireland
Hunakalia	Hungary
Sepania	Spain
‘Amelika Hui Pū ‘ia	United States
Pelekiuma	Belgium
Lukemapuka	Luxembourg
Honua	Earth
Keoki Wakinekona	George Washington
Pinilana	Finland
Kuekene	Sweden
Kenemaka	Denmark
Pōlani	Poland
Lituania	Lithuania
ʻĪkālia	Italy
Kuikilani	Switzerland
ʻAukekulia	Austria
Helene	Greece
Tureke	Turkey
Potugala	Portugal
‘Eulopa	Europe
‘Ākia	Asia
‘Amelika ‘Ākau	North America
‘Ane‘ālika	Antarctica
Wikipikia	Wikipedia
Hōlani	Netherlands
Wakinekona, D.C.	Washington, D.C.
Kapalakiko	San Francisco
Pelelina	Berlin
Barack Obama	Barack Obama
Lākana	London
Palika	Paris
Mekiko	Mexico
Moana ʻAkelanika	Atlantic Ocean
Moana Pākīpika	Pacific Ocean
Kaleponi	California
Pokekona	Boston
Pō‘akahi	Monday
Ianuali	January
Pepeluali	February
Malaki	March
Hōkū‘ula	Mars
Kenia	Kenya
‘Aikiopia	Ethiopia
‘Apelila	April
Mei	May
Iune	June
Iulai	July
‘Aukake	August
Kepakemapa	September
‘Okakopa	October
Nowemapa	November
Kēkēmapa	December
Pō‘alua	Tuesday
Pō‘akolu	Wednesday
Pō‘ahá	Thursday
Pō‘alima	Friday
Pō‘aono	Saturday
Pōpule	Sunday
Liona	Lion
Palani	France
‘Ōlelo Ekepelānako	Esperanto
Aupuni Mōʻī Hui Pū ʻia	United Kingdom
Pōpoki	Cat
Kina	China
‘Ōlelo Palani	French language
Palakila	Brazil
Rūsia	Russia
Pai (makemakika)	Pi
‘Alapama	Alabama
Kelemānia	Germany
Belarusa	Belarus
ʻĀina Hau	Iceland
ʻEsetonia	Estonia
Makulu	Saturn
1 (helu)	1 (number)
Lakawia	Latvia
ʻUkelena	Ukraine
Tiekia	Czech Republic
Solowakia	Slovakia
Solowenia	Slovenia
Molodowa	Moldova
Romānia	Romania
Pulukalia	Bulgaria
Loma	Rome
Repupalika o Masedonia	Republic of Macedonia
ʻAlepania	Albania
Koloatia	Croatia
Bosenia me Hesegowina	Bosnia and Herzegovina
‘Akepaikana	Azerbaijan
ʻAnakola	Andorra
Kupelo	Cyprus
Keokia	Georgia (country)
Kasakana	Kazakhstan
Malata	Malta
Monako	Monaco
Montenegero	Montenegro
Wakikana	Vatican City
Sana Marino	San Marino
‘Inidonesia	Indonesia
Wolfgang Amadeus Mozart	Wolfgang Amadeus Mozart
Ludwig van Beethoven	Ludwig van Beethoven
‘Alekelia	Algeria
Kelewikiona	Television
Chile	Chile
Ukaliali‘i	Mercury (planet)
Hōkūloa	Venus
Ka‘āwela	Jupiter
Hele‘ekela	Uranus
Nepekune	Neptune
Kilo hōkū	Astronomy
Sinapoa	Singapore
Akeakamai	Science
Likenekaina	Liechtenstein
Makemakika	Mathematics
Baharaina	Bahrain
‘Āmēnia	Armenia
Seripia	Serbia
‘Aukekulelia	Australia
Kālaikūlohea	Physics
‘Alekina	Argentina
Kālaimeaola	Biology
Kōlea ʻĀkau	North Korea
Kamabodia	Cambodia
Nalala	Dinosaur
Hoʻomana Mohameka	Islam
Kālailau nahele	Botany
Sofia	Sofia
Kūlanakauhale	City
Lā	Sun
Kahua o nā hōkū	Solar System
Haikokene	Hydrogen
Hiliuma	Helium
Likiuma	Lithium
Beryllium	Beryllium
Makahiki	Year
Oslo	Oslo
Likepona	Lisbon
Rhône (kahawai)	Rhône
Boron	Boron
Kalepona	Carbon
Naikokene	Nitrogen
‘Okikene	Oxygen
Hōkū hele	Planet
Mokekao	Moscow
Fluorine	Fluorine
ʻŌlelo ʻĪkālia	Italian language
Nīane	Neon
Sodiuma	Sodium
Makanekiuma	Magnesium
‘Aluminuma	Aluminium
‘Īnia	India
Silikone	Silicon
Pokepola	Phosphorus
Sulufura	Sulfur
Kolorine	Chlorine
William Shakespeare	William Shakespeare
‘Aragona	Argon
Potasiuma	Potassium
Kalipuna	Calcium
Monokolia	Mongolia
Scandium	Scandium
Titanium	Titanium
Vanadium	Vanadium
Maine	Maine
Lio	Horse
Hoʻomana Buda	Buddhism
Nū Hamekia	New Hampshire
Leonardo da Vinci	Leonardo da Vinci
Makakukeka	Massachusetts
Konekikuka	Connecticut
Hawai‘i	Hawaii
Moana ʻĀlika	Arctic Ocean
Heiti	Haiti
‘Ilana	Iran
‘Ilaka	Iraq
‘Ālaka	Alaska
ʻIseraʻela	Israel
Panamā	Panama
Iemene	Yemen
Ioredāne	Jordan
Pololika	Florida
Kaikikana	Kyrgyzstan
‘Alikona	Arizona
Kuete	Kuwait
Laosa	Laos
Lepanona	Lebanon
‘Olekona	Oregon
Maladiwa	Maldives
Uka	Utah
Malaisia	Malaysia
Puruma	Burma
Nepala	Nepal
ʻOmana	Oman
Pakitana	Pakistan
Katala	Qatar
Saudi ʻAlapia	Saudi Arabia
Sililanaka	Sri Lanka
Suria	Syria
Pokémon	Pokémon
Tailani	Thailand
Wiekanama	Vietnam
‘Apekanikana	Afghanistan
Banagaladesa	Bangladesh
Butana	Bhutan
Brunei	Brunei
ʻĀina Pilipino	Philippines
Isaac Newton	Isaac Newton
Albert Einstein	Albert Einstein
Tunisia	Tunisia
Beijing	Beijing
Burakina Faso	Burkina Faso
ʻElikilea	Eritrea
Mauritiusa	Mauritius
Iulius Caesar	Julius Caesar
Hamepuka	Hamburg
Huli honua	Geology
Mikikana	Michigan
‘Ilinoe	Illinois
Tulinia	Thuringia
Kakoka ‘Ākau	North Dakota
Kakoka Hema	South Dakota
Monekana	Montana
Waiomina	Wyoming
‘Ikahō	Idaho
Wakinekona	Washington (state)
Moana ʻIniana	Indian Ocean
Kololako	Colorado
ʻAlepa	Alps
Kikako, ʻIlinoe	Chicago
‘Ōlelo Sepania	Spanish language
Montevideo	Montevideo
Johann Sebastian Bach	Johann Sebastian Bach
Wilikinia	Virginia
Wilikinia Komohana	West Virginia
Nuioka	New York
Loke ‘Ailana	Rhode Island
Melelana	Maryland
Kelawea	Delaware
‘Ohaio	Ohio
Penekelewinia	Pennsylvania
Uetersen	Uetersen
Augustus	Augustus
Nū ‘Ieleke	New Jersey
‘Ōlelo Pinilana	Finnish language
‘Inikiana	Indiana
Keokia (‘Amelika Hui Pū ‘ia)	Georgia (U.S. state)
Kekeka	Texas
Kalolaina Hema	South Carolina
Seine	Seine
Buenos Aires	Buenos Aires
Mēkiko D.F.	Mexico City
Mikikipi	Mississippi
Kenekī	Tennessee
Nū Mekiko	New Mexico
‘Akenai	Athens
Minekoka	Minnesota
Wikonekina	Wisconsin
‘Iowa	Iowa
Nepalaka	Nebraska
Kanekaka	Kansas
Mikouli	Missouri
Luikiana	Louisiana
Kenekuke	Kentucky
‘Akanaka	Arkansas
‘Okalahoma	Oklahoma
Makekepuka	Magdeburg
Reykjavík	Reykjavík
Paipala	Bible
Thulium	Thulium
Ka Ho‘omana Iesū ‘Oia‘i‘o	True Jesus Church
‘Ōlelo Pelekania	English language
Đồng Hới	Đồng Hới
Concepción, Chile	Concepción, Chile
Końskowola	Końskowola
2000	2000
2003	2003
2002	2002
2001	2001
2009	2009
2008	2008
2004	2004
2005	2005
2006	2006
2007	2007
Lipekika	Leipzig
1998	1998
1999	1999
Kurów	Kurów
Kemika	Chemistry
Makelika	Madrid
Lima	Lima
Santiago de Chile	Santiago
Quito	Quito
Ankara	Ankara
Riyadh	Riyadh
Kamakeko	Damascus
Amman	Amman
Muscat	Muscat, Oman
Wikipedia:Sandbox	Wikipedia:Sandbox
Wehimala	Weimar
Osasco	Osasco
Dong Hoi Airport	Dong Hoi Airport
Curitiba	Curitiba
Zichyújfalu	Zichyújfalu
Sarah Bernhardt	Sarah Bernhardt
Mauna Kana Helena	Mount St. Helens
Mokuhonua	Continent
Kapikala	Capital city
Monzón	Monzón
Almazán	Almazán
Puke noi‘i kū‘ikena	Encyclopedia
Ka papa kinohi	Main Page
Vincent van Gogh	Vincent van Gogh
Frida Kahlo	Frida Kahlo
Michelangelo	Michelangelo
Pablo Picasso	Pablo Picasso
Raffael Santi	Raphael
Rembrandt	Rembrandt
Frank Lloyd Wright	Frank Lloyd Wright
Matsuo Bashō	Matsuo Bashō
Castille a Leon	Castile and León
Meka	Mecca
Gabriel García Márquez	Gabriel García Márquez
Johann Wolfgang von Goethe	Johann Wolfgang von Goethe
Māhele:Candidates for speedy deletion	Category:Candidates for speedy deletion
Kaumokuʻāina	Country
Homer	Homer
Hōʻole Akua	Atheism
Kālaikaiaola	Ecology
Kālaiʻāina	Politics
Aupuni	Government
Qin Shi Huang	Qin Shi Huang
Tolstoi	Leo Tolstoy
Moku‘āina	State (polity)
ʻŌlelo Lūkini	Russian language
‘Ōlelo Pākē	Chinese language
Nelson Mandela	Nelson Mandela
Makani Pāhili	Tropical cyclone
Moʻokalaleo	Literature
Māhele:Palani	Category:France
Oboe	Oboe
ʻOlumepika Kauwela ma 2008	2008 Summer Olympics
Granada	Granada
ʻĀtoma	Atom
Lāpaki	Rabbit
Mohameka	Muhammad
Burgos	Burgos
Ronald Reagan	Ronald Reagan
‘Ōlelo Zaza	Zazaki language
Māhele:Palakila	Category:Brazil
Kumumea kemikala	Chemical element
‘Ohe kani	Flute
ʻAlea	Area
Hulahula	Dance
Papa o nā ʻāina	List of sovereign states
Miranda de Ebro (Burgos)	Miranda de Ebro
Kuli	Hearing loss
Ponferrada	Ponferrada
Santander	Santander, Spain
Helu piha	Integer
Malgrat de Mar	Malgrat de Mar
‘Ōlelo ‘Alapia	Arabic language
Tiranosauru	Tyrannosaurus
Terikeratopa	Triceratops
Setegasauru	Stegosaurus
Barakiosauru	Brachiosaurus
Welokirapetoa	Velociraptor
Hae	Flag
‘Ulu	Breadfruit
Aupuni kiwikā	Municipality
Salamanca	Salamanca
Zamora (España)	Zamora, Spain
León (España)	León, Spain
Welemoneka	Vermont
Houston, Kekeka	Houston
Pēniki	Phoenix, Arizona
Kakalameko	Sacramento, California
Honolulu, Hawaiʻi	Honolulu
Kauoha Hou	New Testament
Rafael Correa	Rafael Correa
Louvre	Louvre
‘Ao‘ao Kū‘oko‘a Pokoliko	Puerto Rican Independence Party
Kalikimaka	Christmas
Mo‘ai	Moai
Hoʻolele hualono	Podcast
Friedrich Schiller	Friedrich Schiller
Jean Auguste Dominique Ingres	Jean-Auguste-Dominique Ingres
Pule	Week
Cervidae	Deer
Pule Alaka‘i A Ka Haku	Lord's Prayer
Musée d'Orsay	Musée d'Orsay
Mokupuni	Island
Moshchena	Moshchena
ʻōhiʻa lomi	Tomato
Paltoga	Paltoga
Panalā‘au o Quảng Binh	Quảng Bình Province
Bryan Cranston	Bryan Cranston
Felidae	Felidae
Pichilemu	Pichilemu
Canidae	Canidae
Karlstad	Karlstad
Mölnlycke	Mölnlycke
Bovidae	Bovidae
Phocidae	Earless seal
ʻAnekelopa	Antelope
‘Amelika	Amerika
Cabañas Raras	Cabañas Raras
Ardón (León)	Ardón
Algadefe	Algadefe
Acebedo	Acebedo
Los Barrios de Luna	Los Barrios de Luna
Fresno de la Vega	Fresno de la Vega
La Antigua (Sepania)	La Antigua, León
Almanza	Almanza
El Burgo Ranero	El Burgo Ranero
Boca de Huérgano	Boca de Huérgano
Bustillo del Páramo	Bustillo del Páramo
Boñar	Boñar
Alija del Infantado	Alija del Infantado
Brazuelo	Brazuelo
Berlanga del Bierzo	Berlanga del Bierzo
Cabreros del Río	Cabreros del Río
Bercianos del Real Camino	Bercianos del Real Camino
Burón (León)	Burón
Bercianos del Páramo	Bercianos del Páramo
Otariidae	Eared seal
Pinnipedia	Pinniped
Zhengzhou	Zhengzhou
Mīkini helu	Calculator
Halakepoka	Hartford, Connecticut
‘Ōlelo Hawai‘i	Hawaiian language
Pea kina	Giant panda
Pae moku	Archipelago
Valparaíso	Valparaíso
‘Ōlelo Sāmoa	Samoan language
Marlon Brando	Marlon Brando
‘Ōlelo Kahiki	Tahitian language
Wailele ‘o Niakala	Niagara Falls
Mošovce	Mošovce
Kauō	Laysan
ʻAperodite	Aphrodite
Nā mokuʻāina o ʻAmelika Hui	U.S. state
Pauka niho	Toothpaste
Mineapoli	Minneapolis
Apia	Apia
Brigitte Bardot	Brigitte Bardot
Arancón	Arancón
'ōlelo toki pona	Toki Pona
Paul Gauguin	Paul Gauguin
Teide	Teide
Kālaiʻelala	Entomology
Ágreda	Ágreda
ʻAnekilosauru	Ankylosaurus
Waleluka	Walrus
Johannes Vermeer	Johannes Vermeer
Teletubbies	Teletubbies
Kahiki	Tahiti
Israel Kamakawiwoʻole	Israel Kamakawiwoʻole
Johnny Cash	Johnny Cash
Nanahana	Ginkgo biloba
Hesioda	Hesiod
Cubillos del Sil	Cubillos del Sil
Igüeña	Igüeña
Noceda del Bierzo	Noceda del Bierzo
Castropodame	Castropodame
Páramo del Sil	Páramo del Sil
Molinaseca	Molinaseca
Congosto	Congosto
Toreno	Toreno
Folgoso de la Ribera	Folgoso de la Ribera
Sancedo	Sancedo
Josepa Samika	Joseph Smith
Pihemanu	Midway Atoll
Paris Hilton	Paris Hilton
Palapola	Parabola
Helu kumu	Prime number
Söréd	Söréd
Palencia	Province of Palencia
El Royo	El Royo
Reyero	Reyero
La Ercina	La Ercina
La Robla	La Robla
Santa Colomba de Curueño	Santa Colomba de Curueño
Santa María del Monte de Cea	Santa María del Monte de Cea
San Cristóbal de la Polantera	San Cristóbal de la Polantera
ʻUkulele	Ukulele
Santa María del Páramo	Santa María del Páramo
Santa Elena de Jamuz	Santa Elena de Jamuz
San Justo de la Vega	San Justo de la Vega
Hawai‘i (mokupuni)	Hawaii (island)
Georg Philipp Telemann	Georg Philipp Telemann
ʻUlano	Uranus (mythology)
Coronel Fabriciano	Coronel Fabriciano
Quintana y Congosto	Quintana y Congosto
Matallana de Torío	Matallana de Torío
Pamela Anderson	Pamela Anderson
Gema	Gemstone
Nā panalā‘au o Burgos	List of municipalities in Burgos
Puahōlani	Tulip
Nā panalā‘au o León	List of municipalities in León
Nikolai Rimsky-Korsakov	Nikolai Rimsky-Korsakov
Nā panalā‘au o Salamanca	List of municipalities in Salamanca
Nā panalā‘au o Soria	List of municipalities in Soria
Nā panalā‘au o Tarragona	List of municipalities in Tarragona
Donald Sutherland	Donald Sutherland
Peter O'Toole	Peter O'Toole
Nā panalā‘au o Zamora	List of municipalities in Zamora
Lili‘uokalani	Liliuokalani
Joey King	Joey King
X-Men	X-Men
Nika	Nyx
Mauna Kea	Mauna Kea
O‘ahu	Oahu
Lucillo	Lucillo
Cimanes de la Vega	Cimanes de la Vega
Cebrones del Río	Cebrones del Río
Quintana del Marco	Quintana del Marco
San Millán de los Caballeros	San Millán de los Caballeros
Cubillas de Rueda	Cubillas de Rueda
Cea (León)	Cea, León
Garrafe de Torío	Garrafe de Torío
Santa María de Ordás	Santa María de Ordás
Cuadros	Cuadros
Llamas de la Ribera	Llamas de la Ribera
Riello	Riello
Palacios de la Valduerna	Palacios de la Valduerna
Castrocalbón	Castrocalbón
Carrocera	Carrocera
Murias de Paredes	Murias de Paredes
Rioseco de Tapia	Rioseco de Tapia
Santa Cristina de Valmadrigal	Santa Cristina de Valmadrigal
Grajal de Campos	Grajal de Campos
Santa María de la Isla	Santa María de la Isla
Campo de Villavidel	Campo de Villavidel
Crémenes	Crémenes
Cimanes del Tejar	Cimanes del Tejar
Castilfalé	Castilfalé
Quintana del Castillo	Quintana del Castillo
Campazas	Campazas
Pajares de los Oteros	Pajares de los Oteros
San Pedro Bercianos	San Pedro Bercianos
Santa Marina del Rey	Santa Marina del Rey
Cebanico	Cebanico
Gordaliza del Pino	Gordaliza del Pino
Castrillo de la Valduerna	Castrillo de la Valduerna
Pozuelo del Páramo	Pozuelo del Páramo
Prado de la Guzpeña	Prado de la Guzpeña
Matanza (León)	Matanza, León
Santa Colomba de Somoza	Santa Colomba de Somoza
Cubillas de los Oteros	Cubillas de los Oteros
Mansilla Mayor	Mansilla Mayor
Gordoncillo	Gordoncillo
San Esteban de Nogales	San Esteban de Nogales
Regueras de Arriba	Regueras de Arriba
Luyego	Luyego
San Emiliano	San Emiliano
Maraña	Maraña
Castrotierra de Valmadrigal	Castrotierra de Valmadrigal
Magaz de Cepeda	Magaz de Cepeda
Matadeón de los Oteros	Matadeón de los Oteros
Castrillo de Cabrera	Castrillo de Cabrera
Gusendos de los Oteros	Gusendos de los Oteros
Chozas de Abajo	Chozas de Abajo
Roperuelos del Páramo	Roperuelos del Páramo
Sonata No. 8 no Piano (Beethoven)	Piano Sonata No. 8 (Beethoven)
ʻĀpana	District
Aotearoa	Aotearoa
John Singer Sargent	John Singer Sargent
Sesame Street	Sesame Street
Aupuni Mōʻī o Hawaiʻi	Kingdom of Hawaii
Mauna Loa	Mauna Loa
Pat Hingle	Pat Hingle
Frans Hals	Frans Hals
Pō La‘i Ē	Silent Night
Nuʻuhiwa	Marquesas Islands
Edentata	Xenarthra
Hualālai	Hualālai
Caltojar	Caltojar
Berlanga de Duero	Berlanga de Duero
Christopher Lee	Christopher Lee
Knoxville, Kenekī	Knoxville, Tennessee
Lāna‘i	Lanai
Carl Larsson	Carl Larsson
Kīlauea	Kīlauea
Maui	Maui
Māmā	Tempo
Christopher Plummer	Christopher Plummer
Mokupuni o Hawai‘i	Hawaiian Islands
Ivan Shishkin	Ivan Shishkin
Moloka‘i	Molokai
Nancy Reagan	Nancy Reagan
Almuñécar	Almuñécar
Hakakā ‘ole	Nonkilling
Kaua‘i	Kauai
Tigranes II	Tigranes the Great
Georges de La Tour	Georges de La Tour
Adour	Adour
Ivan Kramskoi	Ivan Kramskoi
Motril	Motril
Roger Ebert	Roger Ebert
John Bauer	John Bauer (illustrator)
Adolfo Suárez	Adolfo Suárez
Thomas Eakins	Thomas Eakins
Kamehameha I	Kamehameha I
Hilo	Hilo, Hawaii
Anggun	Anggun
Kaho‘olawe	Kahoolawe
Kalo	Colocasia esculenta
Makua Kamiano	Father Damien
Ni‘ihau	Niihau
Dixie Carter	Dixie Carter
Guadix	Guadix
Pete Seeger	Pete Seeger
Heleuī	Halloween
Waikīkī	Waikiki
Brook Mahealani Lee	Brook Lee
Castrojeriz	Castrojeriz
Camponaraya	Camponaraya
Ituero de Azaba	Ituero de Azaba
Villardiegua de la Ribera	Villardiegua de la Ribera
Małgorzata Braunek	Małgorzata Braunek
O Clone	O Clone
Xuxa	Xuxa
Bañuelos de Bureba (Burgos)	Bañuelos de Bureba
Imelda Marcos	Imelda Marcos
Mariana Ximenes	Mariana Ximenes
Órgiva	Órgiva
Michael Gough	Michael Gough
Sargentes de la Lora (Burgos)	Sargentes de la Lora
Vadillo	Vadillo
Peterosauru	Pterodactylus
Makeima	Macadamia
Richard Griffiths	Richard Griffiths
Donald Pleasence	Donald Pleasence
Andrew Wyeth	Andrew Wyeth
'Imi loa Dora	Dora the Explorer
Loja	Loja, Granada
Hua mele hapawalu	Eighth note
Hua mele ‘oko‘a	Whole note
Hua mele hapahā	Quarter note
Kamehameha	Kamehameha
Richard Schiff	Richard Schiff
Pedro de Betancur	Peter of Saint Joseph Betancur
Calzada de Valdunciel	Calzada de Valdunciel
Villarcayo de Merindad de Castilla la Vieja (Burgos)	Villarcayo de Merindad de Castilla la Vieja
Tubilla del Lago (Burgos)	Tubilla del Lago
Pino del Oro	Pino del Oro
Maki a Ruby	Max & Ruby
Jeddah	Jeddah
Almaluez	Almaluez
Salas de los Infantes (Burgos)	Salas de los Infantes
Hua mele hapa kanakolukūmālua	Thirty-second note
Kamehameha II	Kamehameha II
Makakilo	Makakilo, Hawaii
Arraya de Oca (Burgos)	Arraya de Oca
Valencia de Don Juan	Valencia de Don Juan
Manzanal del Barco	Manzanal del Barco
Bugedo (Burgos)	Bugedo
Hua mele hapalua	Half note
Anne Hathaway	Anne Hathaway (disambiguation)
ʻAiea	Aiea, Hawaii
ʻĪao	Iao Valley
Partido de la Sierra en Tobalina (Burgos)	Partido de la Sierra en Tobalina
Valdefresno	Valdefresno
Salobreña	Salobreña
Aldea del Obispo	Aldea del Obispo
Arabayona de Mógica	Arabayona de Mógica
El Maderal	El Maderal
Roa (Burgos)	Roa de Duero
Calvarrasa de Arriba	Calvarrasa de Arriba
Kamehameha III	Kamehameha III
Buke a Moramona	Book of Mormon
Carazo	Carazo Department
Astorga	Astorga, Spain
Pōmare IV	Pōmare IV
Mary Kawena Pukui	Mary Kawena Pukui
Alexander ʻIolani Liholiho	Kamehameha IV
Tan Son Nhat International Airport	Tan Son Nhat International Airport
Aliud	Aliud
Baraona	Baraona
Medinaceli	Medinaceli
Láchar	Láchar
Burgo de Osma-Ciudad de Osma	Burgo de Osma-Ciudad de Osma
Suellacabras	Suellacabras
Yanguas	Yanguas
San Esteban de Gormaz	San Esteban de Gormaz
Baza	Baza, Granada
San Vicente del Raspeig	San Vicente del Raspeig / Sant Vicent del Raspeig
Aranda de Duero (Burgos)	Aranda de Duero
Māmalahoe	Kānāwai Māmalahoe
Nā kiaʻāina o Hawaiʻi	List of Governors of Hawaii
Ka'aahi Thomas	Thomas & Friends
Likaono	Lycaon (Arcadia)
Alhama de Granada	Alhama de Granada
Mauna kai	Seamount
Gallegos del Río	Gallegos del Río
Espinosa de los Monteros (Burgos)	Espinosa de los Monteros
Rabanera del Pinar (Burgos)	Rabanera del Pinar
Cañamaque	Cañamaque
Cazurra	Cazurra
Requejo (Zamora)	Requejo
Haleakalā	Haleakalā
Navaleno	Navaleno
Tremedal de Tormes	Tremedal de Tormes
Las Omañas	Las Omañas
Santa Eufemia del Barco	Santa Eufemia del Barco
Huahine	Huahine
Alfoz de Bricia (Burgos)	Alfoz de Bricia
Villalbilla de Burgos (Burgos)	Villalbilla de Burgos
Negrilla de Palencia	Negrilla de Palencia
Honolulu International Airport	Honolulu International Airport
Efrem Zimbalist, Jr.	Efrem Zimbalist, Jr.
Kailua	Kailua, Honolulu County, Hawaii
Belorado (Burgos)	Belorado
Peleas de Abajo	Peleas de Abajo
Fresneda de la Sierra Tirón (Burgos)	Fresneda de la Sierra Tirón
Morales de Toro	Morales de Toro
Carcedo de Burgos	Carcedo de Burgos
Cijuela	Cijuela
Armilla	Armilla, Granada
Chauchina	Chauchina
Dúrcal	Dúrcal
Cantabrana	Cantabrana
Fuente Vaqueros	Fuente Vaqueros
Huéscar	Huéscar
Trévago	Trévago
Maracena	Maracena
La Bouza	La Bouza
El Campo de Peñaranda	El Campo de Peñaranda
Palacios de Riopisuerga (Burgos)	Palacios de Riopisuerga
Līhuʻe	Lihue, Hawaii
Pedrosa del Príncipe (Burgos)	Pedrosa del Príncipe
Merindad de Valdeporres (Burgos)	Merindad de Valdeporres
Aldealengua	Aldealengua
Cañizal	Cañizal
Tubilla del Agua (Burgos)	Tubilla del Agua
La Encina (Salamanca)	La Encina
Valdepiélago	Valdepiélago
Kahuku	Kahuku, Hawaii
Villademor de la Vega	Villademor de la Vega
Camarzana de Tera	Camarzana de Tera
Dévanos	Dévanos
Poʻipū	Poipu, Hawaii
Zotes del Páramo	Zotes del Páramo
Cañizo	Cañizo
Priaranza del Bierzo	Priaranza del Bierzo
Villagonzalo Pedernales (Burgos)	Villagonzalo Pedernales
Frades de la Sierra	Frades de la Sierra
Avellanosa de Muñó (Burgos)	Avellanosa de Muñó
Pinos Puente	Pinos Puente
Fuentes de Carbajal	Fuentes de Carbajal
Garcibuey	Garcibuey
Rollán	Rollán
Moreruela de Tábara	Moreruela de Tábara
El Bodón	El Bodón
Monasterio de la Sierra (Burgos)	Monasterio de la Sierra
Villamiel de la Sierra (Burgos)	Villamiel de la Sierra
Santa Fe	Santa Fe, Granada
Ólvega	Ólvega
Solarana (Burgos)	Solarana
Kailua-Kona	Kailua, Hawaii County, Hawaii
Barrio de Muñó (Burgos)	Barrio de Muñó
Valmala (Burgos)	Valmala, Province of Burgos
Casaseca de Campeán	Casaseca de Campeán
Terradillos de Esgueva (Burgos)	Terradillos de Esgueva
Waipahu	Waipahu, Hawaii
Villamartín de Don Sancho	Villamartín de Don Sancho
Viveiro	Viveiro
Burganes de Valverde	Burganes de Valverde
Sobrado	Sobrado, Galicia
Basconcillos del Tozo (Burgos)	Basconcillos del Tozo
San Martín de Valderaduey	San Martín de Valderaduey
Palapala ‘Āina Honua	World map
Magaña	Magaña
La Calzada de Béjar	La Calzada de Béjar
Kapaʻa	Kapaa, Hawaii
Abajas (Burgos)	Abajas
Itero del Castillo (Burgos)	Itero del Castillo
Hawaiʻi Ponoʻī	Hawaiʻi Ponoʻī
Huinakolu Polenekia	Polynesian Triangle
Izagre	Izagre
Reinosa	Reinosa
Centenera de Andaluz	Centenera de Andaluz
Villalazán	Villalazán
Almenara de Tormes	Almenara de Tormes
Bermellar	Bermellar
Mokupāpapa	Kure Atoll
Sila Hawaiʻi	Hawaiian monk seal
Cacabelos	Cacabelos
Béjar	Béjar
Topas	Topas
‘Ārue	Arue, French Polynesia
Vidayanes	Vidayanes
Villanázar	Villanázar
Soto de la Vega	Soto de la Vega
Faramontanos de Tábara	Faramontanos de Tábara
Manzanal de los Infantes	Manzanal de los Infantes
Kaunakakai	Kaunakakai, Hawaii
Peque	Peque, Zamora
Fermoselle	Fermoselle
Valle de Sedano (Burgos)	Valle de Sedano
Junta de Traslaloma (Burgos)	Junta de Traslaloma
Mansilla de las Mulas	Mansilla de las Mulas
ʻOeneusa	Oeneus
Atapuerca (Burgos)	Atapuerca, Province of Burgos
Kaʻū	Kau, Hawaii
Riocavado de la Sierra (Burgos)	Riocavado de la Sierra
Belver de los Montes	Belver de los Montes
Villanueva de Argaño (Burgos)	Villanueva de Argaño
Valderas	Valderas
Menekikā	Mehndi
Gradefes	Gradefes
Onzonilla	Onzonilla
Arenas de Iguña	Arenas de Iguña
Keokola Palaiologina Synadene	Theodora Palaiologina Synadene
Backyardigans	The Backyardigans
Barca	Barca (ancient city)
Ciudad Rodrigo	Ciudad Rodrigo
Sahagún	Sahagún
Villatuelda (Burgos)	Villatuelda
Almarza	Almarza
Aldealices	Aldealices
Aldealafuente	Aldealafuente
Alentisque	Alentisque
Adradas	Adradas
Alconaba	Alconaba
Abejar	Abejar
Almajano	Almajano
Arenillas	Arenillas
Aldealpozo	Aldealpozo
Alcubilla de las Peñas	Alcubilla de las Peñas
Aldealseñor	Aldealseñor
Alcubilla de Avellaneda	Alcubilla de Avellaneda
Covaleda	Covaleda
Casarejos	Casarejos
Cerbón	Cerbón
Calatañazor	Calatañazor
Almazul	Almazul
Cidones	Cidones
Alpanseque	Alpanseque
Arcos de Jalón	Arcos de Jalón
Aldehuela de Periáñez	Aldehuela de Periáñez
Beratón	Beratón
Almenar de Soria	Almenar de Soria
Maján	Maján
Coscurita	Coscurita
Barcones	Barcones
Castilfrío de la Sierra	Castilfrío de la Sierra
Castilruiz	Castilruiz
Miño de Medinaceli	Miño de Medinaceli
Vinuesa	Vinuesa
Cigudosa	Cigudosa
Candilichera	Candilichera
Ausejo de la Sierra	Ausejo de la Sierra
Carabantes	Carabantes
Soliedra	Soliedra
Taroda	Taroda
Nepas	Nepas
Valtajeros	Valtajeros
Arévalo de la Sierra	Arévalo de la Sierra
Pozalmuro	Pozalmuro
Cabrejas del Pinar	Cabrejas del Pinar
Villasayas	Villasayas
Cubilla	Cubilla, Soria
Castillejo de Robledo	Castillejo de Robledo
Escobosa de Almazán	Escobosa de Almazán
Estepa de San Juan	Estepa de San Juan
Carrascosa de la Sierra	Carrascosa de la Sierra
Las Aldehuelas	Las Aldehuelas
Bayubas de Arriba	Bayubas de Arriba
Borobia	Borobia
Bliecos	Bliecos
Buberos	Buberos
Muriel Viejo	Muriel Viejo
Oncala	Oncala
Fuentecambrón	Fuentecambrón
Cabrejas del Campo	Cabrejas del Campo
Frechilla de Almazán	Frechilla de Almazán
Valdelagua del Cerro	Valdelagua del Cerro
Ciria	Ciria
Buitrago	Buitrago
Talveila	Talveila
Salduero	Salduero
Fuentes de Magaña	Fuentes de Magaña
Viana de Duero	Viana de Duero
Tardelcuende	Tardelcuende
Duruelo de la Sierra	Duruelo de la Sierra
Bayubas de Abajo	Bayubas de Abajo
Fuentearmegil	Fuentearmegil
Fuentelmonge	Fuentelmonge
Rollamienta	Rollamienta
Villar del Ala	Villar del Ala
Velilla de los Ajos	Velilla de los Ajos
Momblona	Momblona
Fresno de Caracena	Fresno de Caracena
Valdegeña	Valdegeña
Velamazán	Velamazán
Torlengua	Torlengua
Fuentecantos	Fuentecantos
Carrascosa de Abajo	Carrascosa de Abajo
Pinilla del Campo	Pinilla del Campo
Serón de Nágima	Serón de Nágima
Blacos	Blacos
Valdeavellano de Tera	Valdeavellano de Tera
Narros	Narros
Valdeprado	Valdeprado
Borjabad	Borjabad
Fuentelsaz de Soria	Fuentelsaz de Soria
San Leonardo de Yagüe	San Leonardo de Yagüe
Muriel de la Fuente	Muriel de la Fuente
Villar del Río	Villar del Río
Valderrodilla	Valderrodilla
Espejón	Espejón
Liceras	Liceras
Matalebreras	Matalebreras
Quintana Redonda	Quintana Redonda
Nafría de Ucero	Nafría de Ucero
Sotillo del Rincón	Sotillo del Rincón
Torrubia de Soria	Torrubia de Soria
Noviercas	Noviercas
Tajueco	Tajueco
Valdenebro	Valdenebro
Villaciervos	Villaciervos
Villanueva de Gormaz	Villanueva de Gormaz
Yelo	Yelo
Montenegro de Cameros	Montenegro de Cameros
Ucero	Ucero
Langa de Duero	Langa de Duero
Quiñonería	Quiñonería
Villar del Campo	Villar del Campo
Portillo de Soria	Portillo de Soria
Gormaz	Gormaz
Santa Cruz de Yanguas	Santa Cruz de Yanguas
Villaseca de Arciel	Villaseca de Arciel
Reznos	Reznos
Cueva de Ágreda	Cueva de Ágreda
Nolay	Nolay, Soria
Cirujales del Río	Cirujales del Río
Caracena	Caracena
Cubo de la Solana	Cubo de la Solana
Miño de San Esteban	Miño de San Esteban
Fuentestrún	Fuentestrún
Espeja de San Marcelino	Espeja de San Marcelino
Matamala de Almazán	Matamala de Almazán
La Póveda de Soria	La Póveda de Soria
Los Rábanos	Los Rábanos
Quintanas de Gormaz	Quintanas de Gormaz
Santa María de Huerta	Santa María de Huerta
San Pedro Manrique	San Pedro Manrique
Velilla de la Sierra	Velilla de la Sierra
Valdemaluque	Valdemaluque
San Felices	San Felices
Renieblas	Renieblas
Toro (Zamora)	Toro, Zamora
Morón de Almazán	Morón de Almazán
Los Villares de Soria	Los Villares de Soria
Torreblacos	Torreblacos
Vizmanos	Vizmanos
Tejado	Tejado
Retortillo de Soria	Retortillo de Soria
Herrera de Soria	Herrera de Soria
Deza	Deza, Soria
Monteagudo de las Vicarías	Monteagudo de las Vicarías
La Riba de Escalote	La Riba de Escalote
Montejo de Tiermes	Montejo de Tiermes
La Losilla	La Losilla
Recuerda	Recuerda
Tajahuerce	Tajahuerce
Santa María de las Hoyas	Santa María de las Hoyas
Fuentepinilla	Fuentepinilla
Golmayo	Golmayo
Rioseco de Soria	Rioseco de Soria
Gómara	Gómara, Soria
Cihuela	Cihuela
Trabadelo	Trabadelo
Caleruega	Caleruega
Hospital de Órbigo	Hospital de Órbigo
Villafranca del Bierzo	Villafranca del Bierzo
Cyclops (Marvel)	Cyclops (comics)
Pōmare II	Pōmare II
Pōmare I	Pōmare I
Pōmare III	Pōmare III
Peñausende	Peñausende
Villadangos del Páramo	Villadangos del Páramo
Vega de Valcarce	Vega de Valcarce
Valverde de la Virgen	Valverde de la Virgen
Barbalos	Barbalos
Susinos del Páramo (Burgos)	Susinos del Páramo
Seregélyes	Seregélyes
Quintanar de la Sierra (Burgos)	Quintanar de la Sierra
Olmedillo de Roa (Burgos)	Olmedillo de Roa
Valle de Valdebezana (Burgos)	Valle de Valdebezana
Calzada del Coto	Calzada del Coto
Valdesamario	Valdesamario
Fuentes de Oñoro	Fuentes de Oñoro
Val de San Lorenzo	Val de San Lorenzo
Baños de Valdearados (Burgos)	Baños de Valdearados
Insane Clown Posse	Insane Clown Posse
Losacino	Losacino
Villaquilambre	Villaquilambre
Pradoluengo (Burgos)	Pradoluengo
Aldearrodrigo	Aldearrodrigo
Padilla de Arriba (Burgos)	Padilla de Arriba
Trabazos	Trabazos
La Cueva de Roa	La Cueva de Roa
Valdemora	Valdemora
Tardajos (Burgos)	Tardajos
Sotragero (Burgos)	Sotragero
Hurones (Burgos)	Hurones
Velasquita Ramírez	Velasquita Ramírez
Villanueva de Teba (Burgos)	Villanueva de Teba
Condado de Treviño	Condado de Treviño
Castildelgado	Castildelgado
Cardeñuela Riopico	Cardeñuela Riopico
Villaveza del Agua	Villaveza del Agua
Alba de Tormes	Alba de Tormes
Espinosa del Camino (Burgos)	Espinosa del Camino
Villares de Órbigo	Villares de Órbigo
Orbaneja Riopico (Burgos)	Orbaneja Riopico
Pozuelo de Tábara	Pozuelo de Tábara
Palazuelos de Muñó (Burgos)	Palazuelos de Muñó
Nebreda (Burgos)	Nebreda
Benavente (Zamora)	Benavente, Zamora
Galbarros (Burgos)	Galbarros
Palacios de la Sierra (Burgos)	Palacios de la Sierra
Peñaranda de Duero (Burgos)	Peñaranda de Duero
Fuentesecas	Fuentesecas
Riego de la Vega	Riego de la Vega
Viloria de Rioja (Burgos)	Viloria de Rioja
Ferreras de Abajo	Ferreras de Abajo
Pinilla de los Barruecos (Burgos)	Pinilla de los Barruecos
Villambistia (Burgos)	Villambistia
Tosantos (Burgos)	Tosantos
Hornillos del Camino (Burgos)	Hornillos del Camino
Villafranca Montes de Oca (Burgos)	Villafranca Montes de Oca
Hontanas (Burgos)	Hontanas
Villahoz (Burgos)	Villahoz
Losacio	Losacio
Mecerreyes (Burgos)	Mecerreyes
Pardilla (Burgos)	Pardilla
Ledesma (Salamanca)	Ledesma, Salamanca
Villafáfila	Villafáfila
Figueruela de Arriba	Figueruela de Arriba
Hontoria del Pinar (Burgos)	Hontoria del Pinar
ʻAinaonao	Anteater
Haʻikū-Paʻuwela	Haiku-Pauwela, Hawaii
Benuza	Benuza
Rabanales	Rabanales
Milles de la Polvorosa	Milles de la Polvorosa
Celada del Camino	Celada del Camino
Forfoleda	Forfoleda
Castrillo Matajudíos	Castrillo Mota de Judíos
Villamanín	Villamanín
Vegalatrave	Vegalatrave
N. C. Wyeth	N. C. Wyeth
Molinos de Duero	Molinos de Duero
Vozmediano	Vozmediano
Hinojosa del Campo	Hinojosa del Campo
Mamo	Hawaii mamo
Garcihernández	Garcihernández
La Alberca	La Alberca
Redecilla del Camino (Burgos)	Redecilla del Camino
Lahaina	Lahaina, Hawaii
Kahului	Kahului, Hawaii
Rabé de las Calzadas (Burgos)	Rabé de las Calzadas
Villalbos	Villalbos
Kīhei	Kihei, Hawaii
Pelanekelina	Franklin (TV series)
Rello	Rello
Rebollar	Rebollar, Soria
Garray	Garray
Iglesias (Burgos)	Iglesias, Province of Burgos
Hua mele hapa ‘umikūmāono	Sixteenth note
Covarrubias	Covarrubias, Province of Burgos
Aldearrubia	Aldearrubia
Llano de Bureba (Burgos)	Llano de Bureba
Adrada de Haza (Burgos)	Adrada de Haza
Cerezo de Río Tirón	Cerezo de Río Tirón
Pele	Pele (deity)
Lōʻihi	Lōʻihi Seamount
Aiga-i-le-Tai	Aiga-i-le-Tai
Kartlis Deda	Kartlis Deda
Bembibre	Bembibre
Santovenia	Santovenia
Wikipedia:Nohona kuhina	Wikipedia:Embassy
Hawaiʻi Aloha	Hawaii Aloha
Kumulipo	Kumulipo
Aloha ʻOe	Aloha ʻOe
Letícia Sabatella	Letícia Sabatella
Poʻe Hawaiʻi	Native Hawaiians
Halemaʻumaʻu	Halemaumau Crater
Manuae	Manuae (Society Islands)
Holoikauaua	Pearl and Hermes Atoll
Alfoz de Lloredo	Alfoz de Lloredo
Cármenes	Cármenes
Ampuero	Ampuero
Palacios del Sil	Palacios del Sil
Cabrillanes	Cabrillanes
Briviesca (Burgos)	Briviesca
Iznalloz	Iznalloz
Māhele:Kelemānia	Category:Germany
Māhele:ʻAmelika Hui Pū ʻia	Category:United States
Māhele:Sepania	Category:Spain
Māhele:Mekiko	Category:Mexico
Gallegos del Pan	Gallegos del Pan
La Bañeza	La Bañeza
Carracedelo	Carracedelo
Carucedo	Carucedo
Corullón	Corullón
Castrocontrigo	Castrocontrigo
Fabero	Fabero
Corrales	Los Corrales de Buelna
Anievas	Anievas
Anguix (Burgos)	Anguix
Arauzo de Miel (Burgos)	Arauzo de Miel
Arauzo de Salce (Burgos)	Arauzo de Salce
Brazacorta (Burgos)	Brazacorta
Aguilar de Bureba (Burgos)	Aguilar de Bureba
Bascuñana (Burgos)	Bascuñana
Altable (Burgos)	Altable
Barbadillo del Pez (Burgos)	Barbadillo del Pez
Bahabón de Esgueva (Burgos)	Bahabón de Esgueva
Alfoz de Quintanadueñas (Burgos)	Alfoz de Quintanadueñas
Barrios de Colina (Burgos)	Barrios de Colina
Berberana (Burgos)	Berberana
Berlangas de Roa (Burgos)	Berlangas de Roa
Aguas Cándidas (Burgos)	Aguas Cándidas
Belbimbre (Burgos)	Belbimbre
Montorio (Burgos)	Montorio, Province of Burgos
Māhele:Pōlani	Category:Poland
Māhele:Wiekanama	Category:Vietnam
Māhele:Hōʻike honua	Category:Geography
Māhele:Akeakamai	Category:Science
Kāneʻohe	Kaneohe, Hawaii
Waiʻaleʻale	Mount Waialeale
Care Bears	Care Bears
Hanauma	Hanauma Bay
Guijuelo	Guijuelo
Vegas del Condado	Vegas del Condado
Borrenes	Borrenes
Santovenia de la Valdoncina	Santovenia de la Valdoncina
La Pola de Gordón	La Pola de Gordón
Villablino	Villablino
Torre del Bierzo	Torre del Bierzo
Vega de Espinareda	Vega de Espinareda
Barjas	Barjas
Cistierna	Cistierna
Babilafuente	Babilafuente
Cereceda de la Sierra	Cereceda de la Sierra
Cardeñajimeno	Cardeñajimeno
Castil de Peones	Castil de Peones
Jurisdicción de Lara (Burgos)	Jurisdicción de Lara
Arganza (León)	Arganza
Valdevimbre	Valdevimbre
Villaturiel	Villaturiel
Valdepolo	Valdepolo
Gumiel de Mercado (Burgos)	Gumiel de Mercado
Oquillas (Burgos)	Oquillas
Villamañán	Villamañán
Puente de Domingo Flórez	Puente de Domingo Flórez
Olmillos de Muñó (Burgos)	Olmillos de Muñó
Encío (Burgos)	Encío
Ibeas de Juarros (Burgos)	Ibeas de Juarros
Santibáñez del Val (Burgos)	Santibáñez del Val
Urdiales del Páramo	Urdiales del Páramo
Sena de Luna	Sena de Luna
Oña (Burgos)	Oña
Grisaleña (Burgos)	Grisaleña
Coruña del Conde	Coruña del Conde
Zazuar (Burgos)	Zazuar
Buniel (Burgos)	Buniel
Arauzo de Torre (Burgos)	Arauzo de Torre
Berzosa de Bureba (Burgos)	Berzosa de Bureba
Alfoz de Santa Gadea (Burgos)	Alfoz de Santa Gadea
Barbadillo de Herreros (Burgos)	Barbadillo de Herreros
Albillos (Burgos)	Albillos
Arenillas de Riopisuerga (Burgos)	Arenillas de Riopisuerga
Barbadillo del Mercado	Barbadillo del Mercado
Arlanzón (Burgos)	Arlanzón, Province of Burgos
Medina de Pomar (Burgos)	Medina de Pomar
Arandilla (Burgos)	Arandilla
Bozoó (Burgos)	Bozoó
Fuentelisendo (Burgos)	Fuentelisendo
Zarzosa de Río Pisuerga (Burgos)	Zarzosa de Río Pisuerga
Alcocero de Mola (Burgos)	Alcocero de Mola
Valle de Mena (Burgos)	Valle de Mena
Zael (Burgos)	Zael, Province of Burgos
Ameyugo (Burgos)	Ameyugo
Lerma (Burgos)	Lerma, Province of Burgos
Villaquejida	Villaquejida
Sariegos	Sariegos
Corbillos de los Oteros	Corbillos de los Oteros
Vega de Infanzones	Vega de Infanzones
Peranzanes	Peranzanes
Sabero	Sabero
Candín (León)	Candín
Valderrueda	Valderrueda
Puebla de Lillo	Puebla de Lillo
Soto y Amío	Soto y Amío
Laguna de Negrillos	Laguna de Negrillos
Villarejo de Órbigo	Villarejo de Órbigo
La Vecilla	La Vecilla
San Andrés del Rabanedo	San Andrés del Rabanedo
Villazala	Villazala
Villamontán de la Valduerna	Villamontán de la Valduerna
Nava de Roa (Burgos)	Nava de Roa
Villasabariego	Villasabariego
Oencia	Oencia
Encinedo	Encinedo
Hiʻiaka	Hiʻiaka
Zuñeda (Burgos)	Zuñeda
Valdeande (Burgos)	Valdeande
Destriana	Destriana
Villagatón	Villagatón
Arija (Burgos)	Arija
Busto de Bureba (Burgos)	Busto de Bureba
Abezames	Abezames
Alcañices	Alcañices
Laguna Dalga	Laguna Dalga
Alaraz	Alaraz
Brincones	Brincones
Aldeadávila de la Ribera	Aldeadávila de la Ribera
Castellanos de Castro	Castellanos de Castro
Cascajares de la Sierra	Cascajares de la Sierra
Iglesiarrubia (Burgos)	Iglesiarrubia
Castrillo de la Vega	Castrillo de la Vega
Sasamón (Burgos)	Sasamón
Torrepadre (Burgos)	Torrepadre
Sotillo de la Ribera (Burgos)	Sotillo de la Ribera
Torrecilla del Monte (Burgos)	Torrecilla del Monte
Linares de Riofrío	Linares de Riofrío
Ahigal de Villarino	Ahigal de Villarino
Gumiel de Izán (Burgos)	Gumiel de Izán
Cabrerizos	Cabrerizos
Cantalapiedra	Cantalapiedra
Ahigal de los Aceiteros	Ahigal de los Aceiteros
Barceo	Barceo
Castellanos de Moriscos	Castellanos de Moriscos
Casafranca	Casafranca
Vizcaínos (Burgos)	Vizcaínos
Casillas de Flores	Casillas de Flores
Los Balbases (Burgos)	Los Balbases
Santibáñez de Esgueva (Burgos)	Santibáñez de Esgueva
San Martín de Rubiales (Burgos)	San Martín de Rubiales
Tórtoles de Esgueva (Burgos)	Tórtoles de Esgueva
Villaescusa de Roa (Burgos)	Villaescusa de Roa
Mamolar (Burgos)	Mamolar
Moradillo de Roa (Burgos)	Moradillo de Roa
Mambrilla de Castrejón (Burgos)	Mambrilla de Castrejón
Pedrosa de Duero (Burgos)	Pedrosa de Duero
Quintanilla del Coco (Burgos)	Quintanilla del Coco
Pinilla de los Moros (Burgos)	Pinilla de los Moros
Valle de Tobalina (Burgos)	Valle de Tobalina
Villanueva de Carazo (Burgos)	Villanueva de Carazo
Quemada (Burgos)	Quemada
Torresandino (Burgos)	Torresandino
Villalba de Duero (Burgos)	Villalba de Duero
Rubena (Burgos)	Rubena
Valluércanes (Burgos)	Valluércanes
Villadiego (Burgos)	Villadiego
Merindad de Río Ubierna (Burgos)	Merindad de Río Ubierna
Mazuela (Burgos)	Mazuela
Valle de Zamanzas (Burgos)	Valle de Zamanzas
Quintana del Pidio (Burgos)	Quintana del Pidio
Vadocondes (Burgos)	Vadocondes
Fuentelcésped (Burgos)	Fuentelcésped
Ciadoncha	Ciadoncha
Merindad de Montija (Burgos)	Merindad de Montija
Pancorbo (Burgos)	Pancorbo
Monterrubio de la Demanda (Burgos)	Monterrubio de la Demanda
Fuentespina (Burgos)	Fuentespina
Cillaperlata	Cillaperlata
Fontioso (Burgos)	Fontioso
La Sequera de Haza (Burgos)	La Sequera de Haza
La Horra (Burgos)	La Horra
Cilleruelo de Arriba	Cilleruelo de Arriba
Jurisdicción de San Zadornil (Burgos)	Jurisdicción de San Zadornil
Cuevas de San Clemente	Cuevas de San Clemente
Fuentemolinos (Burgos)	Fuentemolinos
Hontangas (Burgos)	Hontangas
Hoyales de Roa (Burgos)	Hoyales de Roa
Campolara	Campolara
Carrias	Carrias
Canicosa de la Sierra	Canicosa de la Sierra
Cerralbo	Cerralbo
Cabezón de la Sierra	Cabezón de la Sierra
Cabañes de Esgueva	Cabañes de Esgueva
Cardeñadijo	Cardeñadijo
Castrillo de Riopisuerga	Castrillo de Riopisuerga
Milagros (Burgos)	Milagros, Province of Burgos
La Puebla de Arganzón (Burgos)	La Puebla de Arganzón
Agallas	Agallas
Abusejo	Abusejo
Posada de Valdeón	Posada de Valdeón
Valderrey	Valderrey
Joarilla de las Matas	Joarilla de las Matas
Neila (Burgos)	Neila
Santiago Millas	Santiago Millas
Turcia	Turcia
Prioro	Prioro
Valdelugueros	Valdelugueros
Santas Martas	Santas Martas
Vegaquemada	Vegaquemada
Pobladura de Pelayo García	Pobladura de Pelayo García
Navas de Bureba (Burgos)	Navas de Bureba
Vegacervera	Vegacervera
San Adrián del Valle	San Adrián del Valle
Valdefuentes del Páramo	Valdefuentes del Páramo
Jaramillo Quemado (Burgos)	Jaramillo Quemado
Campillo de Aranda	Campillo de Aranda
Jaramillo de la Fuente (Burgos)	Jaramillo de la Fuente
Carcedo de Bureba	Carcedo de Bureba
La Gallega (Burgos)	La Gallega
Cebrecos	Cebrecos
La Fuente de San Esteban	La Fuente de San Esteban
Aldeanueva de Figueroa	Aldeanueva de Figueroa
Cerezal de Peñahorcada	Cerezal de Peñahorcada
Cabeza del Caballo	Cabeza del Caballo
Lumbrales	Lumbrales
Villabraz	Villabraz
Villamejil	Villamejil
Villaornate y Castro	Villaornate y Castro
Valverde-Enrique	Valverde-Enrique
Villaobispo de Otero	Villaobispo de Otero
Villazanzo de Valderaduey	Villazanzo de Valderaduey
Villanueva de las Manzanas	Villanueva de las Manzanas
Villamandos	Villamandos
Villamol	Villamol
Villaselán	Villaselán
Villamoratiel de las Matas	Villamoratiel de las Matas
Toral de los Guzmanes	Toral de los Guzmanes
Bañobárez	Bañobárez
Barruecopardo	Barruecopardo
Carrascal del Obispo	Carrascal del Obispo
Castillejo de Martín Viejo	Castillejo de Martín Viejo
Fuenteguinaldo	Fuenteguinaldo
Iruelos	Iruelos
Tamames	Tamames
Bóveda del Río Almar	Bóveda del Río Almar
Doñinos de Ledesma	Doñinos de Ledesma
Encina de San Silvestre	Encina de San Silvestre
Canillas de Abajo	Canillas de Abajo
Castellanos de Villiquera	Castellanos de Villiquera
Carpio de Azaba	Carpio de Azaba
Doñinos de Salamanca	Doñinos de Salamanca
Cantaracillo	Cantaracillo
Las Casas del Conde	Las Casas del Conde
Aldeaseca de la Frontera	Aldeaseca de la Frontera
Castraz	Castraz
Cepeda (Salamanca)	Cepeda, Salamanca
El Tornadizo	El Tornadizo
Aldeaseca de Alba	Aldeaseca de Alba
Navamorales	Navamorales
El Cabaco	El Cabaco
Aldeanueva de la Sierra	Aldeanueva de la Sierra
Cipérez	Cipérez
Cantalpino	Cantalpino
Colmenar de Montemayor	Colmenar de Montemayor
Espadaña (Salamanca)	Espadaña
Cespedosa de Tormes	Cespedosa de Tormes
Carbajosa de la Sagrada	Carbajosa de la Sagrada
Cabrillas	Cabrillas
Berrocal de Huebra	Berrocal de Huebra
Calvarrasa de Abajo	Calvarrasa de Abajo
Cilleros de la Bastida	Cilleros de la Bastida
Sotresgudo (Burgos)	Sotresgudo
Arapiles	Arapiles, Salamanca
Benavides	Benavides, León
Tordómar (Burgos)	Tordómar
Torrelara (Burgos)	Torrelara
San Millán de Lara (Burgos)	San Millán de Lara
Sordillos (Burgos)	Sordillos
Santa María del Mercadillo (Burgos)	Santa María del Mercadillo
Santa Cruz de la Salceda (Burgos)	Santa Cruz de la Salceda
Santa Gadea del Cid (Burgos)	Santa Gadea del Cid
Tamarón (Burgos)	Tamarón
San Mamés de Burgos (Burgos)	San Mamés de Burgos
Santa María del Campo (Burgos)	Santa María del Campo
San Vicente del Valle (Burgos)	San Vicente del Valle
Sarracín (Burgos)	Sarracín
Salinillas de Bureba (Burgos)	Salinillas de Bureba
Villazopeque (Burgos)	Villazopeque
Vilviestre del Pinar (Burgos)	Vilviestre del Pinar
Saldaña de Burgos (Burgos)	Saldaña de Burgos
Tejada (Burgos)	Tejada, Province of Burgos
Tobar (Burgos)	Tobar
Santa Olalla de Bureba (Burgos)	Santa Olalla de Bureba
San Adrián de Juarros (Burgos)	San Adrián de Juarros
Santa María del Invierno (Burgos)	Santa María del Invierno
Tinieblas de la Sierra (Burgos)	Tinieblas de la Sierra
Villaquirán de la Puebla (Burgos)	Villaquirán de la Puebla
Villalbilla de Gumiel (Burgos)	Villalbilla de Gumiel
Villanueva de Gumiel (Burgos)	Villanueva de Gumiel
Villaverde del Monte (Burgos)	Villaverde del Monte
Villaescusa la Sombría (Burgos)	Villaescusa la Sombría
Villayerno Morquillas (Burgos)	Villayerno Morquillas
Villegas (Burgos)	Villegas, Province of Burgos
Vileña (Burgos)	Vileña
Rezmondo (Burgos)	Rezmondo
Villafruela (Burgos)	Villafruela
Villariezo (Burgos)	Villariezo
Villagalijo (Burgos)	Villagalijo
Rublacedo de Abajo (Burgos)	Rublacedo de Abajo
Villamayor de Treviño (Burgos)	Villamayor de Treviño
Royuela de Río Franco (Burgos)	Royuela de Río Franco
Retuerta (Burgos)	Retuerta
Villaldemiro (Burgos)	Villaldemiro
Villaverde-Mogina (Burgos)	Villaverde-Mogina
Revillarruz (Burgos)	Revillarruz
Villamayor de los Montes (Burgos)	Villamayor de los Montes
Villamedianilla (Burgos)	Villamedianilla
Villalmanzo (Burgos)	Villalmanzo
Villaespasa (Burgos)	Villaespasa
Valles de Palenzuela (Burgos)	Valles de Palenzuela
Quintanaélez (Burgos)	Quintanaélez
Vallejera (Burgos)	Vallejera
Vallarta de Bureba (Burgos)	Vallarta de Bureba
Redecilla del Campo (Burgos)	Redecilla del Campo
Quintanabureba (Burgos)	Quintanabureba
Quintanaortuño (Burgos)	Quintanaortuño
Quintanapalla (Burgos)	Quintanapalla
Valle de Losa (Burgos)	Valle de Losa
Regumiel de la Sierra (Burgos)	Regumiel de la Sierra
Quintanilla Vivar (Burgos)	Quintanilla Vivar
Poza de la Sal (Burgos)	Poza de la Sal
Quintanilla del Agua y Tordueles (Burgos)	Quintanilla del Agua y Tordueles
Quintanilla de la Mata (Burgos)	Quintanilla de la Mata
Fuentenebro (Burgos)	Fuentenebro
La Revilla y Ahedo (Burgos)	La Revilla y Ahedo
Hacinas (Burgos)	Hacinas
Prádanos de Bureba (Burgos)	Prádanos de Bureba
Fresno de Rodilla (Burgos)	Fresno de Rodilla
La Vid	La Vid y Barrios
Junta de Villalba de Losa (Burgos)	Junta de Villalba de Losa
Hortigüela (Burgos)	Hortigüela
Villangómez (Burgos)	Villangómez
Madrigalejo del Monte (Burgos)	Madrigalejo del Monte
Mahamud (Burgos)	Mahamud
Presencio (Burgos)	Presencio
Cilleruelo de Abajo	Cilleruelo de Abajo
Madrigal del Monte (Burgos)	Madrigal del Monte
Manciles (Burgos)	Manciles
Fuentebureba (Burgos)	Fuentebureba
Padrones de Bureba (Burgos)	Padrones de Bureba
Melgar de Fernamental (Burgos)	Melgar de Fernamental
Ibrillos (Burgos)	Ibrillos
La Vid de Bureba (Burgos)	La Vid de Bureba
Palazuelos de la Sierra (Burgos)	Palazuelos de la Sierra
Merindad de Sotoscueva (Burgos)	Merindad de Sotoscueva
Castrillo del Val	Castrillo del Val
Valdorros (Burgos)	Valdorros
Los Ausines (Burgos)	Los Ausines
Merindad de Cuesta-Urria (Burgos)	Merindad de Cuesta Urria
Los Barrios de Bureba (Burgos)	Los Barrios de Bureba
Valle de Manzanedo (Burgos)	Valle de Manzanedo
Hontoria de Valdearados (Burgos)	Hontoria de Valdearados
Fuentecén (Burgos)	Fuentecén
Miraveche (Burgos)	Miraveche
Fresnillo de las Dueñas (Burgos)	Fresnillo de las Dueñas
Piérnigas (Burgos)	Piérnigas
Ciruelos de Cervera	Ciruelos de Cervera
Pinilla Trasmonte (Burgos)	Pinilla Trasmonte
Valdezate (Burgos)	Valdezate
Trespaderne (Burgos)	Trespaderne
Pineda Trasmonte (Burgos)	Pineda Trasmonte
Peral de Arlanza (Burgos)	Peral de Arlanza
Puentedura (Burgos)	Puentedura
Cogollos	Cogollos
Cerratón de Juarros	Cerratón de Juarros
Mambrillas de Lara (Burgos)	Mambrillas de Lara
Castrillo de la Reina	Castrillo de la Reina
Merindad de Valdivielso (Burgos)	Merindad de Valdivielso
Modúbar de la Emparedada (Burgos)	Modúbar de la Emparedada
Huerta de Rey	Huerta de Rey
Cascajares de Bureba	Cascajares de Bureba
Cayuela	Cayuela
Villalonso	Villalonso
Moraleja del Vino	Moraleja del Vino
Castrogonzalo	Castrogonzalo
El Perdigón	El Perdigón
Santa Cristina de la Polvorosa	Santa Cristina de la Polvorosa
Lubián	Lubián
Valdefinjas	Valdefinjas
Morales del Vino	Morales del Vino
Matilla la Seca	Matilla la Seca
Navasfrías	Navasfrías
Coreses	Coreses
Villalpando	Villalpando
Hermisende	Hermisende
Pobladura de Valderaduey	Pobladura de Valderaduey
Villaralbo	Villaralbo
Galende	Galende
Puebla de Sanabria	Puebla de Sanabria
Roales	Roales
Mayalde	Mayalde
Robleda	Robleda
Granucillo	Granucillo
Bogajo	Bogajo
Tarazona de Guareña	Tarazona de Guareña
Gejuelo del Barro	Gejuelo del Barro
Nava de Francia	Nava de Francia
Tardáguila	Tardáguila
Encinasola de los Comendadores	Encinasola de los Comendadores
Tordillos	Tordillos
Nava de Sotrobal	Nava de Sotrobal
Yecla de Yeltes	Yecla de Yeltes
Navalmoral de Béjar	Navalmoral de Béjar
Trabanca	Trabanca
Garcirrey	Garcirrey
Navarredonda de la Rinconada	Navarredonda de la Rinconada
Tejeda y Segoyuela	Tejeda y Segoyuela
Escurial de la Sierra	Escurial de la Sierra
El Tejado	El Tejado
Barbadillo	Barbadillo
Carrascal de Barregas	Carrascal de Barregas
Campillo de Azaba	Campillo de Azaba
Aldeacipreste	Aldeacipreste
Ejeme	Ejeme
Calzada de Don Diego	Calzada de Don Diego
Alconada	Alconada
Añover de Tormes	Añover de Tormes
Aldeavieja de Tormes	Aldeavieja de Tormes
Torresmenudas	Torresmenudas
Espino de la Orbada	Espino de la Orbada
La Redonda	La Redonda
Moncalvillo (Burgos)	Moncalvillo
Pedralba de la Pradería	Pedralba de la Pradería
Dios le Guarde	Dios le Guarde
Galisancho	Galisancho
Terradillos	Terradillos
Fuenterroble de Salvatierra	Fuenterroble de Salvatierra
Almendra (Salamanca)	Almendra, Salamanca
Estépar (Burgos)	Estépar
Carrizo	Carrizo de la Ribera
Vallecillo	Vallecillo, León
Espinosa de Cervera (Burgos)	Espinosa de Cervera
Úrbel del Castillo (Burgos)	Úrbel del Castillo
Grijalba (Burgos)	Grijalba
Benegiles	Benegiles
Almaraz de Duero	Almaraz de Duero
Arcenillas	Arcenillas
Carbajales de Alba	Carbajales de Alba
Argañín	Argañín
Arrabalde	Arrabalde
Algodre	Algodre
Bermillo de Sayago	Bermillo de Sayago
Arcos de la Polvorosa	Arcos de la Polvorosa
Alcubilla de Nogales	Alcubilla de Nogales
Andavías	Andavías
Aldeatejada	Aldeatejada
Balboa (León)	Balboa, León
Buenamadre	Buenamadre
Alba de Yeltes	Alba de Yeltes
Coca de Alba	Coca de Alba
Aldehuela de la Bóveda	Aldehuela de la Bóveda
Olmedo de Camaces	Olmedo de Camaces
Gomecello	Gomecello
Cordovilla (Salamanca)	Cordovilla
Herguijuela del Campo	Herguijuela del Campo
Fuenteliante	Fuenteliante
Herguijuela de Ciudad Rodrigo	Herguijuela de Ciudad Rodrigo
Herguijuela de la Sierra	Herguijuela de la Sierra
Armenteros	Armenteros
Encinas de Arriba	Encinas de Arriba
Hinojosa de Duero	Hinojosa de Duero
Encinas de Abajo	Encinas de Abajo
Cabezabellosa de la Calzada	Cabezabellosa de la Calzada
Cristóbal de la Sierra (Salamanca)	Cristóbal de la Sierra
La Orbada	La Orbada
La Rinconada de la Sierra	La Rinconada de la Sierra
Chagarcía Medianero	Chagarcía Medianero
Berrocal de Salvatierra	Berrocal de Salvatierra
Manganeses de la Polvorosa	Manganeses de la Polvorosa
Villavendimio	Villavendimio
Muelas del Pan	Muelas del Pan
Fuentes de Ropel	Fuentes de Ropel
Videmala	Videmala
Vezdemarbán	Vezdemarbán
Maire de Castroponce	Maire de Castroponce
Cerecinos del Carrizal	Cerecinos del Carrizal
Villanueva de Campeán	Villanueva de Campeán
Brime de Urz	Brime de Urz
Cabañas de Sayago	Cabañas de Sayago
Pozoantiguo	Pozoantiguo
Fresno de la Ribera	Fresno de la Ribera
Bustillo del Oro	Bustillo del Oro
El Piñero	El Piñero
Melgar de Tera	Melgar de Tera
Pinilla de Toro	Pinilla de Toro
Sanzoles	Sanzoles
Madridanos	Madridanos
Monfarracinos	Monfarracinos
Fresno de la Polvorosa	Fresno de la Polvorosa
Entrala	Entrala
Hāna	Hana, Hawaii
Jambrina	Jambrina
Villaseco del Pan	Villaseco del Pan
Castronuevo	Castronuevo
Fuente Encalada	Fuente Encalada
Torres del Carrizal	Torres del Carrizal
Villardondiego	Villardondiego
Calzadilla de Tera	Calzadilla de Tera
Cubo de Benavente	Cubo de Benavente
Molezuelas de la Carballeda	Molezuelas de la Carballeda
Santibáñez de Vidriales	Santibáñez de Vidriales
Fonfría (Zamora)	Fonfría, Zamora
San Cristóbal de Entreviñas	San Cristóbal de Entreviñas
Villar de Fallaves	Villar de Fallaves
Santa María de Valverde	Santa María de Valverde
Riofrío de Aliste	Riofrío de Aliste
Kekaha	Kekaha, Hawaii
Revilla del Campo (Burgos)	Revilla del Campo
Humada (Burgos)	Humada
Pampliega (Burgos)	Pampliega
Padilla de Abajo (Burgos)	Padilla de Abajo
Valle de las Navas (Burgos)	Valle de las Navas
Valle de Santibáñez (Burgos)	Valle de Santibáñez
Santa María Rivarredonda (Burgos)	Santa María Ribarredonda
Valle de Oca (Burgos)	Valle de Oca
Villaquirán de los Infantes (Burgos)	Villaquirán de los Infantes
Valle de Valdelucio (Burgos)	Valle de Valdelucio
Rebolledo de la Torre (Burgos)	Rebolledo de la Torre
Villoruebo (Burgos)	Villoruebo
Cubo de Bureba	Cubo de Bureba
Cubillos	Cubillos
Viñas	Viñas
Frías (Burgos)	Frías, Province of Burgos
Villasur de Herreros (Burgos)	Villasur de Herreros
Jonah Kūhiō Kalanianaʻole	Jonah Kūhiō Kalanianaʻole
Villasandino (Burgos)	Villasandino
Santa Cruz del Valle Urbión (Burgos)	Santa Cruz del Valle Urbión
Revilla Vallejera (Burgos)	Revilla Vallejera
Rábanos (Burgos)	Rábanos
Quintanilla San García (Burgos)	Quintanilla San García
Torregalindo (Burgos)	Torregalindo
Pineda de la Sierra (Burgos)	Pineda de la Sierra
Pedrosa de Río Úrbel (Burgos)	Pedrosa de Río Úrbel
Quintanavides (Burgos)	Quintanavides
Pedrosa del Páramo (Burgos)	Pedrosa del Páramo
Salas de Bureba (Burgos)	Salas de Bureba
Reinoso (Burgos)	Reinoso
Fresno de Río Tirón (Burgos)	Fresno de Río Tirón
Hontoria de la Cantera (Burgos)	Hontoria de la Cantera
Las Hormazas (Burgos)	Las Hormazas
Las Quintanillas (Burgos)	Las Quintanillas
Frandovínez (Burgos)	Frandovínez
Horcajo de Montemayor	Horcajo de Montemayor
Luakini ma Lā‘ie, Hawai‘i	Laie Hawaii Temple
Rosinos de la Requejada	Rosinos de la Requejada
Villalcampo	Villalcampo
Quintanilla del Olmo	Quintanilla del Olmo
Trefacio	Trefacio
Palacios del Pan	Palacios del Pan
Venialbo	Venialbo
Bretó	Bretó
Santa Clara de Avedillo	Santa Clara de Avedillo
Otero de Bodas	Otero de Bodas
Ferreras de Arriba	Ferreras de Arriba
Peleagonzalo	Peleagonzalo
Pías	Pías
Tábara	Tábara
Fuentespreadas	Fuentespreadas
Villanueva del Campo	Villanueva del Campo
Robleda-Cervantes	Robleda-Cervantes
Valcabado	Valcabado
Friera de Valverde	Friera de Valverde
Olmillos de Castro	Olmillos de Castro
Riaño	Riaño, León
Villadecanes	Toral de los Vados
Matilla de Arzón	Matilla de Arzón
La Torre del Valle	La Torre del Valle
Aldehuela de Yeltes	Aldehuela de Yeltes
Mombuey	Mombuey
Fresneña (Burgos)	Fresneña
Monasterio de Rodilla (Burgos)	Monasterio de Rodilla
Cuelgamures	Cuelgamures
Coomonte	Coomonte
Huerta de Arriba	Huerta de Arriba
La Hiniesta	La Hiniesta
Fuentesaúco	Fuentesaúco
Arquillinos	Arquillinos
Alfaraz de Sayago	Alfaraz de Sayago
Almeida de Sayago	Almeida de Sayago
Ayoó de Vidriales	Ayoó de Vidriales
Molacillos	Molacillos
Huérmeces (Burgos)	Huérmeces
Brime de Sog	Brime de Sog
Anaya de Alba	Anaya de Alba
Bretocino	Bretocino
Cubillo del Campo	Cubillo del Campo
Montamarta	Montamarta
Micereces de Tera	Micereces de Tera
Moreruela de los Infanzones	Moreruela de los Infanzones
Casaseca de las Chanas	Casaseca de las Chanas
Luelmo	Luelmo
Santo Domingo de Silos (Burgos)	Santo Domingo de Silos
San Vicente de la Cabeza	San Vicente de la Cabeza
San Miguel de la Ribera	San Miguel de la Ribera
Barcial del Barco	Barcial del Barco
Santa María de la Vega	Santa María de la Vega
Torregamones	Torregamones
San Pedro de la Nave-Almendra	San Pedro de la Nave-Almendra
San Pedro de Ceque	San Pedro de Ceque
Santibáñez de Tera	Santibáñez de Tera
Aspariegos	Aspariegos
Porto (Zamora)	Porto de Sanabria
San Vitero	San Vitero
Quintanilla de Urz	Quintanilla de Urz
Salce	Salce
Quiruelas de Vidriales	Quiruelas de Vidriales
Pueblica de Valverde	Pueblica de Valverde
San Agustín del Pozo	San Agustín del Pozo
Villabuena del Puente	Villabuena del Puente
San Cebrián de Castro	San Cebrián de Castro
Tabera de Abajo	Tabera de Abajo
Samir de los Caños	Samir de los Caños
Tenebrón	Tenebrón
Villamayor de Campos	Villamayor de Campos
Vadillo de la Guareña	Vadillo de la Guareña
Tapioles	Tapioles
Santa Colomba de las Monjas	Santa Colomba de las Monjas
Vega de Tera	Vega de Tera
Valdescorriel	Valdescorriel
Santa Croya de Tera	Santa Croya de Tera
Pobladura del Valle	Pobladura del Valle
Villadepera	Villadepera
Villarrín de Campos	Villarrín de Campos
Zamarra	Zamarra
San Esteban del Molar	San Esteban del Molar
Revellinos	Revellinos
Villárdiga	Villárdiga
Vallesa de la Guareña	Vallesa de la Guareña
San Miguel del Valle	San Miguel del Valle
Robliza de Cojos	Robliza de Cojos
Rucandio (Burgos)	Rucandio
Fresnedoso	Fresnedoso
Nava de Béjar	Nava de Béjar
Narros de Matalayegua	Narros de Matalayegua
Fresno Alhándiga	Fresno Alhándiga
Florida de Liébana	Florida de Liébana
Navales	Navales
Navacarros	Navacarros
La Bastida	La Bastida
La Fregeneda	La Fregeneda
Muga de Sayago	Muga de Sayago
Cobreros	Cobreros
Villar del Buey	Villar del Buey
El Pego	El Pego
Moraleja de Sayago	Moraleja de Sayago
Villageriz	Villageriz
Perilla de Castro	Perilla de Castro
Mahide	Mahide
Moralina	Moralina
Pajares de la Lampreana	Pajares de la Lampreana
Cerecinos de Campos	Cerecinos de Campos
Morales de Valverde	Morales de Valverde
Fresno de Sayago	Fresno de Sayago
Villalba de la Lampreana	Villalba de la Lampreana
Villamor de los Escuderos	Villamor de los Escuderos
Vega de Villalobos	Vega de Villalobos
Moral de Sayago	Moral de Sayago
Rionegro del Puente	Rionegro del Puente
Pereruela	Pereruela
Muelas de los Caballeros	Muelas de los Caballeros
Morales de Rey	Morales de Rey
Fuentelapeña	Fuentelapeña
Piedrahita de Castro	Piedrahita de Castro
Roelos	Roelos de Sayago
Espadañedo	Espadañedo
Villabrázaro	Villabrázaro
Villardeciervos	Villardeciervos
Uña de Quintana	Uña de Quintana
Prado (Zamora)	Prado, Spain
Cotanes del Monte	Cotanes del Monte
Navianos de Valverde	Navianos de Valverde
Palacios de Sanabria	Palacios de Sanabria
Cernadilla	Cernadilla
Santa Cecilia (Burgos)	Santa Cecilia
Larrodrigo	Larrodrigo
La Bóveda de Toro	La Bóveda de Toro
Manganeses de la Lampreana	Manganeses de la Lampreana
Endrinal (Salamanca)	Endrinal
Espeja	Espeja
Rágama	Rágama
El Cerro (Salamanca)	El Cerro
El Cubo del Vino	El Cubo de Tierra del Vino
Truchas	Truchas, León
Villanueva de Azoague	Villanueva de Azoague
La Alameda de Gardón	La Alameda de Gardón
La Alamedilla	La Alamedilla
Galindo y Perahuy	Galindo y Perahuy
La Cabeza de Béjar	La Cabeza de Béjar
Galinduste	Galinduste
Arcos (Burgos)	Arcos de la Llana
Justel	Justel, Zamora
Ledrada	Ledrada
La Hoya (Salamanca)	La Hoya, Salamanca
Guarrate	Guarrate
Gallegos de Argañán	Gallegos de Argañán
La Alberguería de Argañán	La Alberguería de Argañán
Horcajo Medianero	Horcajo Medianero
Arcediano	Arcediano
Candelario	Candelario
Guadramiro	Guadramiro
Boada	Boada, Salamanca
Manzanal de Arriba	Manzanal de Arriba
Gallegos de Solmirón	Gallegos de Solmirón
Juzbado	Juzbado
Golpejas	Golpejas
La Tala	La Tala
Gamones	Gamones
Granja de Moreruela	Granja de Moreruela
Asturianos	Asturianos
Argujillo	Argujillo
Castroverde de Campos	Castroverde de Campos
Castrillo de la Guareña	Castrillo de la Guareña
Carbellino	Carbellino
Los Altos (Burgos)	Los Altos, Province of Burgos
Lehua	Lehua
Hanamāʻulu	Hanamaulu, Hawaii
Pīnanaka	Areca nut
Kapalua	Kapalua, Hawaii
Hauʻula	Hauʻula, Hawaii
Waimanalo	Waimānalo, Hawaii
ʻŌmaʻo	Omao, Hawaii
Kīlauea (Kauaʻi)	Kilauea, Hawaii
Māʻalaea	Maalaea, Hawaii
Retortillo (Salamanca)	Retortillo
El Arco	El Arco, Salamanca
Villalobos	Villalobos (Spain)
Villaveza de Valverde	Villaveza de Valverde
Quintanilla del Monte	Quintanilla del Monte
Rábano de Aliste	Rábano de Aliste
Ferreruela	Ferreruela
Villanueva de las Peras	Villanueva de las Peras
San Justo (Zamora)	San Justo, Zamora
Villaferrueña	Villaferrueña
Fariza	Fariza
Villaescusa (Zamora)	Villaescusa, Zamora
Malva (Zamora)	Malva, Zamora
Cantagallo	Cantagallo, Spain
Kaumakani	Kaumakani, Hawaii
Pukalani	Pukalani, Hawaii
Puhi	Puhi, Hawaii
Páginas da Vida	Páginas da Vida
Māhele:Disambig	Category:Disambiguation pages
Valle de Valdelaguna (Burgos)	Valle de Valdelaguna
San Juan del Monte (Burgos)	San Juan del Monte, Province of Burgos
Haza (Burgos)	Haza, Province of Burgos
Beleña	Beleña
Cavia (Burgos)	Cavia, Province of Burgos
Lagunilla	Lagunilla
Kalaeloa	Kalaeloa, Hawaii
Gajates	Gajates
Rojas (Burgos)	Rojas, Province of Burgos
Fuentes de Béjar	Fuentes de Béjar
Santa Inés (Burgos)	Santa Inés, Province of Burgos
Guijo de Ávila	Guijo de Ávila
Contreras	Contreras, Province of Burgos
Buenavista	Buenavista, Salamanca
Isar (Burgos)	Isar, Province of Burgos
Kualapuʻu	Kualapuu, Hawaii
Kaʻaʻawa	Kaʻaʻawa, Hawaii
Afega	Afega
Huerta (Salamanca)	Huerta, Salamanca
Albert Küchler	Albert Küchler
Wailuku	Wailuku, Hawaii
Waikapū	Waikapu, Hawaii
Wailua	Wailua, Hawaii
ʻĀhuimanu, Hawaiʻi	Ahuimanu, Hawaii
Heʻeia	Heʻeia, Hawaii
Māʻili	Māili, Hawaii
Alanui ʻo Kamehameha	Kamehameha Highway
Maraghar lukua	Maraga massacre
Hāliʻimaile	Haliimaile, Hawaii
Hua mele hapa hanelekūmāiwakāluakūmāwalu	Hundred twenty-eighth note
Hua mele hapa kanaonokūmāhā	Sixty-fourth note
Pāʻia	Paia, Hawaii
Bochotnica	Bochotnica
Sanna Nielsen	Sanna Nielsen
Makawao	Makawao, Hawaii
Hanapēpē	Hanapepe, Hawaii
Kōloa	Koloa, Hawaii
Kalihiwai	Kalihiwai, Hawaii
Mākaha	Mākaha, Hawaii
ʻEleʻele (Kauaʻi)	Eleele, Hawaii
Anahola	Anahola, Hawaii
Maunaloa	Maunaloa, Hawaii
Kahaluʻu	Kahaluu, Hawaii
Lāwaʻi	Lawai, Hawaii
Hanalei	Hanalei, Hawaii
Kalāheo	Kalaheo, Hawaii
Nakayama Miki	Nakayama Miki
Hōkūleʻa	Hokulea
Conrad Bain	Conrad Bain
Kāʻanapali	Kaanapali, Hawaii
Carrossel	Carrossel
Māhele:Nā ‘āinapuni‘ole	Category:Continents
Waimea (Kauaʻi)	Waimea, Kauai County, Hawaii
Corações Feridos	Corações Feridos
Dira Paes	Dira Paes
Gabriel Braga Nunes	Gabriel Braga Nunes
Zoboomafoo	Zoboomafoo
Anakuhi:Nā hōkū hele o ke kahua o nā hōkū	Template:Solar System table
Wimzie's House	Wimzie's House
Úrsula Murayama	Úrsula Murayama
Kula ʻo Punahou	Punahou School
Mānoa	Manoa
Kaʻiulani	Kaʻiulani
Lāʻie	Laie, Hawaii
Likelike	Likelike
Apai	Apai
Karacaoğlan	Karacaoğlan
Bernice Pauahi Bishop	Bernice Pauahi Bishop
Luakini ma Kona, Hawai‘i	Kona Hawaii Temple
Pauoa	Pauoa, Hawaii
Kaimukī	Kaimuki, Hawaii
Nainoa Thompson	Nainoa Thompson
Ua Mau ke Ea o ka ʻĀina i ka Pono	Ua Mau ke Ea o ka ʻĀina i ka Pono
Anakuhi:WikipediaLang	Template:Wikipedia languages
Wikipedia:Nā kahu	Wikipedia:Administrators
Wikipedia:Nā noi e ho‘oki‘eki‘e	Wikipedia:Requests for adminship
Wikipedia:Lopako	Wikipedia:Bots
‘Aikupika	Egypt
La mujer dorada	La mujer dorada
Anakuhi:Lopako	Template:Bot
Kanakā	Canada
Māhele:Hunakalia	Category:Hungary
Māhele:Helene	Category:Greece
Māhele:Solowakia	Category:Slovakia
Māhele:ʻEulopa	Category:Europe
A‘ufaga	A'ufaga
Māhele:Wikipedians by language	Category:Wikipedians by language
Wikipedia:‘Ōmuku	Wikipedia:Stub
Sung Jae-gi	Sung Jae-gi
Afiamalu	Afiamalu
Anakuhi:Softredirect	Template:Soft redirect
Anakuhi:Kāpae	Template:Db
Māhele:‘Ōlelo	Category:Languages
Māhele:Wikipikia	Category:Wikipedia
Wikipedia:Nā a‘o ‘ana laulā	Wikipedia:General disclaimer
Wikipedia:Manuale Kaila	Wikipedia:Manual of Style
Anakuhi:Navbox	Template:Navbox
Don Keefer	Don Keefer
Nina Andrycz	Nina Andrycz
Anakuhi:Tnavbar	Template:Navbar
Anakuhi:Okina	Template:Okina
Māhele:ʻApelika	Category:Africa
Anakuhi:Papela	Template:Babel
Anakuhi:Commons	Template:Commons
Anakuhi:ʻŌmuku	Template:Stub
Anakuhi:User de	Template:User de
George Nāʻope	George Naʻope
Anakuhi:User en	Template:User en
Anakuhi:User fr	Template:User fr
Māhele:ʻĀkia	Category:Asia
Māhele:21st century	Category:21st century
Māhele:Panalāʻau o Soria	Category:Province of Soria
Māhele:Castille a Leon	Category:Castile and León
Anakuhi:Mod	Template:Mod
Anakuhi:Aloha	Template:Welcome
Anakuhi:Wikipediasister	Template:Wikipedia's sister projects
Anakuhi:Wide image	Template:Wide image
Māhele:Palika	Category:Paris
Māhele:User en	Category:User en
Anakuhi:User ru	Template:User ru
Māhele:Nā hōkū hele o ke kahua o nā hōkū	Category:Planets of the Solar System
Anakuhi:User blank	Template:User blank
Anakuhi:Ho‘okele nā makahiki	Template:Year nav
Anakuhi:Pule	Template:Days of the week
Anakuhi:Huaʻōlelo puana like	Template:Disambiguation
Māhele:Aliʻi o Hawai‘i	Category:Hawaiian monarchs
Anakuhi:UsersSpeak	Template:UsersSpeak
Anakuhi:Nā ‘āinapuni‘ole	Template:Continents of the world
Jonathan Nāpela	Jonatana Napela
Māhele:User fr	Category:User fr
Māhele:Mea hoʻohana haw	Category:User haw
Kakaʻako	Kakaako
Kula ʻo Kamehameha	Kamehameha Schools
Haukapila ʻo Kapiʻolani	Kapiolani Medical Center for Women and Children
Kaulana Nā Pua	Kaulana Nā Pua
Māhele:Panalāʻau o Quảng Binh	Category:Quang Binh Province
Māhele:User de	Category:User de
Māhele:User de-N	Category:User de-N
Māhele:User en-N	Category:User en-N
Anakuhi:ʻŌnaehana helu	Template:Number systems
La Atalaya	La Atalaya, Cuelap
Māhele:Huli kanaka	Category:Social sciences
Māhele:Kahawai o Palani	Category:Rivers of France
Māhele:User ru	Category:User ru
Anakuhi:Sepania	Template:Autonomous communities of Spain
Kuʻu Ipo I Ka Heʻe Puʻe One	List of compositions and works by Likelike
Māhele:Kahaki‘i	Category:Painters
Māhele:Hawai‘i	Category:Hawaii
Māhele:Kanaka o Hawaiʻi	Category:People from Hawaii
Māhele:Panalā‘au o Granada	Category:Municipalities in the Province of Granada
Māhele:Kelewikiona	Category:Television
Māhele:Nolewai	Category:Norway
Māhele:Nā moana	Category:Oceans
Māhele:Kapikala	Category:Capitals
Puʻuhonua o Hōnaunau	Puʻuhonua o Hōnaunau National Historical Park
Māhele:Honolulu	Category:Honolulu, Hawaii
Samuel Kamakau	Samuel Kamakau
Māhele:Panalā‘au o Burgos	Category:Municipalities in the Province of Burgos
Māhele:Panalā‘au o Zamora	Category:Municipalities of the Province of Zamora
Trojany	Trojany, Masovian Voivodeship
Māhele:Panalā‘au o Salamanca	Category:Province of Salamanca
Māhele:Haku mele (ho‘okani)	Category:Composers
Anakuhi:Mea hoʻohana haw-0	Template:User haw-0
Māhele:Oʻahu	Category:Oahu
Māhele:ʻĀpana o Hawaiʻi	Category:Census-designated places in Hawaii
Chiquititas	Chiquititas (2013 telenovela)
Szymon Szurmiej	Szymon Szurmiej
Anakuhi:Nā kapikala o nā moku‘āina o ‘Amelika Hui	Template:US state capitals
Anakuhi:Puke o Molemona	Template:Books of the Book of Mormon
He Mele Lāhui Hawaiʻi	He Mele Lahui Hawaii
Module:Citation/CS1/Whitelist	Module:Citation/CS1/Whitelist
Module:Yesno	Module:Yesno
Module:Category handler	Module:Category handler
Yun Hyon-seok	Yun Hyon-seok
Module:Arguments	Module:Arguments
Papa nui:NāLoliHou	Special:RecentChanges
Module:Citation/CS1	Module:Citation/CS1
Module:Citation/CS1/Configuration	Module:Citation/CS1/Configuration
Colégio Brasil	Colégio Brasil
Module:Namespace detect	Module:Namespace detect
Module:HtmlBuilder	Module:HtmlBuilder
Module:Navbar	Module:Navbar
Module:Navbox	Module:Navbox
Module:Userbox	Module:Userbox
Māhele:Mele o Hawaiʻi	Category:Songs about Hawaii
