អាហ្វ្រិក	Africa
ជប៉ុន	Japan
អង់គ្លេស	England
ស្កុតឡែន	Scotland
វ៉ែល	Wales
អៀរឡង់ខាងជើង	Northern Ireland
សាធារណរដ្ឋអៀរឡង់	Republic of Ireland
ប្រទេសហុងគ្រី	Hungary
អេស្ប៉ាញ	Spain
សហរដ្ឋអាមេរិក	United States
ផែនដី	Earth
ប៊ឺណឺស លី	Tim Berners-Lee
ស៊ុយអែត	Sweden
ប្រទេសប៉ូឡូញ	Poland
អ៊ីតាលី	Italy
ព័រទុយហ្គាល់	Portugal
អឺរ៉ុប	Europe
អាស៊ី	Asia
វិគីភីឌា	Wikipedia
ភីអេចភី	PHP
ទីក្រុងញូវយ៉ក	New York City
កុំព្យូទ័រ	Computer
អ៊ីនធើណេត	Internet
បារ៉ាក់ អូបាម៉ា	Barack Obama
ប៉ារីស	Paris
អាប្រាហាម លីនខូន	Abraham Lincoln
ប្រព័ន្ធប្រតិបត្តការ Android	Android (operating system)
Google ស្វែងរក	Google
ម៉ិកស៊ិក	Mexico
មហាសមុទ្រអាត្លង់ទិក	Atlantic Ocean
មហាសមុទ្រប៉ាស៊ីហ្វិក	Pacific Ocean
ថ្ងៃច័ន្ទ	Monday
ខែមករា	January
ខែកុម្ភៈ	February
ខែមីនា	March
ភពអង្គារ	Mars
ខែមេសា	April
ខែឧសភា	May
ខែមិថុនា	June
ខែកក្កដា	July
ខែសីហា	August
ខែកញ្ញា	September
ខែតុលា	October
ខែវិច្ឆិកា	November
ខែធ្នូ	December
អង្គារ	Tuesday
ថ្ងៃពុធ	Wednesday
ថ្ងៃព្រហស្បតិ៍	Thursday
ថ្ងៃសុក្រ	Friday
ថ្ងៃសៅរ៍	Saturday
ថ្ងៃអាទិត្យ	Sunday
សេះ (​អុក​)	Knight (chess)
បារាំង	France
សត្វឆ្កែ	Dog
រាជាណាចក្ររួម	United Kingdom
ឆ្មា	Cat
ភាសាបារាំង	French language
ប្រេស៊ីល	Brazil
រុស្ស៊ី	Russia
ការ៉េ	Square
សមុទ្រ	Sea
អាល្លឺម៉ង់	Germany
ភាសាអាល្លឺម៉ង់	German language
ប្រទេសអាយឡែន	Iceland
ភពសៅរ៍	Saturn
១ (លេខ)	1 (number)
២ (លេខ)	2 (number)
៣ (លេខ)	3 (number)
៥	5 (number)
ចតុកោណកែង	Rectangle
មុំកែង	Right angle
អ៊ុយក្រែន	Ukraine
ទីក្រុងរ៉ូម	Rome
អាល់បានី	Albania
អាស៊ែបៃហ្សង់	Azerbaijan
អង់ដូរ៉ា	Andorra
សាធារណរដ្ឋកាហ្សាក់ស្ថាន	Kazakhstan
បុរីវ៉ាទីកង់	Vatican City
គុយបា	Cuba
ឥណ្ឌូនេស៊ី	Indonesia
អាហ្វ្រិកខាងត្បូង	South Africa
ប្រវត្តិសង្ខេប ក្រុមតន្រ្តី រ៉ុក linkin park	Linkin Park
ប្រទេសអាល់ហ្សេរី	Algeria
ស្រា	Wine
ទឹក	Water
ទូរទស្សន៏	Television
ភាសាអាយឡែន	Icelandic language
ឈីលី	Chile
ព្រះយេស៊ូវ គ្រីស្ទ	Jesus
ភពពុធ	Mercury (planet)
ប្រវត្តិសាស្ត្រ	History
ភពសុក្រ	Venus
ភាសា	Language
ភពព្រហស្បតិ៍	Jupiter
ភពអ៊ុយរ៉ានុស	Uranus
វិគីភីឌាភាសាអង់គ្លេស	English Wikipedia
ភពណិបទូន	Neptune
សិង្ហបុរី	Singapore
ភ្លុយតុង	Pluto
ហ្វេសប៊ុក	Facebook
សង្គ្រាមលោកលើកទីមួយ	World War I
សង្គ្រាមលោកលើកទី២	World War II
ទំព័រគំរូ:Corruption	Corruption
Ubuntu	Ubuntu (operating system)
លីនុច	Linux
គណិតវិទ្យា	Mathematics
បារ៉ែន	Bahrain
ព្រះចន្ទ	Moon
អូស្ត្រាលី	Australia
រូបវិទ្យា	Physics
ជីវវិទ្យា	Biology
កូរ៉េខាងជើង	North Korea
ព្រះរាជាណាចក្រកម្ពុជា	Cambodia
ឌីណូស័រ	Dinosaur
សាសនាឥស្លាម	Islam
សេរីភាព	Peace
សហភាពអឺរ៉ុប	European Union
ចេក	Banana
ណាប៉ូលេអុងបូណាប៉ារត៍	Napoleon
ព្រះអាទិត្យ	Sun
ឆ្នាំពន្លឺ	Light-year
អូសេអានី	Oceania
ប្រព័ន្ធព្រះអាទិត្យ	Solar System
អុីដ្រូសែន	Hydrogen
ទីម័រខាងកើត	East Timor
ម៉ុង ប្លុង	Mont Blanc
សឺរេស	Ceres (dwarf planet)
អៀរីស	Eris (dwarf planet)
ភព	Planet
តន្ត្រី	Music
ភាសាអ៊ីតាលី	Italian language
អាលុយមីញ៉ូម	Aluminium
នូវែលសេឡង់	New Zealand
ឥណ្ឌា	India
អង់ដ្រេ ម៉ារី អំពែរ	André-Marie Ampère
វីលីម ហ្សេកស្ពែរ	William Shakespeare
ប៉ាឡាវ	Palau
ម៉ុងហ្គោលី	Mongolia
ជេនហ្គិស ខាន់	Genghis Khan
កូឡុំប៊ី	Colombia
ព្រះពុទ្ធសាសនា	Buddhism
ហ្គាតេម៉ាឡា	Guatemala
មហាសមុទ្រអាកទិក	Arctic Ocean
អ៊ីរ៉ង់	Iran
ភាសាប៉ូឡូញ	Polish language
ហ្សកដង់	Jordan
កៀហ៊្សីស៊ីស្ថាន	Kyrgyzstan
គុយវ៉ែត	Kuwait
ឡាវ	Laos
លីបង់	Lebanon
ទ្វីបអាមេរិក	Americas
ម៉ាឡេស៊ី	Malaysia
មីយ៉ាន់ម៉ា	Burma
នេប៉ាល់	Nepal
ប៉ាគីស្ថាន	Pakistan
MySQL	MySQL
អារ៉ាប៊ីសាអូឌីត	Saudi Arabia
ស្រីលង្កា	Sri Lanka
ផ្លាតូ	Plato
តាជីគីស្ថាន	Tajikistan
YouTube	YouTube
អារីស្តូត	Aristotle
ថៃ	Thailand
វិទ្យុ	Radio
តួរមិនីស្ថាន	Turkmenistan
វៀតណាម	Vietnam
កូរ៉េខាងត្បូង	South Korea
សាធារណរដ្ឋឥស្លាមអាហ្វហ្កានីស្ថាន	Afghanistan
ព្រែកជីកស៊ុយអែស	Suez Canal
បង់ក្លាដែស្ស	Bangladesh
សូក្រាត	Socrates
ធ្វិតថឺរ	Twitter
ប៊្រុយណេ	Brunei
ហ្វីលីពីន	Philippines
អ៊ីសាក់ ញូតុន	Isaac Newton
OpenStreetMap	OpenStreetMap
អាល់បឺត អែងស្តែង	Albert Einstein
ប្រទេសហ្សំប៊ី	Zambia
ប៉េកាំង	Beijing
មហាត្មះគន្ធី	Mahatma Gandhi
ឆាលែស ដាវីន	Charles Darwin
ជូលីស៍ សេសារ	Julius Caesar
ឥន្ទធនូ	Rainbow
អង្គការសហប្រជាជាតិ	United Nations
ភូមិវិទ្យា	Geography
ទីក្រុងប្រាក	Prague
បន្ទុកអគ្គីសនី	Electric charge
ខេត្តជើងភ្នំ (ប្រទេសអ៊ីតាលី)	Piedmont
មហាសមុទ្រឥណ្ឌា	Indian Ocean
អូសាម៉ា ប៊ីន ឡាឌែន	Osama bin Laden
ភាសាអេស្ប៉ាញ	Spanish language
ភីឡាដេលផ្យា	Philadelphia
ញូវយ៉ក	New York
វ្លាឌីមៀរ អ៊ីលីច លេនីន	Vladimir Lenin
អូហ្គុសទុស	Augustus
លោកកៃយុសសេសារ	Caligula
ត្រាហ្សាន	Trajan
Kde	KDE
កូរ៉ាស៊ូន អាគីណូ	Corazon Aquino
ទីក្រុងតូខ្យូ	Tokyo
ហ្វឺឌីណាន់ដ៏ ម៉ាហ្សេឡង់	Ferdinand Magellan
ស៊ីសេរ៉ូ	Cicero
ភ្នំពេញ	Phnom Penh
ទីក្រុងព្រៃនគរ	Ho Chi Minh City
ទីក្រុងហានូយ	Hanoi
គ្រិស្តសាសនា	True Jesus Church
ភាសាអង់គ្លេស	English language
គូឡាឡាំពួ	Kuala Lumpur
២០០១	2001
JavaScript	JavaScript
HTML5	HTML5
ល្បឿនពន្លឺ	Speed of light
JPEG	JPEG
អេឡិចត្រុង	Electron
ចក្រភព រ៉ូម	Roman Empire
Microsoft	Microsoft
គីមីវិទ្យា	Chemistry
ស៊ីទ្រុងជ្រូក	C Sharp (programming language)
បេណេឌីកទី១៦	Pope Benedict XVI
៧ កក្កដា	July 7
បាល់ទាត់	Association football
ទីក្រុងបូកូតា	Bogotá
ថ្ងៃទី៣១ខែធ្នូ	December 31
រិសថា	4 Vesta
ស៊ីដនីយ៏	Sydney
ភ្លើង	Fire
ខ្យល់	Atmosphere of Earth
កោះស៊ូម៉ាត្រា	Sumatra
ចាការតា	Jakarta
ចំណាត់ថ្នាក់ក្រុម:Wikipedia templates	Category:Wikipedia templates
កោះជ្វា	Java
ចំណាត់ថ្នាក់ក្រុម:ចំណាត់ថ្នាក់ក្រុមនៃទំព័រគំរូវិគីភីឌា	Category:Wikipedia template categories
កាលីម៉ាន់តាន់	Kalimantan
ខេត្តបន្ទាយមានជ័យ	Banteay Meanchey Province
វិគីភីឌា:ប្រអប់ខ្សាច់	Wikipedia:Sandbox
អាកាសយានដ្ឋាន ដុង ហ៊យ	Dong Hoi Airport
អាន់ ហ្វ្រែង	Anne Frank
ខុង ជឺ	Confucius
ម៉ារីលីន ម៉ុនរ៉ូ	Marilyn Monroe
ចំណាត់ថ្នាក់ក្រុម:គណិតវិទ្យា	Category:Mathematics
ទំព័រគំរូ:ទិន្នន័យប្រទេស អ៊ីរ៉ង់	Template:Country data Iran
ចំណាត់ថ្នាក់ក្រុម:ប្រវត្តិសាស្ត្រខ្មែរ	Category:History of Cambodia
ចំណាត់ថ្នាក់ក្រុម:ប្រវត្តិសាស្រ្តសិង្ហបុរី	Category:History of Singapore
សមុទ្រ មេឌីទែរ៉ានេ	Mediterranean Sea
វីនដូអេច	Windows 8
ទំព័រគំរូ:ប្រទេសនៅទ្វីបអាស៊ី	Template:Countries of Asia
ទំព័រគំរូ:Agree	Template:Agree
ទន្លេហ្គារ៉ូន	Garonne
ស៊ីតថល	Seattle
ជញ្ជាំង ប៊ែរឡាំង	Berlin Wall
ស្រូវ	Rice
ទំព័រគំរូ:Lang-tr	Template:Lang-tr
ទំព័រគំរូ:ផតថល	Template:Portal
ទំព័រគំរូ:តំបន់នៃពិភពលោក	Template:Regions of the world
ប៊ីល ហ្គេត	Bill Gates
ភាសាជប៉ុន	Japanese language
ប្រជុំវីជ្ជា	Encyclopedia
ឌីវីឌី	DVD
ទំព័រដើម	Main Page
Central processing unit	Central processing unit
រេស៊ីស្ទ័រ	Resistor
កីឡាអូឡាំពិក	Olympic Games
សមុទ្រ កាសព្យែន	Caspian Sea
ឈី ហ្គីវ៉ារ៉ា	Che Guevara
ទីក្រុងកាបូល	Kabul
ហ្គ្រាប្រីអ៊ែល ហ្រ្គារ៉ាស្សៀ ម៉ារ៉ាហ្គេស	Gabriel García Márquez
ទស្សនវិជ្ជា	Philosophy
ចំណាត់ថ្នាក់ក្រុម:លុប	Category:Candidates for speedy deletion
លិទ្ធិកុម្មុយនិស្ត	Communism
ហ៊ីលឡារី រូដហេម គ្លីនតុន	Hillary Rodham Clinton
Boeing 737	Boeing 737
អាហារនៅប្រទេសបារំាង និង របៀបធ្វើ	French cuisine
មណ្ឌលម៉ាញេតូ	Magnetosphere
UTC+7	UTC+07:00
ភាសាកាតាឡាន	Catalan language
បណ្ណាល័យ	Library
នីល ហេនរីក ដេវីដ ប៊័រ	Niels Bohr
និវេសនវិទ្យា	Ecology
ក្លឹបបាល់ទាត់បារសេឡូណា	FC Barcelona
នយោបាយ	Politics
ធនាគារពិភពលោក	World Bank
ប្រជាធិបតេយ្យ	Democracy
អង្គការសន្ធិសញ្ញាអាត្លង់ទិកខាងជើង	NATO
ម៉ារី ស្កូដូស្កា គុយរី	Marie Curie
រង្វាន់ណូបែល	Nobel Prize
មជ្ឈិមបូព៌ា	Middle East
រាជវង្សហាន	Han dynasty
ប្រទេស	State (polity)
គ្រឹស្តុបផើ កូឡំបូស (Christopher Columbus)	Christopher Columbus
ព្រែកជីកប៉ាណាម៉ា	Panama Canal
មហាសមុទ្រខាងត្បូង	Southern Ocean
ត្រីផ្សោតនៅកម្ពុជា	Dolphin
ក្មេង	Child
លេអុនហាដ អយល័រ	Leonhard Euler
ណាប៉ូលេអុងទី៣	Napoleon III
ភាសារុស្ស៊ី	Russian language
ល្វី ដ៏អស្ចារ្យ	Louis XIV of France
សមាគមប្រជាជាតិអាស៊ីអាគ្នេយ៍	Association of Southeast Asian Nations
ប្រវត្តិសាស្ត្របារាំង	History of France
តុលាការយុត្តិធម៌អន្តរជាតិ	International Court of Justice
យូណេស្កូ	UNESCO
អង្គការសុខភាពពិភពលោក	World Health Organization
អង្គការពាណិជ្ជកម្មពិភពលោក	World Trade Organization
ភាសាចិន	Chinese language
ធម្មជាតិ	Nature
ឈាម	Blood
រញ្ជួយផែនដី	Earthquake
សមុទ្រឡាប់តែវ	Laptev Sea
ភ្លើងចរាចរ	Traffic light
ម៉ាទីន ឡូតធឺរ ឃីង	Martin Luther King Jr.
ត្រីកោណមាត្រ	Trigonometry
ធរណីមាត្រ	Geometry
វេយ្យាករណ៍	Grammar
សេដ្ឋកិច្ច	Economics
អក្សរក្រិច	Greek alphabet
អក្សរឡាតាំង	Latin script
រឿងមហាភារតយុទ្ធ	Mahabharata
ការិយាល័យសហព័ន្ធស៊ើបអង្កេត	Federal Bureau of Investigation
វីយោឡុង	Violin
ឃឹម	Cimbalom
អេឡិចសាន់ដឺ ដឹ ហ្គារ៉ែត	Alexander the Great
សង្គម	Society
ការអប់រំ	Education
មនុស្សប្រុស	Man
វិគីភីឌាភាសាអេស៉្បាញ	Spanish Wikipedia
សិទ្ធិមនុស្ស	Human rights
ទាសភាព	Slavery
សង្គ្រាមស៊ីវិល	Civil war
ភ្នំ	Mountain
ហុងកុង	Hong Kong
សង្គ្រាមត្រជាក់	Cold War
សេអ៊ូល	Seoul
សង្គ្រាមវៀតណាម	Vietnam War
ម៉ៃឃើល ហ្វារ៉ាដេយ	Michael Faraday
អង់រីកូ ហ្វែរមី	Enrico Fermi
ភាសាអ៊ុយក្រែន	Ukrainian language
HTML	HTML
ច្យូហានេស គូទេនបឺគ	Johannes Gutenberg
ភាសាដាណឺម៉ាក	Danish language
ភាសាអេស្តូនី	Estonian language
ហិណ្ឌូសាសនា	Hinduism
ភាសាពែក	Persian language
សាសនា	Religion
ភាសាកូរ៉េ	Korean language
ភាសាខ្មែរ	Khmer language
ហ្រ្គេតស៊ីងមួន	Sigmund Freud
ភាសាថៃ	Thai language
ភាសាម៉ាឡេ	Malay language
ភាសាឥណ្ឌូនេស៊ី	Indonesian language
ភាសាហេប្រ៊ូ	Hebrew language
ចន ឡុក	John Locke
ថ្លើម	Liver
ចិត្តវិទ្យា	Psychology
មហាសមុទ្រ	Ocean
ពុទ្ធប្រវត្តិសង្ខេប	Gautama Buddha
ចរិយាមារយាទ	Ethics
សារជីវកម្មផ្សព្វផ្សាយព័ត៌មានរបស់ចក្រភពអង់គ្លេស(BBC)	BBC
ក្លិបបាល់ទាត់ឆេលស៊ី	Chelsea F.C.
គ្រោងឆ្អឹងមនុស្ស	Human skeleton
ក (អវយវៈ)	Neck
រាជវង្សថាង	Tang dynasty
John F. Kennedy	John F. Kennedy
LibreOffice	LibreOffice
ផ្លូវរូងដីក្រោមសមុទ្រ	Channel Tunnel
តារាងខួបនៃធាតុគីមី	Periodic table
ប្រូម៉ាស	Cheese
ទំពាំងបាយជូរ	Grape
បន្លែ	Vegetable
បច្ចេកវិទ្យា	Technology
វិស្វកម្ម	Engineering
ទំនាក់ទំនង	Communication
វិជ្ជាជីវៈខាងសារព័ត៌មាន	Journalism
កាសែត	Newspaper
ទូរស័ព្ទ	Telephone
វប្បធម៌	Culture
សំស្ក្រឹត	Sanskrit
ប្រដាប់របត់ឈាម	Circulatory system
The Guardian	The Guardian
សមីការឌីផេរ៉ង់ស្យែល	Differential equation
មៃក្រូសូហ្វអ៊ិសេល	Microsoft Excel
មុំ	Angle
សំទុះ	Acceleration
ព្រះសិវៈ	Shiva
ព្រះវិស្ណុ	Vishnu
Local Area Network	Local area network
Wide Area Network	Wide area network
ព្រះព្រហ្ម	Brahma
កម្លាំង	Force
អេឡិចត្រូម៉ាញ៉េទិច	Electromagnetism
កសិកម្ម	Agriculture
សំលៀកបំពាក់	Clothing
ល្បឿន	Velocity
ក្រដាស	Paper
សុញ្ញកាស	Vacuum
ស៊ីនេម៉ាទិច	Kinematics
ក្រលាផ្ទៃ	Area
ទ្រឹស្តីបទពីតាករ	Pythagorean theorem
ចំនួនកុំផ្លិច	Complex number
Cristiano Ronaldo	Cristiano Ronaldo
អ្នកថតរូប	Photography
ល្ខោន	Theatre
គ្រឿងអេឡិចត្រូនិច	Electronic component
ព័ត៌មានវិទ្យា	Information technology
អាស៊ីអាគ្នេយ៍	Southeast Asia
ក្រុងសៀមរាប	Siem Reap
បញ្ជីរាយនាម ប្រទេស	List of sovereign states
វិគីភីឌាភាសាព័រទុយហ្គាល់	Portuguese Wikipedia
ប្រដាប់រំលាយអាហារ	Digestion
កីឡាចាក់សាប	Fencing
រោគផ្ដាសាយធម្មតា	Common cold
រោគសរសៃប្រសាទ	Mental disorder
ប្រតិទិន ក្រេកូរី	Gregorian calendar
សុខភាព	Health
ជម្ងឺរលាកទងសួត	Pneumonia
ជំងឺអេដស៍	HIV/AIDS
កូដ QR	QR code
ជំងឺទឹកនោមផ្អែម	Diabetes mellitus
ទំព័រគំរូ:Location map Belgium	Module talk:Location map/data/Belgium/attribution
ទំព័រគំរូ:Location map Croatia	Module talk:Location map/data/Croatia/attribution
ទំព័រគំរូ:Location map Ukraine	Template:Location map Ukraine
ទំព័រគំរូ:Location map Burma	Template:Location map Burma
ទំព័រគំរូ:Location map Philippines	Template:Location map Philippines
ទំព័រគំរូ:Location map Vietnam	Template:Location map Vietnam
ទំព័រគំរូ:Location map Cambodia	Template:Location map Cambodia
ទំព័រគំរូ:Location map Thailand	Template:Location map Thailand
ទំព័រគំរូ:Location map Indonesia	Template:Location map Indonesia
ទំព័រគំរូ:Location map Australia	Template:Location map Australia
ញូតុន	Newton (unit)
ចក្រភព អូតូម៉ង់	Ottoman Empire
ម៉ាស៊ីនចំហេះក្នុង	Internal combustion engine
ក្បាច់គិតលេខ	Abacus
វឺតប្រែស	WordPress
Joomla!	Joomla
ដើមដូង	Coconut
ភាសាណាវ៉ាថ្ល៍	Nahuatl
ភាសាម៉ាយ៉ាយូកាតិក	Yucatec Maya language
អែនជេលីណា ចូលី	Angelina Jolie
អ៊ីលដឺហ្រ្វែន	Île-de-France
ភាសាអារ៉ាប់	Arabic language
Thanksgiving	Thanksgiving
តំបន់ឃ្ជឺស្សឺ	Kyushu
តំបន់ស៊ីកុគឹ	Shikoku
នាយករដ្ឋមន្ត្រី	Prime minister
ទង់ជាតិ	Flag
ខ្មៅដៃ	Pencil
សហភាពសូវៀត	Soviet Union
ចំណុចរលាយ	Melting point
កាមេរ៉ា	Still camera
កម្មវិធីទូរទស្សន៍	Television program
ខេត្តខាហ្គុស៊ីម៉ា	Kagoshima Prefecture
ភាសាស៊ី	C (programming language)
ម៉ង់តេរីយើ	Montesquieu
វិគីភីឌា:អត្ថបទពិសេស	Wikipedia:Featured articles
ពិភពលោក	World
ឈូក	Nelumbo nucifera
ឡងប៊ិច (កាលីផ្វនញ៉ា)	Long Beach, California
រង្វង់	Circle
ប្លង់	Plane (geometry)
វិគីភីឌាភាសាកូរ៉េ	Korean Wikipedia
ទៀបកោះម៉ាឡេ	Malay Peninsula
អេប៉ុងហ្ស៍ (ពពុះទឹក)	Sponge
មធ្យមនព្វន្ធ	Arithmetic mean
World Cup	FIFA World Cup
សម្ដេចប៉ាប	Pope
IATA	International Air Transport Association
បុណ្យណូអែល	Christmas
ត្រីកោណ	Triangle
លោកអេលីសេ រីខ្លាស	Élisée Reclus
អ្នកប្រើប្រាស់:អេង ឡុង/សង្គមវិទ្យាមូលដ្ឋាន	Sociology
សញ្ញាសំលេងអន្តរជាតិ	International Phonetic Alphabet
Friedrich Schiller	Friedrich Schiller
ជំនឿបាហៃ	Bahá'í Faith
១	1
អាប្រាហាម ម៉ាស្លូ	Abraham Maslow
ខ្ទឹមស	Garlic
អ៊ូលេនបាធរ	Ulan Bator
កោះ	Island
ភាសាផ្លូវការ	Official language
ខ្សែអេក្វាទ័រ	Equator
ទិស	Cardinal direction
លេខអាតូម	Atomic number
អាល់ហ្វ្រិដ ណូបែល	Alfred Nobel
សម្ដេចប៉ាប យូហាន ទី២៣	Pope John XXIII
រមណីយដ្ឋានទឹកធ្លាក់ក្បាលឆាយ	Kbal Chhay Waterfall
កិរិយាសព្ទ	Verb
ទីតានិច	RMS Titanic
សត្វឆ្អឹងកង	Vertebrate
បាគូ	Hoopoe
អំពែរ	Ampere
ISO 3166-1	ISO 3166-1
១ មុនគ.ស	1 BC
ម៉ែត្រការ៉េ	Square metre
ជំនួយ:Interlanguage links	Plankton
សហស្សវត្សរ៍ទី២	2nd millennium
ខេត្តកំពង់គោ	Long An Province
ទ្រឹស្តីបទទ្វេធា	Binomial theorem
សមុទ្រជប៉ុន	Sea of Japan
អាស៊ីខាងកើត	East Asia
អាមេរិក កណ្ដាល	Central America
គ្រីស្ទអឌែលហ្វៀន	Christadelphians
បរិមាត្រ	Perimeter
ចក្រភព អូទ្រីស-ហុងគ្រី	Austria-Hungary
បណ្ណាល័យជាតិ	Public library
ផាយថុន	Python (programming language)
អានន្ទ	Ananda
អាស៊ីហ្គេមឆ្នាំ១៩៥១	1951 Asian Games
បាកាន	Bagan
សំទុះទំនាញដី	Gravitational acceleration
ច្បាប់ធម្មតា	Common law
អ្នកម្តាយ តេរេសា​ (Mother Teresa)	Mother Teresa
ប្លូក	Blog
រោគគ្រុនចាញ់	Dengue fever
ដុល្លារហុងកុង	Hong Kong dollar
Xian JH-7	Xian JH-7
ខ្សែបណ្ដោយ	Meridian (geography)
ខេត្តឃ្លាំង	Sóc Trăng Province
ខេត្តទឹកខ្មៅ	Cà Mau Province
សមុទ្រខារ៉ា	Kara Sea
ផ្លេតបន្ទោរ	Lightning
កំរងកោះ	Archipelago
តួប្រុស	Actor
អំបូរភាសាយូតូអាហ្សតិក	Uto-Aztecan languages
ចាស្ទីន ពីពេ្រ	Justin Bieber
ក្រុម​ភាសា​ថៃកៈដៃ	Tai–Kadai languages
ចក្រភព រុស្ស៊ី	Russian Empire
មឞវជ	Mošovce
បេណាហ្សៀរ ប៊ូតូ	Benazir Bhutto
ស៊ីឌី	Compact disc
ឧទ្ធម្ភាគចក្រ	Helicopter
គុណនាម	Adjective
វីតាមីន	Vitamin
វែបសាយ	Website
តំបន់ហុកកៃដូ	Hokkaido
រូបមន្តសមមូលម៉ាស់-ថាមពល	Mass–energy equivalence
សមុទ្រ អារ៉ាល់	Aral Sea
ហូ ជីមិញ	Ho Chi Minh
ម៉ាក ហ្សុកឃឺបឺក	Mark Zuckerberg
ប្រតិកម្មគីមី	Chemical reaction
ខេត្តក្រមួនស	Kiên Giang Province
ខេត្តមាត់ជ្រូក	An Giang Province
ខេត្តរោងដំរី	Tây Ninh Province
ខេត្តព្រះត្រពាំង	Trà Vinh Province
Binomial nomenclature	Binomial nomenclature
ខេត្តពលលាវ	Bạc Liêu Province
ខេត្តផ្សារដែក	Đồng Tháp Province
វ៉ែសបែង	West Bank
ភាសាបាលី	Pali
គេហទំព័រ	Web page
ចតុកោណ	Quadrilateral
ឈិន ឡុង	Jackie Chan
ទិវាកុមារអន្តរជាតិ	Children's Day
Yahoo!	Yahoo!
បន្ទាត់	Line (geometry)
ហ្មរិឩពឡ	Mariupol
G8	G8
អង្កត់ផ្ចិត	Diameter
គ្រូបង្រៀន	Teacher
ស្នាដៃនៃបុព្វបុរសខ្មែរ	Writing
ស្ដេចប៉ាប យ៉ូហាន ប៉ូលទី១	Pope John Paul I
ណៃពិដោ	Naypyidaw
ISO 4217	ISO 4217
ព្យែរ គុយរី	Pierre Curie
ក្រុមប្រឹក្សាសន្តិសុខ អង្គការសហប្រជាជាតិ	United Nations Security Council
ពហុកោណ	Polygon
ទិវានៃក្ដីស្រលាញ់	Valentine's Day
ហ្គូហ្គល	Market (economics)
សមុទ្រចិនខាងត្បូង	South China Sea
និវេសនប្រព័ន្ធ	Ecosystem
សមុទ្រលឿង	Yellow Sea
យ៉ាំងហ្គូន	Yangon
សូរព្យញ្ជនៈ	Consonant
ច្បាប់ចលនារបស់ញូតុន	Newton's laws of motion
ឈូងសមុទ្របេងហ្គាល់	Bay of Bengal
ទិវានារីអន្តរជាតិ	International Women's Day
.jp	.jp
ភ្នំហ្វឹជី	Mount Fuji
ប៉ុលពត	Pol Pot
Xian H-6	Xian H-6
Chengdu J-7	Chengdu J-7
Shenyang J-8	Shenyang J-8
ភ្នំភ្លើង អ៊ីស៊ាឡឺក	Eyjafjallajökull
ម៉ាក្រូសេដ្ឋកិច្ច	Macroeconomics
Harbin SH-5	Harbin SH-5
ដីជ្រោយហ្គាស្សា	Gaza Strip
​វិទ្យុ​ស្ទូឌីយោ 54 បណ្តាញ	Radio Studio 54 Network
អេលីប	Ellipse
វិទ្យុអាស៊ីសេរី	Radio Free Asia
សមាគមន៍សារព័ត៌មាន	Associated Press
អធិដ្ឋាន	Prayer
គណៈកម្មាធិការអូឡាំពិកអន្តរជាតិ	International Olympic Committee
Skype	Skype
.kh	.kh
ចតុកោណស្មើ	Rhombus
ទន្លេមេគង្គ	Mekong
មេកានិច	Mechanics
វិចិត្រសាលវលញ្ឆករប្រទេស	Gallery of country coats of arms
ហែងរីហ ហឺត	Heinrich Hertz
អង់រី បិកកឺរ៉ែល	Henri Becquerel
ទស្សនាវដ្ដី	Magazine
សមីការដឺក្រេទី២	Quadratic equation
រូពីឥណ្ឌូនេស៊ី	Indonesian rupiah
សមុទ្រអុកហុតស្គ៍	Sea of Okhotsk
ចិត្តវិភាគ	Psychoanalysis
ខ្មែរម៉ាស្ទើ	Webmaster
.kr	.kr
URL	Uniform resource locator
ក្រុមបាល់ទាត់ជម្រើសជាតិ អេស្ប៉ាញ	Spain national football team
Google Earth	Google Earth
ប៊ែនហាដ រីម៉ាន	Bernhard Riemann
កោន	Cone
អាតុល	Atoll
ទិន្នន័យ	Data
ខ្លែង	Kite
ស្ថាបត្យករ	Architect
មហាអំណាច អាប់ស៊ីស	Axis powers
វិគីភីឌា:FAQ	Wikipedia:FAQ
.th	.th
ចក្រភព អាល្លឺម៉ង់	German Empire
ក្រុមបាល់ទាត់ជម្រើសជាតិ អាល្លឺម៉ង់	Germany national football team
ហេរី ផោតធ័រ និង សិលាទេព	Harry Potter and the Philosopher's Stone
អង្គការ Creative Commons	Creative Commons
ឥណ្ឌូចិន	Mainland Southeast Asia
ប្រាសាទអង្គរវត្ត	Angkor Wat
ទ្រឹស្ដីរ៉ឺឡាទីវីតេ	Theory of relativity
ប្រុស	Male
Toulon	Toulon
ប៉ាស្កាល់	Pascal (unit)
ទ្រឹស្ដីល្បែង	Game theory
នីតិរដ្ឋ	Rule of law
សមុទ្រចិនខាងកើត	East China Sea
ខ្នុរ	Jackfruit
ប្រលេឡូក្រាម	Parallelogram
ប្រាសាទព្រះវិហារ	Preah Vihear Temple
ចតុកោណព្នាយ	Trapezoid
ស៊ូស៊ី	Sushi
រូប៊ិក ខ្យូប	Rubik's Cube
កាល	Plautus
ចង្រិត	Cricket (insect)
ទិវាពលកម្មអន្ដរជាតិ	International Workers' Day
ស្ទឹង	Stream
សមុទ្រអង់ដាម៉ង់	Andaman Sea
ប៉ិបស៊ី	Pepsi
ក្រុមបាល់ទាត់ជម្រើសជាតិ អង់គ្លេស	England national football team
ក្រុមបាល់ទាត់ជម្រើសជាតិ បារាំង	France national football team
ទំព័រគំរូ:Commonscat	Template:Commons category
វិគីភីឌាភាសាអាល្លឺម៉ង់	German Wikipedia
អាស៊ីខាងលិច	Near East
យេនឌ័រ	Gender identity
អង្គការសហភាពអន្តរជាតិដើម្បីអភិរក្សធម្មជាតិ	International Union for Conservation of Nature
ទីក្រុងមេឌេយីណ	Medellín
ប៉ារ៉ាបូល	Parabola
ខេត្តអ៊ីវ៉ាតិ	Iwate Prefecture
ទ្វារសមុទ្រមលក្កា	Strait of Malacca
មហាយាន	Mahayana
ប្រព័ន្ធប្រតិបត្តការ iOS	IOS
ចំនួនបឋម	Prime number
សង្គ្រាម ប្រាំមួយ ថ្ងៃ	Six-Day War
ក្រុងឡូវែល រដ្ឋម៉ាស្សាឈូស៊ែត	Lowell, Massachusetts
សមុទ្រជ្វា	Java Sea
សិប្បកម្មខ្ញុំ	Minecraft
ច្រកសមុទ្រធ្ងន់ធ្ងរ	Dire Straits
វីហ្សួលបេហ៊្សិក.ណេត	Visual Basic .NET
បំណែងចែករដ្ឋបាលនៃកម្ពុជា	Administrative divisions of Cambodia
អនុគមន៍ដឺក្រេទី២	Quadratic function
ច្បាប់អំពែរ	Ampère's circuital law
ជំងឺអ៊ីបូឡា	Ebola virus disease
ច្រកកូរ៉េ	Korea Strait
ឆកសមុទ្រកូរ៉េ	Korea Bay
កង្កែប	Frog
ខ្សែទឹកឃឹរ៉ុស៊ីអុ	Kuroshio Current
ចំណាត់ថ្នាក់ក្រុម:ព្រះមហាក្សត្រ	Category:Monarchs
ចំណាត់ថ្នាក់ក្រុម:រដ្ឋាភិបាល	Category:Government
ទំព័រគំរូ:Infobox legislature	Template:Infobox legislature
ទន្លេយ៉ាលូ	Yalu River
ទំព័រគំរូ:ប្រវត្តិសាស្ត្រថៃ	Template:History of Thailand
ទំព័រគំរូ:ប្រវត្តិសាស្ត្រចិន	Template:History of China
ទំព័រគំរូ:ប្រវត្តិសាស្ត្រអាស៊ី	Template:History of Asia
មីហ្គេល អ៊ីដាលហ្គោ អ៊ី កុស្ទីយ៉ា	Miguel Hidalgo y Costilla
នរោត្តម សីហមុនី	Norodom Sihamoni
ហ៊ុន សែន	Hun Sen
តូក្យូស្កាយទ្រី	Tokyo Skytree
ហោ ណាំហុង	Hor Namhong
ភាសាប៉ាស្តូ	Pashto language
កំណែទម្រង់រូបិយវត្ថុ	Monetary reform
ធនាគារកណ្ដាល	Central bank
Pidgin	Pidgin (software)
​វិលហែម វុឌ	Wilhelm Wundt
យិដា តាដូ	Gerda Taro
មនុស្សពីងពាង	Spider-Man
សារធាតុគីមី	Chemical substance
ចលនានៅក្នុងរូបវិទ្យា	Motion (physics)
ជម្ងឺកញ្ជ្រឹល	Measles
ក្រុមបាល់ទាត់ជម្រើសជាតិ អាហ្សង់ទីន	Argentina national football team
ខ្យល់ព្រះអាទិត្យ	Solar wind
បាល់ទាត់ពិភពលោក ២០១៤	2014 FIFA World Cup
ម៉ូបាល (អាល់ឡាបាម៉ា)	Mobile, Alabama
កុំព្យូទ័រផ្រូក្រាមមីង(Computer programming)	Computer programming
ខេត្តឈីបា	Chiba Prefecture
អាំងតេក្រាល	Integral
ខេត្តអៃឈិ	Aichi Prefecture
វិបត្តិសេដ្ឋកិច្ចឆ្នាំ ១៩៩៧	1997 Asian financial crisis
ខ្មែរ	Adult
សិល្បៈប្រើវោហារបង្ហូរគំនិត	Rhetoric
ឃីមីហ្គាយ៉ុ	Kimigayo
សាល អូហ្គុស្ទីន ដឺ គូឡុំ	Charles-Augustin de Coulomb
ខេត្តអាគីតា	Akita Prefecture
ថ្នាក់ពាក្យ	Part of speech
ស្ថានភាពអភិរក្ស	Conservation status
កាន់ជិ	Kanji
នាម	Name
ប្រវត្តិសាស្ត្រចិន	History of China
អវតារ	Avatar
ច្បាប់គូឡុំ	Coulomb's law
រឿង រ៉ូមេអូ និង ហ្ស៊ុយលីយេ	Romeo and Juliet
សាលីណា កូមាស់	Selena Gomez
ក្រុម (តារាងខួបនៃធាតុគីមី)	Group (periodic table)
ក្រុមបាល់ទាត់ជម្រើសជាតិ ប្រេស៊ីល	Brazil national football team
ទ្រឹស្ដីគមនាគមន៍	Communication theory
កាល ឡែមស្ដែនណឺ	Karl Landsteiner
បាល់ប៉ូឡូញ	Polandball
ឯកសារភាពយន្ត	Documentary film
អនុគមន៍ត្រីកោណមាត្រ	Trigonometric functions
ហ្រាន្ដកូស ហ្វីឡុន	François Fillon
ខួប (តារាងខួបនៃធាតុគីមី)	Period (periodic table)
ល្បែងទាញព្រ័ត្រ	Tug of war
Article (grammar)	Article (grammar)
មេដ្យានទ័រ	Compass (drawing tool)
Rfid	Radio-frequency identification
អ៊ីប៉ូតេនុស	Hypotenuse
ហិចហ្វាន់	Hedge fund
ISO 3166	ISO 3166
សញ្ញាជាតិកូរ៉េខាងជើង	Emblem of North Korea
មេហ្គា	Mega-
គីឡូ	Kilo-
ការតាំងសមាធិ	Meditation
ប៉េតា	Peta-
យ៉ុតតា	Yotta-
សង់ទី	Centi-
ហ្គីហ្គា	Giga-
តេរ៉ា	Tera-
ហ្វង់តូ	Femto-
ហ្សិតតា	Zetta-
ច្រកតារតារី	Strait of Tartary
ហ្សិបតូ	Zepto-
កាតែត	Cathetus
អាត់តូ	Atto-
យ៉ុកតូ	Yocto-
ដេស៊ី	Deci-
ចំណែករដ្ឋបាលនៃម៉ិចស៊ិក	Administrative divisions of Mexico
ម៉ាស៊ីនស្វែងរក	Metasearch engine
អាំងតេក្រាលមិនកំនត់	Antiderivative
Shenyang J-15	Shenyang J-15
កម្មវិធីទីផ្សារអ៊ីម៉ែល	Bulk email software
គណបក្សហ៊្វុនស៊ិនប៉ិច	Funcinpec Party
ខេត្តក្យូតុ	Kyoto Prefecture
តំលៃដាច់ខាត	Absolute value
ហេដ្ឋារចនាសម្ព័ន្ធ	Infrastructure
សាស្ត្រាចារ្យ	Professor
តេគីឡា	Tequila
សន្ធិសញ្ញាប្រេស្ត-លីតូវស្ក	Treaty of Brest-Litovsk
William Thomson, 1st Baron Kelvin	William Thomson, 1st Baron Kelvin
អាណាខេត្តអូសាកា	Osaka Prefecture
ខេត្តអិហ៊ីមិ	Ehime Prefecture
វាំងននដែក	Iron Curtain
Kara (band)	Kara (band)
វីលៀម ជែម	William James
ខេត្តយ៉ាម៉ាកាតា	Yamagata Prefecture
ច្រកតៃវ៉ាន់	Taiwan Strait
គំរោងម៉ាន់ហាត់ថាន់	Manhattan Project
ខេត្តយ៉ាម៉ាហ្គឹឈិ	Yamaguchi Prefecture
ខេត្តខាន់ណាហ្គាវ៉ា	Kanagawa Prefecture
បញ្ចកោណ	Pentagon
តំបន់ជឺហ្គុកឹ	Chūgoku region
ខេត្តណាហ្គាណុ	Nagano Prefecture
ខេត្តសៃតាម៉ា	Saitama Prefecture
ខេត្តមីអិ	Mie Prefecture
ណុត	Knot (unit)
តំបន់តុហុកកឹ	Tōhoku region
ខេត្តហ្គឺនម៉ា	Gunma Prefecture
ជ្រូកទឹក	Dugong
ខ្សែទឹកមហាសមុទ្រ	Ocean current
ខេត្តមីយ៉ាសាគី	Miyazaki Prefecture
ខេត្តឃឹម៉ាម៉ុតុ	Kumamoto Prefecture
មូលដ្ឋានូបនីយកម្មភាសា	Language localisation
Mikoyan MiG-29	Mikoyan MiG-29
សប្ដាហ៏ពិសិដ្ឋ	Holy Week
ឈូងសមុទ្រថៃ	Gulf of Thailand
លី ក្វាន់យូ	Lee Kuan Yew
កម្មសិទ្ធិបញ្ញា	Intellectual property
អាណាខេត្តណារ៉ា	Nara Prefecture
បុព្វបទនៅក្នុងប្រព័ន្ធខ្នាតអន្តរជាតិ	Metric prefix
យន្តហោះប៉ូឡូញកំទេចឆ្នាំ២០១០	2010 Polish Air Force Tu-154 crash
ជនភៀសខ្លួន	Refugee
ហង់រី កាវិនឌីស	Henry Cavendish
បុណ្យចូលឆ្នាំចិន	Chinese New Year
ថេរវាទ	Theravada
តំបន់ខាន់តូ	Kantō region
ខេត្តនីហ្គាតាក់	Niigata Prefecture
ខេត្តយ៉ាម៉ាណាស៊ី	Yamanashi Prefecture
ខេត្តស៊ីម៉ាណិ	Shimane Prefecture
ខេត្តតុយ៉ាម៉ា	Toyama Prefecture
ខេត្តអូកាយ៉ាម៉ា	Okayama Prefecture
ISO 3166-2	ISO 3166-2
ខេត្តអយតាក់	Ōita Prefecture
ខេត្តខូឈិ	Kōchi Prefecture
អង្គការអន្តរជាតិនៃនយោបាយរបស់បារាំង	Organisation internationale de la Francophonie
ភ្នំមេរ៉ាពី	Mount Merapi
ព្រះធម៌	Dharma
តំបន់ឈឺប៊ឹ	Chūbu region
វ៉ាក់សាំង	Vaccine
រោគក្អកមាន់	Pertussis
គន្ថនិទ្ទេស	Bibliography
អាហារខ្មែរ	Cambodian cuisine
កម្ពុជា នៅកីឡាអូឡាំពិករដូវក្ដៅ ២០០៨	Cambodia at the 2008 Summer Olympics
គីមឈី	Kimchi
ខេត្តកំពង់ចាម	Kampong Cham Province
ខ្សែទឹកហ្គ្រីនលែនខាងកើត	East Greenland Current
ខ្សែទឹកប៉ាស៊ីហ្វិកខាងជើង	North Pacific Current
ខ្សែទឹកហាំបុល	Humboldt Current
ខ្សែទឹកអូស្ត្រាលីខាងកើត	East Australian Current
ជ័រទឹក	Resin
ដុនបូស្កូ	John Bosco
ធ្នូរង្វង់	Arc (geometry)
អប្សរា	Apsara
ស្រុក	District
រាជវង្សចោឡា	Chola dynasty
ខ្លារខិន ២ (រថក្រោះ)	Leopard 2
មហាអំណាច កណ្ដាល	Central Powers
អិចសា	Exa-
ហិកតូ	Hecto-
ដេកា	Deca-
រ៉ូបឺតកាប៉ា	Robert Capa
មីល្លី	Milli-
មីក្រូ	Micro-
ពីកូ	Pico-
ណាណូ	Nano-
លីប៉ូល ស៊ីដាស៊ាងហ័រ	Léopold Sédar Senghor
វិគីភីឌាភាសាឥណ្ឌូនេស៊ី	Indonesian Wikipedia
ទន្ដគោម	Agave
ប្រវតិ្តBoney M	Boney M.
វីមេអូ	Vimeo
អំពើអនិត្យានុកូល	Domestic violence
ហង់រី ការចេរ ប្រេស្សុង	Henri Cartier-Bresson
ត្រីកោណសម័ង្ស	Equilateral triangle
ម៉ាក់ណូលា	Magnolia
ចូសេហ្វ ហិនរី	Joseph Henry
មន ស	Morus alba
ពិធីបញ្ជាប់ពាក្យ	Engagement
ត្រីកោណកែង	Right triangle
សមុទ្រហ្វីលីពីន	Philippine Sea
ប្រព័ន្ធកូអ័រដោណេភូមិសាស្ត្រ	Geopolitics
Eurocopter Tiger	Eurocopter Tiger
តេត្រាអែត	Tetrahedron
សឺន សាន	Son Sann
ម៉ោងផែនដី	Earth Hour
នរោត្ដម សីហនុ	Norodom Sihanouk
ទន្លេរីយ៉ូហ្គ្រែនដេ	Rio Grande
សំព័រ	Artocarpus
កម្មវិធីអភិវឌ្ឍន៍សហប្រជាជាតិ	United Nations Development Programme
ម៉ាស៊ីនថត លេកា	Leica Camera
សេវាសាធារណៈ	Public service
មេគុណជីនី	Gini coefficient
នីត្រូគ្លីសេរីន	Nitroglycerin
វណ្ណយុត្តិ	Diacritic
ទង់ជាតិកម្ពុជា	Flag of Cambodia
ក្រុងអង្គរ	Angkor
ក្រពេញទីមុស	Thymus
ទ្រឹស្តីបទកូស៊ីនុស	Law of cosines
ទក្សិណ ជិនវ័ត្រ	Thaksin Shinawatra
ប្រធាន	Subject (grammar)
ហិនរី រ៉េម៉ុន	Henry Jarvis Raymond
អ៊ែង​ហ្គ្រី បឺដ	Angry Birds
អ៊ីពែបូល	Hyperbola
វិសមភាពស្វ័យគុណ	Inequality (mathematics)
ប៊ិច	Pen
ចេក​	Cooking plantain
XHTML	XHTML
ចម្ប៉ាក្រហម	Magnolia champaca
គ្រោះទុរ្ភិក្ស	Famine
អរិយសច្ច៤	Four Noble Truths
ស្តាទិច	Statics
ខេត្តណាហ្គាសាគី	Nagasaki Prefecture
វិគីភីឌាភាសាស្វីស	Swedish Wikipedia
ភ្លើងឆេះព្រៃ	Wildfire
ទ្រឹស្តីបទស៊ីនុស	Law of sines
ច្បាប់ហ៊ូក	Hooke's law
ក្រុមបាល់ទាត់ជម្រើសជាតិ ជប៉ុន	Japan national football team
រោគឈឺចាប់ក្នុងសន្លាក់ឆ្អឹង	Arthritis
ប្លុកហ្គឺ (Blogger)	Blogger (service)
ធម្មនុញ្ញនៃអង្គការសហប្រជាជាតិ	United Nations Charter
Boeing AH-64 Apache	Boeing AH-64 Apache
រោគហើមសួត	Bronchitis
អេមីល្យូ ហ្គីណូ សេហ្គ្រែ	Emilio G. Segrè
Sukhoi Su-27	Sukhoi Su-27
ម៉ាស៊ីនត្រជាក់	Air conditioning
កាំ	Radius
អភិសិទ្ធិ វេជ្ជាជីវៈ	Abhisit Vejjajiva
HAL Tejas	HAL Tejas
លីមីត	Limit (mathematics)
អ៊ីដ្រូស្តាទិច	Fluid statics
វិគីភីឌាភាសាជប៉ុន	Japanese Wikipedia
គោលនយោបាយរូបិយវត្ថុ	Monetary policy
យានដឹកជញ្ជូនសាធារណៈ	Public transport
ពាណិជ្ជកម្មអន្តរជាតិ	International trade
ចក្រភពអាណានិគមបារាំង	French colonial empire
ពន្ធលើប្រាក់ចំណូល	Income tax
HTML tag	HTML element
រូបចំលាក់	Statue
នាឡិកាខ្សាច់	Hourglass
ពុយមីស	Pumice
FM	Frequency modulation
សង្គមស៊ីវិល	Civil society
សមុទ្របូហៃ	Bohai Sea
ការិយាល័យ	Office
ការបង្រៀនដែនដីបរិសុទ្ធ	E-learning
ម៉ែត្រក្នុងមួយវិនាទី	Metre per second
រូបមន្តហេរុង	Heron's formula
ទន្សោង	Banteng
វីតាមីន B	B vitamins
គណៈកម្មាធិការជាតិអូឡាំពិក	National Olympic Committee
ប៉មតូក្យូ	Tokyo Tower
ទិវាទឹកអន្តរជាតិ	World Water Day
រូបមន្តអយល័រ	Euler's formula
ស៊ីយ៉ាញួរ	Cyanide
អរិយដ្ឋង្គិកមគ្គ	Noble Eightfold Path
សហភាពឥណ្ឌូចិន	French Indochina
ចន្ទគតិ	Lunar calendar
ការវិភាគតាមអ៊ីនធើណែត	Unique user
សំទុះមុំ	Angular acceleration
អាស៊ីហ្គេមឆ្នាំ១៩៧០	1970 Asian Games
កាលប្បវត្តិព្រះពុទ្ធសាសនា	Timeline of Buddhism
គោលនយោបាយសារពើពន្ធ	Fiscal policy
ឡាហ្គូន	Lagoon
Mathew Brady	Mathew Brady
អប់សិន (ហិរញ្ញវត្ថុ)	Option (finance)
អង្កត់ធ្នូ	Chord (geometry)
អាយុសង្ឃឹម	Life expectancy
ជំនួយ:Using colours	Help:Using colours
ខុទ្ទកាល័យ	Board of directors
សីដក់	Sepak takraw
ធនាគារអភិវឌ្ឍន៍អាស៊ី	Asian Development Bank
បញ្ជីរដ្ឋមានអាវុធនុយក្លេអ៊ែរ	List of states with nuclear weapons
ទីផ្សារអ៊ីធើណែត	Internet marketing
សៀវភៅ	The Jungle Book
បារីអេឡិចត្រូនិច	Electronic cigarette
Eagles (ក្រុមភ្លេង)	Eagles (band)
កំណើនសេដ្ឋកិច្ច	Economic growth
យន្តសាស្រ្តរថយន្ត	Automotive industry
អាឌាម លេមបឺត	Adam Lambert
រូបមន្តដឺម័រ	De Moivre's formula
អនុគមន៍ហ្គាំម៉ា	Gamma function
ផ្សារធំថ្មី	Central Market, Phnom Penh
ច្បាប់ប៉ាស្កាល់	Pascal's law
សញ្ញាជាតិបង់ក្លាដែស្ស	National Emblem of Bangladesh
នាង​សីតា	Sita
សូរ (​ភាសាសាស្ត្រ​)	Tone (linguistics)
ខ្មែរក្រហម	Khmer Rouge
ម៉ូឌុល​យ៉ាំង	Elastic modulus
យុន ជីមិ-ហូ	Yun Chi-ho
កែវម៉ាស៊ីនថត	Camera lens
ទីភ្នាក់ងារសារព័ត៌មាន	News agency
វិគីភីឌាភាសាស្លូវ៉ាគី	Slovak Wikipedia
ថេរហ្វារ៉ាដេយ	Faraday constant
និមិត្តសញ្ញាគីមី	Symbol (chemistry)
ប្រវត្តិអ៊ីនធើណេត	History of the Internet
សមភាពគួរកត់សំគាល់	Binomial
ខូប្រា	Copra
ទ្រឹស្តីបទមេនេឡូស	Menelaus' theorem
ការធ្វើពាណិជ្ជកម្ម	Interactive advertising
អត្ថបទ(ប្រើបា្រស់ភាសា)	Context (language use)
ជូគ័រលាង	Zhuge Liang
បំលែងឡាប្លាស	Laplace transform
សញ្ញាជាតិតួរគី	National emblem of Turkey
បឹងទន្លេសាប	Tonlé Sap
Dassault Mirage 2000	Dassault Mirage 2000
ចំនួនអវិជ្ជមាន	Negative number
វិសុទ្ធិមគ្គ	Visuddhimagga
សញ្ញាជាតិវៀតណាម	Emblem of Vietnam
ខ្មែរ (ជនជាតិ)	Khmer people
សញ្ញាជាតិកូរ៉េខាងត្បូង	Emblem of South Korea
សញ្ញាជាតិឡាវ	Emblem of Laos
សញ្ញាជាតិប៉ាគីស្ថាន	State emblem of Pakistan
Tigranes the Great	Tigranes the Great
អាណាចក្រខ្មែរ	Khmer Empire
សម្ដេចព្រះមហាឃោសនន្ន	Preah Maha Ghosananda
កោះក្នុងទ្វីប	Inland island
ត្រីពណ៌	Tricolour (flag)
សញ្ញាជាតិប៊្រុយណេ	Emblem of Brunei
រង្វង់ត្រីកោណមាត្រ	Unit circle
ចំរៀករង្វង់	Circular sector
អនុគមន៍ដឺក្រេទី៣	Cubic function
អនុគមន៍អ៊ីពែបូលីក	Hyperbolic function
ឆាវ ឆាវ	Cao Cao
Sukhoi Su-30	Sukhoi Su-30
កម្មវិធីស្បៀងអាហារពិភពលោក	World Food Programme
រៀល	Cambodian riel
សមុទ្រស្ទើរបិទ	Marginal sea
ច្រកសិង្ហបុរី	Singapore Strait
វិគីភីឌាភាសារុស្ស៊ី	Russian Wikipedia
សញ្ញាជាតិអូម៉ង់	National emblem of Oman
ភាសាកម្មវិធី Lua	Lua (programming language)
សញ្ញាជាតិប៊ូតាន	Emblem of Bhutan
ភ្លេងជាតិថៃ	Thai National Anthem
ព្រះរតនត្រ័យ	Three Jewels
អាហារនៅប្រទេសម៉ិចស៊ិក	Mexican cuisine
ច្រកឡាប៉េរូស	La Pérouse Strait
ខ្នាតកំលាយនៅក្នុងប្រព័ន្ធខ្នាតអន្តរជាតិ	SI derived unit
ផ្សារហិរញ្ញវត្ថុ	Financial market
ញ៉ែ	Flirting
ព្រះឆាយាល័ក្ខកម្ពុជា	Royal Arms of Cambodia
ទិវាអង្គការសហប្រជាជាតិ	United Nations Day
ខ្សែទឹកអាត្លង់ទិកខាងជើង	North Atlantic Current
ប្រវត្តិសាស្ត្រវៀតណាម	History of Vietnam
ខ្សែទឹកខាណារី	Canary Current
ទ្រឹស្តីបទឆិវ៉ា	Ceva's theorem
LinkedIn	LinkedIn
ព្រះត្រៃបិដក	Pāli Canon
បុណ្យវិសាខបូជា	Vesak
ទីក្រុងព្រែកឫស្សី	Cần Thơ
ជនជាតិចាម	Champa
រីស្ស៉ាត កាពុសស៊ីនស្គី	Ryszard Kapuściński
ប្រវត្តិសាស្ត្រភូមា	History of Burma
ស៊ាន ឃីងស្តន	Sean Kingston
កងទ័ពជើងទឹកបារាំង	French Navy
ចំប៉ី	Plumeria
ពហុកីឡាដ្ឋានសុផាចាឡាសៃ	National Stadium (Thailand)
អនុគមន៍បេសែ្សល	Bessel function
លោក អាប់ឌូ ឌីអោហ្វ	Abdou Diouf
វិធីហ្វៃណៃថ៍អ៊េលម៉ិន	Finite element method
ច្បាប់អគ្គីសនីវិភាគរបស់ហ្វារ៉ាដេយ	Faraday's laws of electrolysis
ខេត្តព្រះសីហនុ	Sihanoukville Province
មានប្រ	Anggun
ប្រហុក	Prahok
និកាយនៃព្រះពុទ្ធសាសនា	Schools of Buddhism
ដុនបូស្កូសាឡេស៊ាន្ត	Salesians of Don Bosco
ខ្នាតគោលនៅក្នុងប្រព័ន្ធខ្នាតអន្តរជាតិ	SI base unit
អង្គរធំ	Angkor Thom
Kara	Kara
១៤១	141 (number)
ព្រះបាទសុទ្ធោទន	Śuddhodana
ប្រទេសនៅអឺរ៉ុប	List of sovereign states and dependent territories in Europe
វិទ្យុសម្លេងសហរដ្ឋអាមេរិក	Voice of America
ជេឃ្វីរី	JQuery
ទិវាពិភពលោកគ្មានថ្នាំជក់	World No Tobacco Day
គម្ពីរបញ្ចតន្ត្រ	Panchatantra
មេដ្យាន	Median (geometry)
ផ្លាយ អាស់	Fly ash
T-80	T-80
សញ្ញាជាតិកាតារ	Emblem of Qatar
សញ្ញាយ៉ាកូប៊ី	Jacobi symbol
ភាសាចាម	Cham languages
សត្វព្រៃ	Wildlife
មីហ៊្គោ	MeeGo
វិភាគចិត្តវិទ្យា	Analytical psychology
លីវ ប៉ី	Liu Bei
កិច្ចព្រមព្រៀងពាណិជ្ជកម្ម	Trade agreement
ម៉ាត្សឹស៊ីតា ខូណុស្កិ	Konosuke Matsushita
សង្គ្រាមគ្រីមៀ	Crimean War
ក្ងោកបៃតង	Green peafowl
នាវាចរណ៏	Navigator
Pinterest	Pinterest
អាស៊ីហ្គេមឆ្នាំ១៩៦២	1962 Asian Games
ឃុំព្រះផុស	Preah Phos
ទ្រឹស្តីបទទ្វេធាអាបែល	Abel's binomial theorem
អៀង ធីរិទ្ធ	Ieng Thirith
ភ្នំសេមេរូ	Semeru
កោះសមុយ	Ko Samui
ថវិការដ្ឋាភិបាល	Government budget
អាំងតេក្រាលដោយផ្នែក	Integration by parts
ផ្សោតក្បាលត្រឡោក	Irrawaddy dolphin
Near Field Communication	Near field communication
ខៀវ ពណ្ណារី	Khieu Ponnary
ហិរញ្ញវត្ថុសាធារណៈ	Public finance
កប៉ាល់ ជួង	Ship's bell
សាលាសំណាក់	Pavilion
ជយវម៌្មទី១	Jayavarman I
ប្រាសាទក្រោលគោ	Krol Ko
ខ្សែទឹកកាលីហ្វរនៀ	California Current
រូបមន្តអយល័រ-ម៉ាក្លូរីន	Euler–Maclaurin formula
១៤៨	148 (number)
ធនាគារជាតិនៃកម្ពុជា	National Bank of Cambodia
នគរឆាវ	Cao (state)
AIDC F-CK-1 Ching-kuo	AIDC F-CK-1 Ching-kuo
OSM	OSM
ប្រមោញ	Asiatic brush-tailed porcupine
ខេត្តសាឡៈវ៉ាន់	Salavan Province
WikiHow	WikiHow
ប្រាសាទមេបុណ្យខាងកើត	East Mebon
ទិន្នន័យបើកចំហ	Open data
ទិន ហ្វី	Stephen Chow
ចម្ប៉ាខែក	Magnolia figo
ហាំង ង៉ោ	Haing S. Ngor
ព្រះបាទសូរ្យវរ្ម័នទី២	Suryavarman II
ហ្គោស ចុកតុង	Goh Chok Tong
ហិនរី វីលសុន	Henry Wilson
ហុងដា សូអ៊ិជិរ៉ូ	Soichiro Honda
ស៊ុន ឈាន	Sun Quan
ឆាវ ភី	Cao Pi
ម៉ាស៊ីនថតវីឌីអូ	Video camera
សមុទ្រកូរ៉ូ	Koro Sea
ពិម្ពិសារ	Bimbisara
ដូមីនិក សាវីយ៉ូ	Dominic Savio
ក្រុមបាល់ទាត់ជម្រើសជាតិកម្ពុជា	Cambodia national football team
Seo Jae-pil	Seo Jae-pil
ព្រះសារីបុត្រ	Sariputta
ទ្រឹស្តីបទគ្រីន	Green's theorem
ប្រាសាទអូសាកា	Osaka Castle
ការប្រើប្រាស់ភាសា	Applied linguistics
គោព្រៃ	Kouprey
VCD	Video CD
បេអាត​ រិចន័រ	Beat Richner
ថ្ងៃបាស់ស្ទីល	Bastille Day
កម្ពុជាប្រជាធិបតេយ្យ	Democratic Kampuchea
សាលាក្ដីខ្មែរក្រហម	Khmer Rouge Tribunal
ណាសសែរ អាល់ មូហាមមេដ អាល់ អាហ៍មេដ អាល់ អាបាហ៍	Nasser Al-Sabah
ស៊ុនធិ បុណ្យ រ័តក្លិន	Sonthi Boonyaratglin
ខេត្តផុងសាលី	Phongsaly Province
ខេត្តបកែវ	Bokeo Province
ខេត្តចំប៉ាសក្តិ	Champasak Province
កិលេស	Passion (emotion)
ព្រះបាទជ័យវរ្ម័នទី៧	Jayavarman VII
កស្សបៈ	Mahākāśyapa
កាំង ហ្កិច អ៊ាវ	Kang Kek Iew
កំពស់ត្រីកោណ	Altitude (triangle)
អាយតនៈ	Ayatana
វិសមភាពរវាងមធ្យម	Inequality
ស៊ឺ ម៉ាអ៉ី	Sima Yi
ចំនុចហ្គែរហ្គោន	Inscribed circle
ប្រវត្តិសាស្រ្តនៃរូបថត	History of photography
ឋានន្តរសក្ដិរាជវង្សនិងអភិជន	Royal and noble ranks
សឺង ង៉ុកថាញ់	Son Ngoc Thanh
ក្រុមហ៊ុនអាកាសចរណ៍ជាតិ កម្ពុជាអង្គរអ៊ែរ	Cambodia Angkor Air
វិសមភាពនេស្ប៉ីត	Nesbitt's inequality
កីឡាឧបទ្វីបអាស៊ីអាគ្នេយ៍លើកទី៥	1969 Southeast Asian Peninsular Games
មហាបរិនិព្វានសូត្រ	Mahaparinibbana Sutta
ទ្រឹស្តីបទមេអំបៅ	Butterfly theorem
កន្ថឹក	Northern treeshrew
វណ្ណ មូលីវណ្ណ	Vann Molyvann
ហេង សំរិន	Heng Samrin
ខៀវ សំផន	Khieu Samphan
ជេកខប រីស	Jacob Riis
ព្យែរ វ៉ារីញ៉ុង	Pierre Varignon
នួន ជា	Nuon Chea
អៀង សារី	Ieng Sary
ជយវម៌្មទី៣	Jayavarman II
អជាតសត្តុ	Ajatasatru
បន្ទាត់អយល័រ	Euler line
ប្រវត្តិសាស្ត្រថៃ	History of Thailand
បុណ្យសែនព្រះខែ	Mid-Autumn Festival
មហាមោគ្គលាន	Maudgalyayana
ប្រេម ទីនសូឡានុន្ទ	Prem Tinsulanonda
គុណកិរិយា	Adverb
ឌីណាមិក HTML	Dynamic HTML
នូហាក់ ភូមសៈវ៉ាន់	Nouhak Phoumsavanh
កុំផ្លិចឆ្លាស់	Complex conjugate
ការកើនឡើងនៃចំនួនប្រជាជននៅលើពិភពលោក	Population growth
ស៊ីហ្គេមលើកទី៩	1977 Southeast Asian Games
ប្រាសាទអកយំ	Ak Yum
សាសនានៅប្រទេសកម្ពុជា	Religion in Cambodia
គោលនយោបាយកសិកម្ម	Agricultural policy
ហង់រី មូហូ	Henri Mouhot
ប្រវត្តិសាស្ត្រលាវ	History of Laos
ព្រះបរមរាជវាំង	Royal Palace, Phnom Penh
តារាងអាំងតេក្រាល	Lists of integrals
ព្រាប សុវត្ថិ	Preap Sovath
បន្ទាត់សេកង់	Secant line
ពហុកោណស្មើ	Equilateral polygon
ប្រាសាទតាកែវ	Ta Keo
សម្ដេចប៉ាបហ្វ្រង់សូ័រ	Pope Francis
ព្រះពុទ្ធ​២៨​ព្រះអង្គ	List of the named Buddhas
ទ្រឹស្តីបទតូលេមី	Ptolemy's theorem
Regional Internet registry	Regional Internet registry
គុណវិបត្តិនៃការជក់បារី	Health effects of tobacco
ខ្វែងជ័យបុរី	Sainyabuli Province
ខ្វែងជើងខ្វែង	Xiangkhouang Province
ខេត្តឧត្តមជ័យ	Oudomxay Province
ខេត្តកោះកុង	Koh Kong Province
ខេត្តកណ្ដាល	Kandal Province
ម៉ារី ដូមីនិក ម៉ាសារីលូ	Maria Domenica Mazzarello
ព្រះនាងយសោធរា	Yasodharā
អនុគមន៍បែតា	Beta function
ទ្រឹស្តីបទតង់សង់	Law of tangents
លិង្គ	Lingam
ឌិត ប្រន	Dith Pran
មធ្យមនព្វន្ធ-ធរណីមាត្រ	Arithmetic–geometric mean
កូម៌ៈ	Kurma
អាស៊ីហ្គេមឆ្នាំ១៩៧៤	1974 Asian Games
អាកាសយានដ្ឋានអន្តរជាតិតានសូនណាត្ត	Tan Son Nhat International Airport
KAI T-50 Golden Eagle	KAI T-50 Golden Eagle
ឧបទ្វីបកូរ៉េ	Korean Peninsula
វីគីប្រជុំ	Wikimania
អាស៊ីហ្គេម	Asian Games
ទង់ជាតិសិង្ហបុរី	Flag of Singapore
បង្អួចឆ្នាំ 2000	Windows 2000
តារាងអាំងតេក្រាលនៃអនុគមន៍សនិទាន	List of integrals of rational functions
តារាងអាំងតេក្រាលនៃអនុគមន៍អ៊ីពែបូលីក	List of integrals of hyperbolic functions
សមីការដឺក្រេទី១	Linear equation
តារាងអាំងតេក្រាលនៃអនុគមន៍ច្រាស់អ៊ីពែបូលីក	List of integrals of inverse hyperbolic functions
សញ្ញាជាតិអាហ្វហ្គានីស្ថាន	Emblem of Afghanistan
E-commerce	E-commerce
Sukhoi Superjet 100	Sukhoi Superjet 100
អ្នក​មាន​ជាង​គេ​លើ​ពិភពលោក	The World's Billionaires
គណកម្មាធិការអូឡាំពិកកូរ៉េ	Korean Olympic Committee
កីឡាអាស៊ីខាងកើតឆ្នាំ១៩៩៧	1997 East Asian Games
ច្រកខាន់ម៉ុង	Kanmon Straits
ផ្លាកសញ្ញាចរាចរណ៍នៅកូរ៉េខាងត្បូង	Road signs in South Korea
អាស៊ីហ្គេមឆ្នាំ២០០២	2002 Asian Games
ឆកសមុទ្រលាវតុង	Liaodong Bay
ឆកសមុទ្របូហៃ	Bohai Bay
T-ARA	T-ara
អាស៊ីហ្គេមឆ្នាំ១៩៨៦	1986 Asian Games
អាណាស្រុកម៉ូបាល (អាល់ឡាបាម៉ា)	Mobile County, Alabama
កូរ៉េ	Education in South Korea
ម្កាក់	Spondias dulcis
បារខែម	BarCamp
ដើមត្នោត	Borassus flabellifer
ព្រះបាទសូរ្យវរ្ម័នទី១	Suryavarman I
ខេត្តកំពង់ធំ	Kampong Thom Province
ខេត្តព្រះវិហារ	Preah Vihear Province
ខេត្ត ហួ ផាន់	Houaphanh Province
ខ្វែងអាចម៍ក្រពើ	Attapeu Province
បញ្ជីទីក្រុងនិងទីប្រជុំជននៅកម្ពុជា	List of cities in Cambodia
ខេត្តខាំមួន	Khammouane Province
ខេត្តប៉ៃលិន	Pailin
ឆាយាលក្សសារព័ត៌មាន	Photojournalism
ឧទ្យានជាតិភ្នំគូលែន	Phnom Kulen National Park
បារីសង់	Centroid
វិសមភាពប៊ូល	Boole's inequality
ស៊ីសុវត្ថិ មុនីវង្ស	Sisowath Monivong
អង្គឌួង	Ang Duong
រូបមន្តប្រេឆ្នៃដឺ	Bretschneider's formula
ក្រុមបាល់ទាត់ជម្រើសជាតិ កូរ៉េខាងត្បូង	South Korea national football team
សុញ្ញតា	Śūnyatā
គោលនយោបាយសាធារណៈ	Public policy
ឆកសមុទ្រចាការតា	Jakarta Bay
Xian MA60	Xian MA60
ប្រមា	Malayan porcupine
ភូមិសាស្រ្ដនៃប្រទេសកម្ពុជា	Geography of Cambodia
ស្រុកអន្លង់វែង	Anlong Veng District
កស្ថានីយភ្នំបូកគោ	Bokor Hill Station
នរោត្តម	Norodom of Cambodia
ម៉ាសែលលីន ចាមប៉ាញេត	Marcellin Champagnat
ព្រះបាទយសោវរ្ម័នទី១	Yasovarman I
អេដូអារដូ អាម៉ាល់ឌី	Edoardo Amaldi
Chengdu J-20	Chengdu J-20
វេយ្យាករណ៍អង់គ្លេស	English grammar
ព្រះបាទឥន្រ្ទវរ្ម័នទី១	Indravarman I
ស៊ីឡាត	Silat
ទ្រឹស្តីបទវ្យែត	Vieta's formulas
ប្រាសាទភ្នំបាខែង	Phnom Bakheng
តារាងអាំងតេក្រាលនៃអនុគមន៍អិចស្ប៉ូណង់ស្យែល	List of integrals of exponential functions
តារាងអាំងតេក្រាលនៃអនុគមន៍អសនិទាន	List of integrals of irrational functions
តារាងអាំងតេក្រាលនៃអនុគមន៍លោការីត	List of integrals of logarithmic functions
អាំងតេក្រាលហ្វ្រេនែល	Fresnel integral
គោលនយោបាយសេដ្ឋកិច្ច	Economic policy
ប្រាសាទភិមានអាកាស	Phimeanakas
Baskin​-Robbins បាន	Baskin-Robbins
ទិវាសេរីភាពសារព័ត៌មានពិភពលោក	World Press Freedom Day
ប្រាសាទតាព្រហ្ម	Ta Prohm
អាជ្ញាធរអន្តរកាលសហប្រជាជាតិនៅកម្ពុជា	United Nations Transitional Authority in Cambodia
ប្រាសាទធម្មនន្ទ	Thommanon
អាំងតេក្រាលផ្ទៃ	Surface integral
ប្រាសាទមេបុណ្យខាងលិច	West Mebon
ប្រាសាទបន្ទាយក្តី	Banteay Kdei
ក្រុងសំរោង	Samraong (town)
ប្រាសាទបន្ទាយសំរែ	Banteay Samré
រួបថតនៅក្នុងសង្គ្រាម	War photography
មជ្ឈិមនិកាយ	Majjhima Nikaya
ស្រះស្រង់	Srah Srang
ខេត្តតាកែវ	Takéo Province
បជាបតិគោតមី	Mahapajapati Gotami
លានស្តេចគំលង់	Terrace of the Leper King
ខេត្តហ៊ីរ៉ូស៊ីម៉ា	Hiroshima Prefecture
ព្រះសហគមន៏កាតូលិកភូមិភាគភ្នំពេញ	Apostolic Vicariate of Phnom Penh
បន្ទប់រៀន	Classroom
សេដ្ឋកិច្ចកម្ពុជា	Economy of Cambodia
ជំរំជនភៀសខ្លួន	Refugee camp
ហ្គូតហ្គោល	Google Sites
ទីភ្នាក់ងារសហប្រតិបត្តការអន្តរជាតិកូរ៉េ	Korea International Cooperation Agency
ខេត្តឧត្ដរមានជ័យ	Oddar Meanchey Province
ប្រភេទស្រាទំពាំងបាយជូរពីប្រទេសបារាំង	French wine
អុក	Makruk
បទនគររាជ	Nokor Reach
នគររាជសីមា	Nakhon Ratchasima
ចំនួនអាកស៊ីម៉ែដ	Archimedes number
សង្គ្រាមកម្ពុជា-វៀតណាម	Cambodian–Vietnamese War
តំលៃលើការចាប់អារម្មណ៍	Cost per mille
អនុគមន៍អ៊ីពែបូលីកច្រាស់	Inverse hyperbolic function
កីឡាចុងបូព៌ាឆ្នាំ១៩២៥	1925 Far Eastern Championship Games
បញ្ជីរាយនាម ជ័យលាភីរង្វាន់ណូបែលសន្តិភាព	List of Nobel Peace Prize laureates
១៥០	150 (number)
ស្ទឹងស៊ីលីវូង	Ciliwung
ISO 3166-2:KH	ISO 3166-2:KH
ទ្រឹស្តីបទពីក	Pick's theorem
ខេត្តសៀមរាប	Siem Reap Province
ខេត្តមណ្ឌលគិរី	Mondulkiri Province
ខេត្តកំពង់ស្ពឺ	Kampong Speu Province
ប្រាសាទបាយ័ន	Bayon
អុនសេន	Onsen
ឧត្តមស្នងការអង្គការសហប្រជាជាតិទទួលបន្ទុកសិទ្ធិមនុស្ស	Office of the United Nations High Commissioner for Human Rights
សម រង្ស៊ី	Sam Rainsy
ត្រីតុកកែជ្រូក	Humpback grouper
ធុតង្គ	Dhutanga
ជាតក	Jataka tales
ក្រុងហាកុណិ (ខេត្តកាណាហ្គាវ៉ា)	Hakone, Kanagawa
អនុគមន៍ត្រីកោណមាត្រច្រាស់	Inverse trigonometric functions
ប្រវត្តិសាស្ត្រខ្មែរ	History of Cambodia
ម៉ាជូ ពីជូ	Machu Picchu
គណនីធនាគារ	Bank account
ខ្សែទឹកប្រេស៊ីល	Brazil Current
ក្រុមអសនិក (អាកាសចរណ៍)	Squadron (aviation)
Pilatus PC-7	Pilatus PC-7
អម្ពបាលី	Amrapali
ត្រកៀតប៉ោង	Eichhornia crassipes
ជ្រោយណុតុ	Noto Peninsula
ចតុកោណចារឹកក្នុងរង្វង់	Cyclic quadrilateral
១៣៨	138 (number)
គីឡូម៉ែត្រការ៉េ	Square kilometre
ជី កុង	Ji Gong
ចេននី រីវឺរ៉ា	Jenni Rivera
ពហុកោណនិយ័ត	Regular polygon
ប្រទេសនៅអាស៊ី	List of sovereign states and dependent territories in Asia
១៤៤	144 (number)
ឆកសមុទ្រឡៃចូ	Laizhou Bay
រលួស	Erythrina variegata
១៤០	140 (number)
១៤៣	143 (number)
១៤៧	147 (number)
១៤៦	146 (number)
១៤៩	149 (number)
១៤២	142 (number)
១៣៩	139 (number)
១៤៥	145 (number)
ប្រទេសមួយ ប្រព័ន្ធពីរ	One country, two systems
ត្រកៀត	Pontederiaceae
បណ្តាញផ្លូវហាយវេអាស៊ី	Asian Highway Network
អាស៊ីហ្គេមឆ្នាំ១៩៥៤	1954 Asian Games
អាស៊ីហ្គេមឆ្នាំ១៩៥៨	1958 Asian Games
អាស៊ីហ្គេមឆ្នាំ១៩៦៦	1966 Asian Games
អាស៊ីហ្គេមឆ្នាំ១៩៧៨	1978 Asian Games
អាស៊ីហ្គេមឆ្នាំ១៩៨២	1982 Asian Games
អាស៊ីហ្គេមឆ្នាំ១៩៩០	1990 Asian Games
អាស៊ីហ្គេមឆ្នាំ១៩៩៤	1994 Asian Games
អាស៊ីហ្គេមឆ្នាំ១៩៩៨	1998 Asian Games
Hongdu JL-8	Hongdu JL-8
ឃុំប៉ោយប៉ែត	Poipet (commune)
ច្រកចូហរ	Straits of Johor
ព្រះសង្ឃ	Monk
នគរលូ	Lu (state)
ត្រីរាជ	Mekong giant catfish
ទ្រឹស្តីបទស្តេអាត	Stewart's theorem
Yeghishe Charents	Yeghishe Charents
Siedlnica	Siedlnica
Hongdu L-15	Hongdu L-15
ភាពលំអៀង	Bias
CAC/PAC JF-17 Thunder	CAC/PAC JF-17 Thunder
ខេត្តរតនគិរី	Ratanakiri Province
បញ្ចក្ខន្ធ	Skandha
Gloomy Sunday	Gloomy Sunday
ខេត្តហ្លួងព្រះបាង	Luang Prabang Province
ខេត្តកំពត	Kampot Province
សង្គ្រាមឥណ្ឌូចិនលើកទី១	First Indochina War
ខេត្តស្វាយរៀង	Svay Rieng Province
សង្គាយនា	Buddhist councils
ISO 9362	ISO 9362
ប៉ាកាយ៉ា	Pacaya
ខ្លែងប្រម៉ង់	Collared falconet
ទិវាអក្ខរកម្មអន្តរជាតិ	International Literacy Day
ទ្រឹស្ដីបទការ៉េទាំង៤របស់ឡាហ្គ្រង់	Lagrange's four-square theorem
សុត្តន្តបិដក	Sutta Pitaka
ខេត្តអូគីណាវ៉ា	Okinawa Prefecture
លានជល់ដំរី	Terrace of the Elephants
មឹង អ៊ី	Meng Yi
គណបក្សប្រជាជនកម្ពុជា	Cambodian People's Party
ទន្លេបាទី	Tonle Bati
អាស៊ីខាងត្បូង	South Asia
អាំងតេក្រាលឌីរិចឡេ	Dirichlet integral
កំណាត់រង្វង់	Circular segment
ខេត្តក្រចេះ	Kratié Province
ប្រាសាទបាគង	Bakong
ប្រាសាទបក្សីចាំក្រុង	Baksei Chamkrong
ប្រាសាទបន្ទាយស្រី	Banteay Srei
ប្រាសាទបាពួន	Baphuon
សមីការឌីផេរ៉ង់ស្យែលប៊ែរនូយី	Bernoulli differential equation
កណ្ដុរភ្នំ	Rhizomys
ឃុំបន្ទាយឆ្មារ	Banteay Chhmar
ខេត្តបាត់ដំបង	Battambang Province
តំបន់ត្រីកោណមាស	Golden Triangle (Southeast Asia)
ប្រាសាទបឹងមាលា	Beng Mealea
សង្គ្រាមផ្ទៃក្នុងកម្ពុជា	Cambodian Civil War
ESET	ESET
អាស៊ីហ្គេមរដូវរងារ	Asian Winter Games
ក្រុងយ៉ាណៃ	Yanai
កុសិនារា	Kushinagar
KM	Kilometre
BRIC	BRIC
បញ្ជីព្រះមហាក្សត្រកម្ពុជា	List of monarchs of Cambodia
ផ្លូវកណ្ដាល	Middle Way
ជម្រើសអ្នកប្រើប្រាស់	Consumer choice
ខេត្តពោធិ៍សាត់	Pursat Province
វិស័យអប់រំនៅប្រទេសជប៉ុន	Education in Japan
ខេត្តស្ទឹងត្រែង	Stung Treng Province
ប្រព័ន្ធគោល	Radix
ក្រុមប្រឹក្សាអូឡាំពិកអាស៊ី	Olympic Council of Asia
McDonnell Douglas F-15E Strike Eagle	McDonnell Douglas F-15E Strike Eagle
២៤២	242 (number)
តារាងអាំងតេក្រាលនៃអនុគមន៍ត្រីកោណមាត្រ	List of integrals of trigonometric functions
ច្រកកាលីម៉ាតា	Karimata Strait
បញ្ជី ប្រទេស មានចំនួនអ្នកអានសៀវភៅ	List of countries by literacy rate
សារមន្ទីរទួលស្លែង	Tuol Sleng Genocide Museum
ខេត្តកែប	Kep Province
ទ្រឹស្តីបទវីវីអានី	Viviani's theorem
បញ្ជីអ្នកទទួលបានជ័យលាភីណូបែលខាងរូបវិទ្យា	List of Nobel laureates in Physics
VietJet Air	VietJet Air
ភវវម៌្មទី១	Bhavavarman I
ក្រុងសិរីសោភ័ណ	Sisophon
ក្រុងកំពង់ចាម	Kampong Cham (city)
សាកលវិទ្យាល័យ ចុឡាលុងករណ៍	Chulalongkorn University
Gallery of dependent territory flags	Gallery of flags of dependent territories
អនុគមន៍ស៊ីនុសកាឌីណាល់	Sinc function
ខេត្តព្រៃវែង	Prey Veng Province
បញ្ជីរាយនាម សេដ្ឋវិទូ	List of economists
អនុគមន៍ពហុហ្គាំម៉ា	Polygamma function
ទ្រឹស្តីបទកូស៊ី-អាដាម៉ា	Cauchy–Hadamard theorem
គណៈកម្មាធិការជាតិអូឡាំពិកកម្ពុជា	National Olympic Committee of Cambodia
កប្ប	Kalpa (aeon)
ខ្សែទឹកអេក្វាទ័រខាងជើង	North Equatorial Current
សាធារណរដ្ឋប្រជាមានិតកម្ពុជា	People's Republic of Kampuchea
នគរវ្នំ	Kingdom of Funan
ក្រុងកំពត	Kampot (town)
ខេត្តកំពង់ឆ្នាំង	Kampong Chhnang Province
ស៊ីហ្គេម	Southeast Asian Games
ទ្រឹស្តីបទមេដ្យាន	Apollonius' theorem
ISO 3166-3	ISO 3166-3
ព្រះនាងមាយា	Maya (mother of Buddha)
គុនីងអាន	Kuningan
ព្រះបាទជ័យវរ្ម័នទី៣	Jayavarman III
ស៊ីសុវត្ថិ	Sisowath of Cambodia
ពោធិបក្ខិយធម៌	Bodhipakkhiyādhammā
ពោជ្ឈង្គ៧	Seven Factors of Enlightenment
ព្រហ្មវិហារធម៌	Brahmavihara
បាល់ទាត់កញ្ចុំផ្កាយ	Galactik Football
ការ​បញ្ចាំង​ស្លាយ	Diaporama
វីគីភីឌាភាសាខ្មែរ	Volatile organic compound
ប្រទេសនៅអាមេរិកខាងត្បូង	List of sovereign states and dependent territories in South America
ចំប៉ីសៀម	Adenium
ជំនួយ:មាតិកា	Help:Contents
ស៊ីហ្គេមលើកទី២៣	2005 Southeast Asian Games
ច្បាប់ប្រលេឡូក្រាម	Parallelogram law
The Phnom Penh Post	The Phnom Penh Post
ចំនុចប៊្រូការ	Brocard points
ទ្រឹស្តីបទកន្លះបន្ទាត់ពុះមុំ	Angle bisector theorem
AgustaWestland Apache	AgustaWestland Apache
សាលាប្រព័ន្ធសាលារដ្ឋស្រុកម៉ូបាល	Mobile County Public School System
ភ្នំភ្លើងអ៊ីស៊ាឡឺកធ្វើអោយខកខានការហោះហើរនៅអឺរ៉ុប	Air travel disruption after the 2010 Eyjafjallajökull eruption
មីក្រូម៉ែត្រការ៉េ	Orders of magnitude (area)
ព្រៃវែង	Prey Veng (city)
ធនធានដែលមិនកកើតឡើងវិញ	Non-renewable resource
ខ្សែទឹកអៀមីងហ្គើរ	Irminger Current
ស៊ីហ្គេមលើកទី១១	1981 Southeast Asian Games
ជួរភ្នំដងរែក	Dângrêk Mountains
ប៉ាណរវដ្ឋ កិតតិករចម្រើន	Apichet Kittikorncharoen
ប្រាសាទព្រះខ័ន	Preah Khan
វិសមភាព ហាតឌី	Hardy's inequality
រូបមន្តញូតុន-កូត្ស	Newton–Cotes formulas
មធ្យមលោការីត	Logarithmic mean
មធ្យមស្តូឡារស្គី	Stolarsky mean
កបិលវត្ថុ	Kapilavastu
ភ្នំគូលេន	Phnom Kulen
ទីភ្នាក់ងារសហប្រតិបត្តិការអន្តរជាតិជប៉ុន	Japan International Cooperation Agency
ស្វាកន្ទុយស	Black-shanked douc
ប្រាសាទភ្នំក្រោម	Phnom Krom
Nanchang Q-5	Nanchang Q-5
ស៊ីហ្គេមលើកទី២១	2001 Southeast Asian Games
រាត្រីមួយក្រោយសង្គ្រាម	One Evening After the War
ពិធីបុណ្យមាឃបូជា	Magha Puja
ប្រដាល់សេរី	Pradal serey
សុន សេន	Son Sen
គណកម្មាធិការអូឡាំពិកជប៉ុន	Japanese Olympic Committee
ចំនួនតេត្រាអែក	Tetrahedral number
ក្រុងកំពង់ធំ	Kampong Thom (city)
អង់រីកូ ពែរស៊ីកូ	Enrico Persico
ឧបាលិ	Upali
ភ្នំដា	Angkor Borei and Phnom Da
អាំងតេក្រាលសេកង់គូប	Integral of secant cubed
អាំងតេក្រាលអយល័រ	Euler integral
ព្រះពុទ្ធសាសនា​នៅ​ស្រីលង្កា	Buddhism in Sri Lanka
ចំណុចរំពុះ	Boiling point
Coats of arms of dependent territories	Gallery of coats of arms of dependent territories
ក្រុងប៉ោយប៉ែត	Poipet
តារាងលីមីត	List of limits
វិសមភាពភីដូ	Pedoe's inequality
វិសមភាព អឺមីត-អាដាម៉ា	Hermite–Hadamard inequality
របាំព្រះរាជទ្រព្យ	Royal Ballet of Cambodia
ក្រុងកំពង់ឆ្នាំង	Kampong Chhnang (city)
តារាងអាំងតេក្រាលនៃអនុគមន៍ច្រាស់ត្រីកោណមាត្រ	List of integrals of inverse trigonometric functions
គណកម្មាធិការអូឡាំពិកជាតិសិង្ហបុរី	Singapore National Olympic Council
ត្រៃលក្ខណ៍	Three marks of existence
អាកាសយានដ្ឋានអន្តរជាតិភ្នំពេញ	Phnom Penh International Airport
វិសមភាពហាតវីហ្គឺហ្វីនស្លឺ	Hadwiger–Finsler inequality
ព្រះនិព្វាន៤ថ្នាក់	Four stages of enlightenment
វិសមភាពអូណូ	Ono's inequality
សាធារណរដ្ឋខ្មែរ	Khmer Republic
អក្សរខ្មែរ	Khmer alphabet
អាកាសយានដ្ឋានអន្តរជាតិសៀមរាបអង្គរ	Siem Reap International Airport
បច្ចេកវិទ្យាសារពត៌មាន	Online journalism
ក្មេងទំនើង	Juvenile delinquency
ចេនឡា	Chenla Kingdom
វិសមភាព ហ្គោលដិន-ថមសុន	Golden–Thompson inequality
ប្រកែកនយោបាយថៃ ស.ក.២០១០	2010 Thai political protests
ស្ដេចចក្រពត្តិ	Chakravartin
តថាគត	Tathāgata
វិភង្គ	Vibhanga
បុគ្គលបញ្ញត្តិ	Puggalapannatti
ប្រាសាទនាគព័ន្ធ	Neak Pean
ជា ស៊ីម	Chea Sim
នគរឆឹន	Chen (state)
ប្រព័ន្ធផ្សព្វផ្សាយសុក្រិត្យ	Social media optimization
អាំងតេក្រាលប្តូរអថេរ	Integration by substitution
កម្មវីធីសូនីវីហ្គាស	Sony Vegas Pro
ស៊ីហ្គេមលើកទី២៥	2009 Southeast Asian Games
ខ្សែទឹកអេក្វាទ័រខាងត្បូង	South Equatorial Current
សិក្ខាបទ៥	Five Precepts
ការប្រកួតកីឡាជើងឯកចុងបូព៌ា	Far Eastern Championship Games
កងទ័ពអេហ្ស៊ីប	Egyptian Armed Forces
ប្រាសាទប្រែរូប	Pre Rup
ប្រាសាទក្រវាន់	Prasat Kravan
តារាងដេរីវេ	Differentiation rules
មេកានិច​សូលីដ	Solid mechanics
ការប្រកួតកីឡា កម្ពុជា	Cambodian League
ប្រាសាទព្រះគោ	Preah Ko
ប្រាសាទលលៃ	Lolei
ក្បាលស្ពាន	Kbal Spean
ប្រាសាទតាសោម	Ta Som
ស្ពានថ្ម	Spean Thma
អនុគមន៍ស្ករ៉ឺ	Scorer's function
មធ្យមធរណីមាត្រ-អាម៉ូនិក	Geometric–harmonic mean
CAIC Z-10	CAIC Z-10
អាំងតេក្រាលត្រីកោណមាត្រ	Trigonometric integral
សមីការឌីផេរ៉ងស្យែលក្លែរ៉ូ	Clairaut's equation
សាសនា សកល	Religious symbol
រូបមន្តបេយ៉ា	Bellard's formula
វិមានឯករាជ្យ	Independence Monument (Cambodia)
ទ្រឹស្តីបទផលគុណកត្តា	Factor theorem
ប្រតិទិនឈប់សំរាកប្រចាំឆ្នាំ២០០៨	Public holidays in Cambodia
ខ្សែទឹកណរវេយ	Norwegian Current
ទង់ព្រះពុទ្ធសាសនា	Buddhist flag
វិសមភាពញូតុន	Newton's inequalities
មករ	Makara (Hindu mythology)
ISO 3166-1 alpha-2	ISO 3166-1 alpha-2
តំបន់អឌ្ឍច័ន្ទមាស	Golden Crescent
សហរដ្ឋ	Political union
អាស៊ីហ្គេមលើឆ្នេរខ្សាច់	Asian Beach Games
បណ្ឌិត្យ​សភា​នីតិ​អន្តរជាតិ​នៃ​ទីក្រុង​ឡាអេ	Hague Academy of International Law
ស៊ីហ្គេមលើកទី២៦	2011 Southeast Asian Games
សម្រែកនៃដុលោរ៉េស៏	Grito de Dolores
ប្រពលវប្បកម្ម	Intensive farming
សមភាពការ៉េទាំង៤របស់អឺលែរ	Euler's four-square identity
ស៊េរីត្រីកោណមាត្រ	Trigonometric series
រូបមន្តប្រាម៉ាហ្គឹបតា	Brahmagupta's formula
មហាភូតរូប	Mahābhūta
Shenyang J-11	Shenyang J-11
មុំក្នុង	Internal and external angle
ផលបូក រីម៉ាន	Riemann sum
ប្រាសាទអ៊ីវ៉ាឃឹនី	Iwakuni Castle
សមីការហ៊ីល	Hill differential equation
សេដ្ឋកិច្ចតំបន់ អាសីុ	Economy of Asia
គ្រឹះស្ថានឧត្តមសិក្សាសាធារណៈនៅប្រទេសជប៉ុន	List of national universities in Japan
កីឡាអាស៊ីខាងកើតឆ្នាំ១៩៩៣	1993 East Asian Games
កីឡាចុងបូព៌ាឆ្នាំ១៩៣៨	1938 Far Eastern Championship Games
សមភាពការ៉េទាំង៨របស់ដេហ្គេន	Degen's eight-square identity
មធ្យមហេរ៉ុង	Heronian mean
វិសមភាព វេតស្សឹនបុក	Weitzenböck's inequality
រូប	Rūpa
Kawasaki OH-1	Kawasaki OH-1
កីឡាអាស៊ីខាងកើត	East Asian Games
ស៊ីហ្គេមលើកទី២០	1999 Southeast Asian Games
បុណ្យ តារា	Tanabata
ក្រុមមិត្តភក្តិ (Peer group)	Peer group
ក្រុងតាកែវ	Takéo
ស្ពានឃីងតៃ	Kintai Bridge
សមីការកូស៊ី-អយល័រ	Cauchy–Euler equation
ស្ពានខាន់ម៉ុងក្យូ	Kanmon Bridge
កីឡាអាស៊ីខាងត្បូង	South Asian Games
OSGeo	Open Source Geospatial Foundation
វិគីភីឌា:ស្ថានទូតខ្មែរ	Wikipedia:Embassy
Bottleneck	Bottleneck
ប្រៃសណីយ៍ភ័ណ្ឌ	Parcel post
ស៊ីហ្គេមលើកទី១៩	1997 Southeast Asian Games
ស៊ីហ្គេមលើកទី២៧	2013 Southeast Asian Games
ស៊ីហ្គេមលើកទី១៧	1993 Southeast Asian Games
ស៊ីហ្គេមលើកទី១០	1979 Southeast Asian Games
រាជវង្សហុងបាង	Hồng Bàng dynasty
ស៊ីហ្គេមលើកទី២៤	2007 Southeast Asian Games
ស៊ីហ្គេមលើកទី១៤	1987 Southeast Asian Games
កីឡាចុងបូព៌ាឆ្នាំ១៩១៧	1917 Far Eastern Championship Games
ទីឃនិកាយ	Digha Nikaya
នវវិទ្យា	Neology
រដ្ឋសភាជាតិកម្ពុជា	National Assembly (Cambodia)
អនុគមន៍ទ្រីហ្គាំម៉ា	Trigamma function
ហ្វ្រង់កូ រ៉ាសិតទី	Franco Rasetti
ខ្សែទឹករង្វល់របស់មហាសមុទ្រ	Ocean gyre
វ៉ន វេត	Vorn Vet
បញ្ជីរាយនាម កោះនៅកម្ពុជា	List of islands of Cambodia
វិទ្យុតាមអ៊ីនធើណែត	Digital radio
ខ្សែទឹកហ្គ្រីនលែនខាងលិច	West Greenland Current
តូនី វ៉ាការ៉ូ	Tony Vaccaro
កោះទន្សាយ	Koh Thonsáy
អាន ដ្យឿង វឿង	An Dương Vương
ខ្សែទឹកកោះបាហ្វហ្វីន	Baffin Island Current
ខ្មែរលើ	Khmer Loeu
នគរតាវ	Dao (state)
កីឡាឧបទ្វីបអាស៊ីអាគ្នេយ៍លើកទី៣	1965 Southeast Asian Peninsular Games
កីឡាឧបទ្វីបអាស៊ីអាគ្នេយ៍លើកទី៤	1967 Southeast Asian Peninsular Games
កីឡាឧបទ្វីបអាស៊ីអាគ្នេយ៍លើកទី៦	1971 Southeast Asian Peninsular Games
កីឡាឧបទ្វីបអាស៊ីអាគ្នេយ៍លើកទី៨	1975 Southeast Asian Peninsular Games
វិសមភាពស្យ៉ឺរ	Schur's inequality
គមនាគមន៍កម្ពុជា	Transport in Cambodia
អនុគមន៍ហ្គុឌែរម៉ាន់	Gudermannian function
វិធីសាស្រ្តហ្រ្វូបេនៀស	Frobenius method
សាកលវិទ្យាល័យអាគីតា	Akita University
ចន វ៉នណុក	John Warnock
អភិបាលកិច្ចល្អ	Good governance
ឃុនបរម	Khun Borom
មួយម៉ូនីកា	Agnez Mo
Candies	Candies (group)
កីឡាឧបទ្វីបអាស៊ីអាគ្នេយ៍លើកទី១	1959 Southeast Asian Peninsular Games
កីឡាអាស៊ីកណ្ដាល	Central Asian Games
កីឡាអាស៊ីខាងកើតឆ្នាំ២០០៥	2005 East Asian Games
កីឡាឧបទ្វីបអាស៊ីអាគ្នេយ៍លើកទី២	1961 Southeast Asian Peninsular Games
ស៊ីហ្គេមលើកទី១៦	1991 Southeast Asian Games
ស៊ីហ្គេមលើកទី១៥	1989 Southeast Asian Games
ស៊ីហ្គេមលើកទី១៨	1995 Southeast Asian Games
កីឡាឧបទ្វីបអាស៊ីអាគ្នេយ៍លើកទី៧	1973 Southeast Asian Peninsular Games
កីឡាអាស៊ីខាងកើតឆ្នាំ២០០១	2001 East Asian Games
សាកលវិទ្យាល័យហ្វឹគឹអ៊ី	University of Fukui
ខ្មែរក្រោម	Khmer Krom
ស៊ីហ្គេមលើកទី២២	2003 Southeast Asian Games
ស៊ីហ្គេមលើកទី១៣	1985 Southeast Asian Games
ស៊ីហ្គេមលើកទី១២	1983 Southeast Asian Games
ទ្រឹស្តីបទកាសី	Casey's theorem
សមាគមអូឡាំពិកឥណ្ឌា	Indian Olympic Association
កីឡាចុងបូព៌ាឆ្នាំ១៩១៥	1915 Far Eastern Championship Games
កីឡាចុងបូព៌ាឆ្នាំ១៩១៣	1913 Far Eastern Championship Games
ប្រាសាទព្រះប៉ាលីឡៃ	Preah Palilay
សុខ អាន	Sok An
ស្រុកកំពង់ត្រាច	Kampong Trach District
ក្រុងបាវិត	Bavet
ស្រុកសំឡូត	Samlout District
ស្រុកថ្មពួក	Thma Puok District
ស្រុកព្រះនេត្រព្រះ	Preah Netr Preah District
ស្រុកកោះកុង	Koh Kong District
ស្រុកកំពង់ត្រឡាច	Kampong Tralach District
ESET NOD32 Antivirus	ESET NOD32
ស្រីសុរិយោពណ៌ទី២	Ponhea Yat
កេង វ៉ាន់សាក់	Keng Vannsak
វិគីភីឌា:Glossary	Wikipedia:Glossary
នីវរណធម៌	Five hindrances
បុណ្យ	Merit (Buddhism)
ចំណាត់ថ្នាក់ក្រុម:ប្រទេសជប៉ុន	Category:Japan
ចំណាត់ថ្នាក់ក្រុម:ម៉ិកសិច	Category:Mexico
វិធីសាស្រ្តក្នុងការទំនាក់ទំនង	Models of communication
ទ្រឹស្តីបទប្រាម៉ាហ្គឹបតា	Brahmagupta theorem
ចេមនិងផ្លែប៉ែសយក្ស	James and the Giant Peach
ស្ងោរជ្រក់សាច់មាន់	Chicken soup
បន្ទប់សារពត៌មាន	Newsroom
ចំណាត់ថ្នាក់ក្រុម:ឥណ្ឌូនេស៊ី	Category:Indonesia
ចំណាត់ថ្នាក់ក្រុម:សិង្ហបុរី	Category:Singapore
ចំណាត់ថ្នាក់ក្រុម:រូបវិទ្យា	Category:Physics
ចំណាត់ថ្នាក់ក្រុម:វិទ្យាសាស្រ្តធម្មជាតិ	Category:Natural sciences
ចំណាត់ថ្នាក់ក្រុម:ជីវវិទ្យា	Category:Biology
ចំណាត់ថ្នាក់ក្រុម:សាសនា	Category:Religion
ចំណាត់ថ្នាក់ក្រុម:កីឡា	Category:Sports
ចំណាត់ថ្នាក់ក្រុម:វិទ្យាសាស្ត្រ	Category:Science
ប្រជាមតិទាក់ទងនឹងឯករាជភាពរបស់ស្កុតឡែនឆ្នំា២០១៤	Scottish independence referendum, 2014
សំយុត្តនិកាយ	Samyutta Nikaya
សំយោជនៈ	Rebirth (Buddhism)
សាសនាក្នុងប្រទេសចិន	Religion in China
ខួច​គូថ	Rhombus of Michaelis
G8+5	G8+5
ចំនួនហ្គាលីលេ	Galilei number
ត្រីគល់រាំង	Giant barb
ប្រវត្តិសាស្រ្តរបស់ទូរទស្សន៍	History of television
ប្រវត្តិវិទ្យុ	History of radio
ប្រវត្តិសាស្រ្តអ្នកកាសែត	History of journalism
ប្រវត្តិច្បាប់រក្សាសិទ្ធ	History of copyright law
Honda HA-420 HondaJet	Honda HA-420 HondaJet
ទ្រឹស្ដីនៃពណ៌	Color theory
នើនដូ	Steinberg Nuendo
នពតល ប៉័ទមៈ	Noppadon Pattama
ស្ករត្នោត	Palm sugar
អង្គាបុស្ប	Millingtonia
Guizhou JL-9	Guizhou JL-9
ប្រាសាទភ្នំជីសូរ	Phnom Chisor
កោះរុង	Koh Rong
ស្ដង់ដា	Standard
ចំនុចកណ្ដាល	Midpoint
ខុទ្ទកនិកាយ	Khuddaka Nikaya
ចាន់ ស៊ី	Chan Sy
ប៉ាន់ រិទ្ធី	Rithy Panh
ជីវក	Jivaka Kumar Bhaccha
សាកលវិទ្យាល័យកម្ពុជា	University of Cambodia
សាកលវិទ្យាល័យភូមិន្ទភ្នំពេញ	Royal University of Phnom Penh
ទំព័រគំរូ:Dts	Template:Dts
បុណ្យកឋិន	Kathina
គែន	Khene
វិសមភាព កុលហ្គោម៉ូរ៉ូវ	Kolmogorov's inequality
ទីក្រុងរ៉ូមបុរាណ	Ancient Rome
ទំព័រគំរូ:Box-footer	Template:Box-footer
កន្ថឹកក្បាលឆ្នូត	Northern smooth-tailed treeshrew
រឹសគូប	Cube root
ប្រាសាទកោះកេរ	Koh Ker
នរោត្ដម សុរាម្រិត	Norodom Suramarit
អាស៊ីហ្គេមអ៊ីនដរ	Asian Indoor Games
Airbus A318	Airbus A318
អាំងតេក្រាលមាឌ	Volume integral
ការវាយប្រហារដែនអាកាសនៅទីក្រុងបេកដាត ថ្ងៃទី ១២ កក្តដា ២០០៧	July 12, 2007 Baghdad airstrike
ទ្រឹស្តីបទរូទ	Routh's theorem
ក្លឹបបាល់ទាត់ ភ្នំពេញក្រោន	Phnom Penh Crown FC
សញ្ញាណលោការីត	List of logarithmic identities
វត្តភ្នំ	Wat Phnom
ប្រាសាទសំបូរព្រៃគុក	Sambor Prei Kuk
គណបក្សសិទ្ធិមនុស្ស	Human Rights Party (Cambodia)
កោះត្រឡាច	Côn Sơn Island
ក្រុមហ៊ុនអាកាសចរណ៏រ៉ូយ៉ាល់ខ្មែរអ៊ែរឡាញ	Royal Khmer Airlines
អាគីតា	Akita
ស្រុកត្បែងមានជ័យ	Tbaeng Meanchey District
ស្រុកពួក	Puok District
ស្រុកក្រឡាញ់	Kralanh District
ស្រុកជីក្រែង	Chi Kraeng District
ស្រុកអង្គរជុំ	Angkor Chum District
ស្រុកស្រីសន្ធរ	Srey Santhor District
ខណ្ឌទួលគោក	Toul Kork District
ទ្រឹស្ដីបទវ៉ារីញ៉ុង	Varignon's theorem
អនុគមន៍ហ្សេតាបឋម	Prime zeta function
ចំណាយរដ្ឋាភិបាល	Government spending
ប្រវត្តិសាស្ត្រខ្មែរដំបូង	Early history of Cambodia
សារមន្ទីរជាតិ	National Museum of Cambodia
ឧទ្យានជាតិព្រះសុរាម្រិតកុសុមៈគិរីរម្យ	Kirirom National Park
អ្នកសារពត័មាន	Journalist
រង្វង់ប៊្រូការ	Brocard circle
ប៉ែន សុវណ្ណ	Pen Sovan
ស្រុកមង្គលបុរី	Mongkol Borey District
ក្រុងតាខ្មៅ	Ta Khmao
ចំណាត់ថ្នាក់ក្រុម:អូឡាំពិក	Category:Olympic Games
ចំណាត់ថ្នាក់ក្រុម:ព្រះពុទ្ធសាសនា	Category:Buddhism
វប្បធម៍បារាំង	Culture of France
ប្រទេសនៅអាមេរិកខាងជើង	List of sovereign states and dependent territories in North America
បញ្ជីឈ្មោះអនុគមន៍គណិតវិទ្យា	List of mathematical functions
ស្ពានប្រាប់ទិស	Spean Praptos
ប្រអប់ខ្សាច់	Sandbox
Open Access Week	Open Access Week
ណូរី	Norry
ស្ថានីយទូរទស្សន៍	Television channel
ពហុកីឡដ្ឋានជាតិអូឡាំពិក	Olympic Stadium (Phnom Penh)
កិច្ចតែងការ	Lesson plan
ព្រះពុទ្ធសាសនានៅប្រទេសបារាំង	Buddhism in France
ឈិង	Ching (instrument)
សាលាសាធារណៈឡូវែល	Lowell Public Schools
ជំងឺរលាកបំពង់ក	Pharyngitis
ទេសចរបារាំង	Tourism in France
កម្ពុជាសម័យលង្វែក	Longvek
ឃុំប្រាសាទ (ស្រុកព្រះនេត្រព្រះ)	Prasat
អាកាសយានដ្ឋានអន្តរជាតិក្រុងព្រះសីហនុ	Sihanoukville International Airport
អង្គការសង្គមអភិរក្សសត្វព្រៃ	Wildlife Conservation Society
សាកលវិទ្យាល័យអប់រំអៃឈិ	Aichi University of Education
ការដឹងគ្រប់គ្រាន់នៃវិធីដកដង្ហើម១៦យ៉ាង	Anapanasati
សញ្ញាណត្រីកោណខុនវេ	Conway triangle notation
នគរគ័រខាងកើត	Eastern Guo
ចម្ប៉ា	Magnolia × alba
ស្រុកមេមត់	Memot District
ស្រុកលំផាត់	Lumphat District
ឧទ្យានជាតិវីរៈជ័យ	Virachey National Park
ទំព័រគំរូ:Lang-ta	Template:Lang-ta
បរិស្ថាន	Environment (biophysical)
ស៊ុកូឡា	History of chocolate in Spain
យ៉ាបា	Ya ba
ចំនួនអូតូម៉ហ្វីស	Automorphic number
អូរកែវ	Óc Eo
ពហុធាប៊ែរនូយី	Bernoulli polynomials
ច្បាប់កំលាំងរបស់អំពែរ	Ampère's force law
ព្រះធម្មចក្កប្បវត្តនសូត្រ	Dhammacakkappavattana Sutta
សមីការឌីផេរ៉ង់ស្យែល -អាំងតេក្រាល	Integro-differential equation
ប្រាសាទព្រះពិធូរ	Preah Pithu
ការផ្សាយពាណិជ្ជកម្ម	Display advertising
អ្នកលឿង	Neak Leung
ឃុំរលួស (ស្រុកស្វាយចេក)	Roluos
ខេត្តបលិខាំសៃ	Bolikhamsai Province
ខណ្ឌរដ្ឋបាលសាលាភីឡាដេលផ្យា	School District of Philadelphia
ស្ពានព្រះមុនីវង្ស	Monivong Bridge
ភ្នំឧដុង្គ	Oudong
ទ្រឹស្តីបទមីកេល	Miquel's theorem
វិសាខា	Visakha
ជនជាតិចារាយ(ខ្មែរលើ)	Jarai people
អនុស័យ​	Anasuya
ស្ថាបត្យករខ្មែរ	Khmer architecture
តារាងនៃស៊េរីគណិតវិទ្យា	List of mathematical series
ប្រាសាទតានៃ	Ta Nei
ចំងាយពីចំនុចមួយទៅបន្ទាត់	Distance from a point to a line
ទូរគមនាគមន៍នៅប្រទេសកម្ពុជា	Telecommunications in Cambodia
ធម្មសង្គណី	Dhammasangani
ចៅ​សែន​ កុសល​ឈុំ	Chau Sen Cocsal Chhum
ចំណូលរដ្ឋាភិបាល	Government revenue
អភិញ្ញា៦	Abhijñā
ចំនួនថេរត្រីកោណមាត្រពិត	Exact trigonometric constants
បណ្ណាល័យជាតិកម្ពុជា	National Library of Cambodia
បដ្ឋាន	Patthana
កថាវត្ថុ	Kathavatthu
ធាតុកថា	Dhatukatha
ម៉ោងនៅឥណ្ឌូនេស៊ី	Time in Indonesia
យមក	Yamaka
ជញ្ជាំងក្រហម	Redwall (novel)
ខ្មែរឥស្សរៈ	Khmer Issarak
ព្រះរាជាណាចក្រកម្ពុជា (១៩៥៣-១៩៧០)	Kingdom of Cambodia (1953–70)
វត្តព្រះកែវមរកត	Silver Pagoda, Phnom Penh
រូបមន្តតង់សង់កន្លះមុំ	Tangent half-angle formula
ដប់ប្រាំពីរមេសាជោគជ័យ	Dap Prampi Mesa Chokchey
មហេន្ទ្រវម៌្មទី១	Mahendravarman
អង្គការរៃយំ	Reyum Institute of Arts and Culture
សមីការតូរីចេល្លី	Torricelli's equation
កីឡាចុងបូព៌ាឆ្នាំ១៩១៩	1919 Far Eastern Championship Games
បណ្តុំកន្សោមរ៉ាឌីកាល់	Nested radical
កីឡាចុងបូព៌ាឆ្នាំ១៩២១	1921 Far Eastern Championship Games
ច្បាប់នៃកម្ម	Karma in Buddhism
កោណ្ឌញ្ញៈ	Kaundinya
កីឡាចុងបូព៌ាឆ្នាំ១៩៣០	1930 Far Eastern Championship Games
កីឡាចុងបូព៌ាឆ្នាំ១៩២៧	1927 Far Eastern Championship Games
កីឡាចុងបូព៌ាឆ្នាំ១៩២៣	1923 Far Eastern Championship Games
កីឡាចុងបូព៌ាឆ្នាំ១៩៣៤	1934 Far Eastern Championship Games
WNBT	WNBC
កត្តាអាំងតេក្រាល	Integrating factor
ប្រជាសាស្ត្រនៃកម្ពុជា	Demographics of Cambodia
អ្នកស្រែ	Rice People
ការបោះឆ្នោតនៅកម្ពុជា	Elections in Cambodia
រដ្ឋាភិបាលចម្រុះកម្ពុជាប្រជាធិបតេយ្យ	Coalition Government of Democratic Kampuchea
ភ្លេងបានដា	Banda (music)
ធនាគារអេស៊ីលីដា	ACLEDA Bank
ក្លឹបបាល់ទាត់ បៀលប្រាយយូណាយធីត	Build Bright University FC
សញ្ញាជាតិរបស់បណ្ដាប្រជាជាតិនៅអាស៊ី	National emblems and coats of arms of Asia
ណាយ៉ាន់ ចាន់ដា	Nayan Chanda
ប្រាសាទបាតជុំ	Bat Chum
ទ្រឹស្តីបទអូស្រ្តូស្គី	Ostrowski's theorem
ព្រហ្មជាលសូត្រ	Brahmajala Sutta (Theravada)
បណ្ដាញទូរទស្សន៍កម្ពុជា	Cambodian Television Network
Cambodge Soir	Cambodge Soir
ចំណាត់ថ្នាក់ក្រុម:អត្ថបទខ្លីមិនពេញលេញ	Category:Stubs
ចំណាត់ថ្នាក់ក្រុម:ទ្វីប	Category:Continents
ចំណាត់ថ្នាក់ក្រុម:ភូមិវិទ្យា	Category:Geology
ចំណាត់ថ្នាក់ក្រុម:យន្តហោះ	Category:Aircraft
ឆាលេស ហ្គេសស្គី	Charles Geschke
ពិធីបុណ្យចូលឆ្នាំខ្មែរ	Cambodian New Year
ជា វិជ្ជា	Chea Vichea
ព្រះរាជពិធីច្រត់ព្រះនង្គ័ល	Royal Ploughing Ceremony
កាលប្បវត្តិកម្ពុជា	Timeline of Cambodian history
ប្រវត្តិសិល្បៈភាពយន្តខ្មែរ	Cinema of Cambodia
កីឡាឧបទ្វីបអាស៊ីអាគ្នេយ៍ដែលគ្រងនឹងធ្វើនៅឆ្នាំ១៩៦៣	1963 Southeast Asian Peninsular Games
ខ្សែកោងក្លេលី	Clélie
រស់ សេរីសុទ្ធា	Ros Serey Sothea
យុទ្ធនាការកម្ពុជា	Cambodian Campaign
របាំខ្មែរ	Dance in Cambodia
ជូ ដាវី	Davy Chou
បញ្ជីស្រុក ក្រុង និង ខណ្ឌកម្ពុជា	List of Cambodian districts and sections
ក្រឡាន	Kralan
បឹងយក្សឡោម	Lake Yeak Laom
បសេនទិកោសល	Pasenadi
វីរៈ តារា	Virak Dara
ព្រឹទ្ធសភាកម្ពុជា	Senate (Cambodia)
វ៉ិចទ័រប្រាប់ទិស	Direction vector
អនុគមន៍ដសុន	Dawson function
ខេមបូឌា ដេលី	The Cambodia Daily
វត្តឧណ្ណាលោម	Wat Ounalom
ជនជាតិខ្មែរអ៊ីស្លាម	Islam in Cambodia
វិទ្យាស្ថានពុទ្ធសាសនបណ្ឌិត្យ	Buddhist Institute, Cambodia
កម្ពុជាសម័យអាណានិគមបារាំង	French Protectorate of Cambodia
ទំព័រគំរូ:ប្រព័ន្ធព្រះអាទិត្យ	Template:Solar System table
កឹម សុខា	Kem Sokha
សាលារៀនសាធារណៈស៊ីតថល	Seattle Public Schools
បញ្ជីរាយនាមប្រទេសនៅអាស៊ីតាមចំនួនប្រជាជន	List of Asian countries by population
ទន្លេនៅកម្ពុជា	List of rivers of Cambodia
ទុង សៀន	Dong Xian
មធ្យមពីតាករ	Pythagorean means
ដេរីវេនៃអនុគមន៍ត្រីកោណមាត្រ	Differentiation of trigonometric functions
សេដ្ឋកិច្ចគ្រប់គ្រង	Managerial economics
អនុរុទ្ធ	Anuruddha
ស្រុកភ្នំស្រុក	Phnom Srok District
ឃុំនរា	Norea, Cambodia
ពីរ៉ាមីត	Pyramid (geometry)
មង្គលសូត្រ	Mangala Sutta
និតិភូមិ នវរ័ត្ន	Nitipoom Navaratna
បុណ្យភ្ជុំបិណ្ឌ	Pchum Ben
ពហុធាអាបែល	Abel polynomials
ស្ពានគីហ្សូណា	Kizuna bridge
ស្ពានព្រែកតាមាក់	Prek Tamak Bridge
ការគ្រប់គ្រងរបស់ខ្មែរក្រហមនៅកម្ពុជា	Khmer Rouge rule of Cambodia
ទេវទហៈ	Devadaha
យ៉ូសែប ឆ្មារសាឡាស់	Joseph Chhmar Salas
ស៊ីន ស៊ីសាមុត	Sinn Sisamouth
វិសមភាពបាររ៉ូ	Barrow's inequality
ពន្ធតែមប្រិ៍	Stamp duty
ខុជ្ជុត្តរា	Khujjuttara
ជំនួយ:ការកត់ឈ្មោះចូល	Help:Logging in
តារាង គោល	Table of bases
អង្គការមូលនិធិអាស៊ី	The Asia Foundation
សាកលវិទ្យាល័យអន្តរជាតិ	International University, Cambodia
ការបោះឆ្នោតជ្រើសតាំងតំណាងរាស្ត្រ នីតិកាលទី៥ ឆ្នាំ២០១៣	Cambodian general election, 2013
កន្លះបរិមាត្រ	Semiperimeter
សាកលវិទ្យាល័យ ន័រតុន	Norton University
គ្រោះមហន្តរាយ	Disaster
អនុគមន៍គុយ-តែតតា	Q-theta function
ពិធីបុណ្យអុំទូក	Water Festival
វិគីភីឌា:Reference desk	Wikipedia:Reference desk
ទំព័រគំរូ:Authority control	Template:Authority control
ទំព័រគំរូ:Quote	Template:Quote
ភ្នំសុមេរុ	Sumeru
ទំព័រគំរូ:Wikipedia languages	Template:Wikipedia languages
ទំព័រគំរូ:Location map Scotland	Template:Location map UK Scotland
ទំព័រគំរូ:Location map England	Template:Location map UK England
ចំណាត់ថ្នាក់ក្រុម:សេដ្ឋកិច្ច	Category:Economics
វិគីភីឌា:សុំប្តូរអត្តនាម	Wikipedia:Changing username
ចំណាត់ថ្នាក់ក្រុម:ជនជាតិ ភាគតិច ក្នុង ប្រទេស កម្ពុជា	Category:Ethnic groups in Cambodia
វិគីភីឌា:Oversight	Wikipedia:Oversight
វិគីភីឌា:IP block exemption	Wikipedia:IP block exemption
ចំណាត់ថ្នាក់ក្រុម:Container categories	Category:Container categories
វិគីភីឌា:រូបយន្ត	Wikipedia:Bots
ចំណាត់ថ្នាក់ក្រុម:Hidden categories	Category:Hidden categories
សមីការឌីផេរ៉ង់ស្យែលទ្វេធា	Binomial differential equation
ទេវតា	Deva (Buddhism)
ក្រលាផ្ទៃរង្វង់	Area of a disk
វិសមភាពភីត្រឹ	Peetre's inequality
ទំព័រគំរូ:WP:UBS	Template:WP:UBS
អេហ៊្សីប	Egypt
វេយ្យាករណ៍ភាសាខ្មែរ	Khmer grammar
ជំនួយ:ទំព័រគំរូ	Help:Template
ឦសានវម៌្មទី១	Isanavarman I
វិគីភីឌា:វិគីគម្រោង	Wikipedia:WikiProject
ខុទ្ទកបាឋ	Khuddakapatha
ក្រសួងការបរទេស និងសហប្រតិបត្តិការអន្តរជាតិ	Ministry of Foreign Affairs and International Cooperation (Cambodia)
ទំព័រគំរូ:Bot	Template:Bot
វិគីភីឌា:អ្វីៗដែលវិគីភីឌាមិនអនុញ្ញាត	Wikipedia:What Wikipedia is not
ឧទ្យានជាតិបុទុមសាគរ	Botum Sakor National Park
អាម៉ុក	Amok trey
កាណាដា	Canada
វិសមភាព ស្ទេហ្វេនសេន	Steffensen's inequality
ចំណាត់ថ្នាក់ក្រុម:ប្រទេសអាយឡែន	Category:Iceland
វិគីភីឌា:អំពីវិគីភីឌា	Wikipedia:About
ចំណាត់ថ្នាក់ក្រុម:ខ្នាតក្រលាផ្ទៃ	Category:Units of area
ជំនួយ:ពាក្យទិព្វ	Help:Magic words
សហព័ន្ធខ្មែរកម្ពុជាក្រោម	Khmers Kampuchea-Krom Federation
វិគីភីឌា:Database reports	Wikipedia:Database reports
ទំព័រគំរូ:Flagicon	Template:Flagicon
ចំណាត់ថ្នាក់ក្រុម:អឺរ៉ុប	Category:Europe
ចំណាត់ថ្នាក់ក្រុម:បច្ចេកវិទ្យា	Category:Main topic classifications
ចំណាត់ថ្នាក់ក្រុម:ជំនួយក្នុងវិគីភីឌា	Category:Wikipedia help
វិគីភីឌា:ទំព័រអ្នកប្រើប្រាស់	Wikipedia:User pages
វិគីភីឌា:ព្រឹត្តិការណ៍​ថ្មីៗ	Portal:Current events
ទំព័រគំរូ:Documentation	Template:Documentation
វិគីភីឌា:អ្នកប្រើប្រាស់	Wikipedia:User access levels
ចំណាត់ថ្នាក់ក្រុម:Wikipedia pages with incorrect protection templates	Category:Wikipedia pages with incorrect protection templates
វិគីភីឌា:Protection policy	Wikipedia:Protection policy
អាជ្ញាធរអប្សរា	APSARA
វិគីភីឌា:WikiLove	Wikipedia:WikiLove
វិគីភីឌា:Userboxes	Wikipedia:Userboxes
វិគីភីឌា:ហត្ថលេខា	Wikipedia:Signatures
វិគីភីឌា:អត្ថបទខ្លីមិនពេញលេញ	Wikipedia:Stub
វិគីភីឌា:លក្ខណៈវិនិច្ឆ័យនៃលុបជាបន្ទាន់	Wikipedia:Criteria for speedy deletion
វិគីភីឌា:Most wanted articles	Wikipedia:Requested articles
អភិធម្មត្ថសង្គហ	Abhidhammattha-sangaha
ចំណាត់ថ្នាក់ក្រុម:ទំព័រអសង្ស័យកម្ម អំពីឈ្មោះទីកន្លែង	Category:Place name disambiguation pages
គណៈកម្មាធិការទទួលស្គាល់គុណភាពអប់រំនៃកម្ពុជា	Accreditation Committee of Cambodia
្ឞ្ញ ហ្សអិ-អិអៀ	Sung Jae-gi
កសិកម្មនៅកម្ពុជា	Agriculture in Cambodia
Aki Ra	Aki Ra
ខេត្តមេគង្គ	Cửu Long Province
ទំព័រគំរូ:Facebook navbox	Template:Facebook navbox
អនត្តលក្ខណសូត្រ	Anattalakkhana Sutta
ឃុំអណ្តើកហែប	Andaeuk Haeb
ស្រុកអណ្តូងមាស	Andoung Meas District
ស្រុកអង្គស្នួល	Angk Snuol District
ស្រាបៀរ អង្គរ	Angkor Beer
ឃុំអង្គរបាន (ស្រុកសំពៅលូន)	Angkor Ban
ស្រុកអង្គរបុរី	Angkor Borei District
ស្រុកអង្គរជ័យ	Angkor Chey District
សាកលវិទ្យាល័យអង្គរ	Angkor University
ស្រុកអង្គរធំ	Angkor Thom District
ឃុំអន្លង់រុន	Anlong Run
ឃុំអន្លង់វិល	Anlong Vil
ស្រុកឱរ៉ាល់	Aoral District
វិគីភីឌា:Huggle	Wikipedia:Huggle
អ្នកយកការណ៍នៅទ្វីបអាស៊ី (Asian Correspondent)	Asian Correspondent
វិសមភាព អាស្គី-ហ្គាស្ពើ	Askey–Gasper inequality
ស្រុកបាភ្នំ	Ba Phnum District
ទំព័រគំរូ:Softredirect	Template:Soft redirect
ទំព័រគំរូ:លុបជាបន្ទាន់	Template:Db
ស្រុកបាកាន	Bakan District
ស្រុកបាណន់	Banan District, Battambang Province
ស្រុកបានលុង	Banlung District
ឃុំបន្សាយត្រែង	Bansay Traeng
ស្រុកបន្ទាយអំពិល	Banteay Ampil District
ស្រុកបន្ទាយមាស	Banteay Meas District
ឃុំបន្ទាយនាង	Banteay Neang
ស្រុកបន្ទាយស្រី	Banteay Srei District
ស្រុកបរកែវ	Bar Kaev District
ឃុំបារាំងធ្លាក់	Barang Thleak
ស្រុកបារាយណ៍	Baray District
ស្រុកបរិបូណ៌	Baribour District
ស្រុកបរសេដ្ឋ	Basedth District
ឃុំបត់ត្រង់	Bat Trang (khum of Cambodia)
ស្រុកបាធាយ	Batheay District
ស្រុកបាទី	Bathi District
ក្រុងបាត់ដំបង	Battambang District
បវេល	Bavel
ឃុំបវេល	Bavel (commune)
ស្រុកបវេល	Bavel District
ឃុំបាយដំរាំ	Bay Damram
ស្រុកកៀនស្វាយ	Kien Svay District
ដែនជំរកសត្វព្រៃបឹងពេរ	Beng Per Wildlife Sanctuary
ភទ្ទាកាបិលានី	Bhadda Kapilani
ក្លោងទ្វារ:ចិន	Portal:China
វិគីភីឌា:វិគីគម្រោង ជីវប្រវត្តិ	Wikipedia:WikiProject Biography
ជំនួយ:ប្រអប់ព័ត៌មាន	Help:Infobox
ប្រសព្វរវាងបន្ទាត់និងប្លង់	Line–plane intersection
កម្ពុជាសម័យទំនើប	Modern Cambodia
មណីមេខលា	Manimekhala
រីម គីន	Rim Kin
យុគអន្ធកាលនៃកម្ពុជា	Dark ages of Cambodia
ការត្រួតត្រារបស់ជប៉ុននៅកម្ពុជា	Japanese occupation of Cambodia
ឫសទី១២នៃ២	Twelfth root of two
នរោត្តម មុនីនាថ សីហនុ	Norodom Monineath
រដ្ឋប្រហារកម្ពុជាឆ្នាំ១៩៧០	Cambodian coup of 1970
ប្រជុំរឿងព្រេងខ្មែរ	Preah Botumthera Som
សាវ័កព្រះពុទ្ធ	Sāvakabuddha
តេលេសុខភាព	Telehealth
របៀបសសេរស្គ្រីប	Scriptment
ទូរទស្សន៍ជាតិកម្ពុជា	National Television of Kampuchea
ស្រុកមោងឫស្សី	Moung Ruessei District
ស្រុកសៀមបូក	Siem Bouk District
ស្រុកស្វាយជ្រំ	Svay Chrom District
ស្រុកសេសាន	Sesan District
ស្រុកគងពិសី	Kong Pisei District
ស្រុកស្វាយចេក	Svay Chek District
ស្រុករវៀង	Rovieng District
ក្រុងស្វាយរៀង	Svay Rieng District
ស្រុកកំពង់លែង	Kampong Leaeng District
ស្រុកត្បូងឃ្មុំ	Tboung Khmum District
ស្រុកកោះអណ្ដែត	Kaoh Andaet District
ស្រុកជាំក្សាន្ត	Choam Khsant District
ស្រុកម៉ាឡៃ	Malai District
ស្រុកថ្ពង	Thpong District
ស្រុករមាសហែក	Romeas Haek District
ស្រុកស្ទឹងត្រង់	Stueng Trang District
ស្រុកព្រៃឈរ	Prey Chhor District
ស្រុកជ័យសែន	Chey Saen District
ស្រុកឈូក	Chhouk District
ស្រុកឆែប	Chhaeb District
ស្រុកពញាក្រែក	Ponhea Kraek District
ស្រុកសិរីសោភ័ណ	Serei Saophoan District
ស្រុកសង្គមថ្មី	Sangkom Thmei District
ស្រុកភ្នំស្រួច	Phnom Sruoch District
ស្រុកគូលែន	Kuleaen District
ស្រុកចន្រ្ទា	Chanthrea District
ស្រុករំដួល	Romdoul District
ការប្រមូលទិន្នន័យ	Data collection
ស្រុកឧដុង្គ	Odongk District
ស្រុកអូរជ្រៅ	Ou Chrov District
ស្រុកអូររាំង	Ou Reang District
ស្រុកស្នួល	Snuol District
ក្រុងដូនកែវ	Doun Kaev District
ស្រុកសៀមរាប	Siem Reap District
ស្រុកបទុមសាគរ	Botum Sakor District
ស្រុកស្វាយទាប	Svay Theab District
ស្រុកគិរីសាគរ	Kiri Sakor District
ស្រុកកញ្ជ្រៀច	Kanhchriech District
ស្រុកសម្បូរ	Sambour District
ស្រុកកំពង់ត្របែក	Kampong Trabaek District
ស្រុកវាលវែង	Veal Veang District
ស្រុកជុំគិរី	Chum Kiri District
ស្រុកត្រាំកក់	Tram Kak District
ស្រុកប្រាសាទបាគង	Prasat Bakong District
ស្រុកស្ទឹងហាវ	Stueng Hav District
ស្រុកភ្នំក្រវាញ	Phnum Kravanh District
ស្រុកព្រៃកប្បាស	Prey Kabbas District
ស្រុកកំចាយមារ	Kamchay Mear District
ស្រុកពាមជរ	Peam Chor District
ស្រុកសង្កែ	Sangkae District
ស្រុកមណ្ឌលសីមា	Mondol Seima District
ស្រុកក្រចេះ	Kratié District
ស្រុកទ្រាំង	Treang District
ស្រុកព្រែកប្រសព្វ	Preaek Prasab District
ក្រុងសែនមនោរម្យ	Senmonorom District
ស្រុកសៀមប៉ាង	Siem Pang District
ក្រុងស្ទឹងត្រែង	Stung Treng District
ស្រុកសំពៅមាស	Sampov Meas District
ស្រុកកោះញែក	Kaoh Nheaek District
ស្រុកស្មាច់មានជ័យ	Smach Mean Chey District
ស្រុករតនមណ្ឌល	Rotanak Mondol District
ស្រុកសំរោងទង	Samraong Tong District
ស្រុកថាឡាបរិវ៉ាត់	Thala Barivat District
ស្រុកក្រគរ	Krakor District
ស្រុកសូទ្រនិគម	Sout Nikom District
ស្រុកឆ្លូង	Chhloung District
ស្រុកស្រីស្នំ	Srei Snam District
ស្រុកមេសាង	Me Sang District
ស្រុករលាប្អៀរ	Rolea B'ier District
ស្រុកកំពង់សិលា	Kampong Seila District
ឃុំចំណោម	Chamnaom
ឃុំគោកបល្ល័ង្គ	Kouk Ballangk
ឃុំទឹកជោរ	Tuek Chour Smach
ក្រមង៉ុយ	Krom Ngoy
វេស្សន្ដរជាតក	Vessantara Jataka
ម៉ាទ្រីសប្រាម៉ាហ្គឹបតា	Brahmagupta matrix
កូក្លេអូអ៊ីត	Cochleoid
ស្រុកថ្មបាំង	Thma Bang District
ស្រុកល្វាឯម	Lvea Aem District
ស្រុកស៊ីធរកណ្ដាល	Sithor Kandal District
ស្រុកកំពង់សៀម	Kampong Siem District
ស្រុកព្រះស្ដេច	Preah Sdach District
ស្រុកកូនមុំ	Koun Mom District
ស្រុកស្វាយលើ	Svay Leu District
ស្រុកជលគិរី	Chol Kiri District
ស្រុកទឹកផុស	Tuek Phos District
ស្រុកជើងព្រៃ	Cheung Prey District
ស្រុកព្រៃវែង	Prey Veaeng District
ស្រុកចុងកាល់	Chong Kal District
ស្រុកកំពង់ស្វាយ	Kampong Svay District
ស្រុកអូរជុំ	Ou Chum District
ស្រុកកំពង់លាវ	Kampong Leav District
ស្រុកវើនសៃ	Veun Sai District
ស្រុកគីរីវង់	Kiri Vong District
ស្រុកត្រពាំងប្រាសាទ	Trapeang Prasat District
ស្រុកខ្សាច់កណ្ដាល	Khsach Kandal District
ស្រុកស្រែអំបិល	Srae Ambel District
ស្រុកចំការលើ	Chamkar Leu District
ក្រុងស្ទឹងសែន	Stueng Saen District
ស្រុកប្រាសាទបល្ល័ង្ក	Prasat Balangk District
ស្រុកតាវែង	Ta Veaeng District
ស្រុកអូរយ៉ាដាវ	Ou Ya Dav District
ស្រុកពារាំង	Pea Reang District
ស្រុកវ៉ារិន	Varin District
ស្រុកព្រៃនប់	Prey Nob District
អ្នកមានកេរ្តិ៍ឈ្មោះរបស់ខ្មែរ	List of Cambodians
កោះរុងសន្លឹម	Koh Rong Samlon
ឃុំភ្នំដី	Phnom Dei
ឧទ្យានជាតិកែប	Kep National Park
ឧទ្យានជាតិមុនីវង្យបូកគោ	Preah Monivong National Park
សតិប្បដ្ឋាន	Satipatthana Sutta
ស្រុកលើកដែក	Leuk Daek District
ស្រុកសំរោង(ខេត្តតាកែវ)	Samraŏng District
ទឹកជ្រោះប៊ូស្រា	Boo Sra Waterfall
ឧទ្យានជាតិព្រះសីហនុរាម	Ream National Park
ប៉ែន រ៉ន	Pan Ron
ស្រុកប្រាសាទសម្បូរ	Prasat Sambour District
ស្រុកឯកភ្នំ	Ek Phnom District
ស្រុកថ្មគោល	Thma Koul District
ស្រុកមុខកំពូល	Mukh Kamphool District
ស្រុកក្រូចឆ្មារ	Krouch Chhmar District
ស្រុកពញាឮ	Ponhea Leu District
ស្រុកអូររាំងឪ	Ou Reang Ov District
ស្រុកសន្ទុក	Santuk District
ស្រុកកោះសូទិន	Koh Sotin District
Moon OS	Moon OS
ឃុំបឹងបេង	Boeng Beng
ឃុំបឹងរាំង	Boeng Reang
ឃុំបឹងព្រីង	Boeng Pring
ឃុំបុស្បូវ	Bos Sbov
ស្រុកបូរីជលសារ	Bourei Cholsar District
ចំណាត់ថ្នាក់ក្រុម:ភាសា	Category:Languages
ចំណាត់ថ្នាក់ក្រុម:វេយ្យាករណ៍	Category:Grammar
ចំណាត់ថ្នាក់ក្រុម:វិគីភីឌា	Category:Wikipedia
វិគីភីឌា:ការបដិសេធ ទូទៅ	Wikipedia:General disclaimer
ជំនួយ:ចំណាត់ថ្នាក់ក្រុម	Help:Category
វិគីភីឌា:សារទំព័រគំរូ	Wikipedia:Template messages
វិគីភីឌា:អសង្ស័យកម្ម	Wikipedia:Manual of Style
Portal:Contents/Portals	Portal:Contents/Portals
ផ្សារមូលបត្រកម្ពុជា	Cambodia Securities Exchange
ខ្មែរអាមេរិកាំង	Cambodian American
មជ្ឈមណ្ឌលសិទ្ធិមនុស្សកម្ពុជា	Cambodian Center for Human Rights
សាកលវិទ្យាល័យមេគង្គកម្ពុជា	Cambodian Mekong University
គណបក្សសង្គ្រោះជាតិ	Cambodia National Rescue Party
ទំព័រគំរូ:Navbox	Template:Navbox
មជ្ឈមណ្ឌលខេមរសិក្សា	Center for Khmer Studies
ឃុំចែងមានជ័យ	Chaeng Mean Chey
ឃុំចក្រី	Chakrei
ចម ប្រសិទ្ធ	Cham Prasidh
សង្កាត់ចំការសំរោង	Chamkar Samraong
ខណ្ឌចំការមន	Chamkarmon District
ជំនួយ:រូបមន្ត	Help:Displaying a formula
ឃុំចង្ហា	Changha
ចាប៉ីដងវែង	Chapei
ក្រុងច្បារមន	Chbar Mon District
អនុគមន៍សនិទានឆិប៊ីសេវ	Chebyshev rational functions
របាំឆៃយ៉ាំ	Chhayam
ឃុំឈើទាល (ស្រុកបាណន់)	Chheu Teal
ឃុំឈ្នួរមានជ័យ	Chhnuor Mean Chey
ឃុំឆ្នាល់មាន់	Chhnal Moan
ឃុំជប់វារី	Chob Veari
ឃុំជ្រៃ (ស្រុក មោងឫស្សី)	Chrey, Moung Ruessei
ឃុំជ្រៃ(ស្រុក ថ្មគោល)	Chrey, Thma Koul
ឃុំជ្រៃសីមា	Chrey Sema
ឃុំជ្រោយស្តៅ	Chrouy Sdau
ជួន ណាត	Chuon Nath
ទំព័រគំរូ:Coat of arms	Template:Coat of arms
ឈុត វុទ្ធី	Chut Wutty
ទូរទស្សន៍រាជធានីភ្នំពេញ ប៉ុស្ដិ៍លេ៣	Channel 3 (Cambodia)
ស្រុកដំបែ	Dambae District
ស្រុកដងទង់ខេត្ដកំពត	Dang Tong District
ខណ្ឌដង្កោ	Dangkao District
ខណ្ឌដូនពេញ	Daun Penh District
ដេវិឌ ឆាណ្ឌល័រ	David P. Chandler
ជំនួយ:តំណភ្ជាប់	Help:Link
សាលាដុនបូស្កូនៅប្រទេសកម្ពុជា	Don Bosco Cambodia
ឃុំដូនបា	Doun Ba
ទំព័រគំរូ:Citation needed	Template:Citation needed
ឌី សាវ៉េត	Dy Saveth
តំបន់ពាណិជ្ជកម្មសេរី	Free trade area
វិស័យអប់រំនៅកម្ពុជា	Education in Cambodia
អាជ្ញាធរអគ្គិសនីកម្ពុជា	Electricity Authority of Cambodia
បំពង់អេឡិចត្រុង	Electron tube
សាលាបឋមសិក្សានៅប្រទេសជប៉ុន	Elementary schools in Japan
ទំព័រគំរូ:Error	Template:Error
ចំណាត់ថ្នាក់ក្រុម:Flag templates	Category:Flag templates
ទំព័រគំរូ:((	Template:((
ទំព័រគំរូ:))	Template:))
ទំព័រគំរូ:=	Template:=
ទំព័រគំរូ:Navbar	Template:Navbar
ទំព័រគំរូ:Loop	Template:Loop
ទំព័រគំរូ:Void	Template:Void
ទំព័រគំរូ:Key press	Template:Key press
ទំព័រគំរូ:Okina	Template:Okina
ទំព័រគំរូ:Transclude	Template:Transclude
ទំព័រគំរូ:Sc	Template:Smallcaps
ទំព័រគំរូ:Small	Template:Small
ទំព័រគំរូ:Clear	Template:Clear
ទំព័រគំរូ:Col-break	Template:Col-break
ទំព័រគំរូ:Col-begin	Template:Col-begin
ទំព័រគំរូ:Col-end	Template:Col-end
ទំព័រគំរូ:Trim	Template:Trim
ទំព័រគំរូ:Color	Template:Color
ទំព័រគំរូ:Nowrap	Template:Nowrap
ទំព័រគំរូ:Bots	Template:Bots
ទំព័រគំរូ:Abbr	Template:Abbr
វិគីភីឌា:វិគីគម្រោង ទំព័រគំរូ	Wikipedia:WikiProject Templates
ទ្រឹស្តីបទមុំក្រៅ	Exterior angle theorem
ត្រីកោណប៉ះក្រៅ	Extouch triangle
ចំណាត់ថ្នាក់ក្រុម:ខ្សែកោង	Category:Curves
ទំព័រគំរូ:Babel	Template:Babel
ទំព័រគំរូ:Commons	Template:Commons
ទំព័រគំរូ:Reflist	Template:Reflist
ទំព័រគំរូ:NavPeriodicTable	Template:Periodic table (32 columns, micro)
វិគីភីឌា:Citing sources	Wikipedia:Citing sources
ទំព័រគំរូ:អត្ថបទខ្លីមិនពេញលេញ	Template:Stub
ទំព័រគំរូ:User af-1	Template:User af-1
ទំព័រគំរូ:User als-1	Template:User als-1
ទំព័រគំរូ:User az	Template:User az
ទំព័រគំរូ:User bar-1	Template:User bar-1
ទំព័រគំរូ:See also	Template:See also
ទំព័រគំរូ:User de	Template:User de
ទំព័រគំរូ:User de-1	Template:User de-1
ទំព័រគំរូ:User et-1	Template:User et-1
ទំព័រគំរូ:User el	Template:User el
ទំព័រគំរូ:User es	Template:User es
ទំព័រគំរូ:User de-3	Template:User de-3
ទំព័រគំរូ:User en-3	Template:User en-3
ទំព័រគំរូ:User en-1	Template:User en-1
ទំព័រគំរូ:User en-2	Template:User en-2
ទំព័រគំរូ:User en-4	Template:User en-4
ទំព័រគំរូ:User fi	Template:User fi
ទំព័រគំរូ:User en-0	Template:User en-0
ទំព័រគំរូ:User es-4	Template:User es-4
ទំព័រគំរូ:User en	Template:User en
ទំព័រគំរូ:User de-2	Template:User de-2
ទំព័រគំរូ:User es-1	Template:User es-1
ទំព័រគំរូ:User fa	Template:User fa
ទំព័រគំរូ:User fr-1	Template:User fr-1
ខណ្ឌសាលារៀនសាមគ្គីឡងប៊ិច	Long Beach Unified School District
ទំព័រគំរូ:User id-3	Template:User id-3
ទំព័រគំរូ:User it-3	Template:User it-3
ទំព័រគំរូ:User tr-2	Template:User tr-2
ទំព័រគំរូ:User fr-2	Template:User fr-2
ទំព័រគំរូ:User tr	Template:User tr
ទំព័រគំរូ:User ja	Template:User ja
ទំព័រគំរូ:User ja-1	Template:User ja-1
ទំព័រគំរូ:User it-1	Template:User it-1
ទំព័រគំរូ:User fr	Template:User fr
ទំព័រគំរូ:User gsw-1	Template:User gsw-1
ទំព័រគំរូ:Location map/Info	Template:Location map/Info
ចំណាត់ថ្នាក់ក្រុម:Navigational boxes	Category:Navigational boxes
ទំព័រគំរូ:ទិន្នន័យ នៃប្រទេសតាជីគីស្ថាន	Template:Country data Tajikistan
ចំណាត់ថ្នាក់ក្រុម:អាស៊ី	Category:Asia
ចំណាត់ថ្នាក់ក្រុម:User uk-N	Category:User uk-N
ទំព័រគំរូ:Intricate template	Template:Intricate template
ទំព័រគំរូ:Lang-ja	Template:Lang-ja
ទំព័រគំរូ:Football squad player	Template:Football squad player
ទំព័រគំរូ:ទិន្នន័យប្រទេស គុយវ៉ែត	Template:Country data Kuwait
ទំព័រគំរូ:Mod	Template:Mod
ទំព័រគំរូ:Now Commons	Template:Now Commons
ទំព័រគំរូ:User it	Template:User it
ទំព័រគំរូ:User uk	Template:User uk
ទំព័រគំរូ:User es-2	Template:User es-2
ទំព័រគំរូ:ស្វាគមន៍	Template:Welcome
ទំព័រគំរូ:គម្រោងវិគីជាបងប្អូន	Template:Wikipedia's sister projects
ចំណាត់ថ្នាក់ក្រុម:External link templates	Category:External link templates
ទំព័រគំរូ:Month header	Template:Month header
ទំព័រគំរូ:ទិន្នន័យប្រទេស ស្លូវ៉ាគី	Template:Country data Slovakia
ចំណាត់ថ្នាក់ក្រុម:ទំព័រគំរូសំរាប់កូអរដោនេ	Category:Coordinates templates
ទំព័រគំរូ:Country flagnavy	Template:Navy/core
ទំព័រគំរូ:USA	Template:USA
ទំព័រគំរូ:ទិន្នន័យប្រទេស អេត្យូពី	Template:Country data Ethiopia
ទំព័រគំរូ:ទិន្នន័យប្រទេស ឆេក	Template:Country data Czech Republic
ទំព័រគំរូ:ទិន្នន័យ នៃប្រទេសថៃ	Template:Country data Thailand
ទំព័រគំរូ:Scinote	Template:Scinote
ទំព័រគំរូ:ទិន្នន័យប្រទេស គុយបា	Template:Country data Cuba
ទំព័រគំរូ:Lang-km	Template:Lang-km
ទំព័រគំរូ:ទិន្នន័យប្រទេស អាល់បានី	Template:Country data Albania
ទំព័រគំរូ:ទិន្នន័យ នៃប្រទេសប៉េរូ	Template:Country data Peru
ទំព័រគំរូ:ទិន្នន័យ នៃប្រទេសម៉ាកាវ	Template:Country data Macau
ទំព័រគំរូ:User wikipedia	Template:User wikipedia
ទំព័រគំរូ:ទិន្នន័យប្រទេស សាធារណរដ្ឋចិន	Template:Country data Republic of China
ទំព័រគំរូ:ទិន្នន័យ នៃប្រទេសអ៊ូបេគីស្ថាន	Template:Country data Uzbekistan
ចំណាត់ថ្នាក់ក្រុម:User ms	Category:User ms
ទំព័រគំរូ:Continent-based templates	Template:Continent-based templates
ទំព័រគំរូ:Months	Template:Months
ទំព័រគំរូ:ទិន្នន័យ នៃប្រទេសឡាតវី	Template:Country data Latvia
ទំព័រគំរូ:Football kit	Template:Football kit
ទំព័រគំរូ:ទិន្នន័យ នៃប្រទេសម៉ាល់តា	Template:Country data Malta
ទំព័រគំរូ:ទិន្នន័យ នៃប្រទេសម៉ូណាកូ	Template:Country data Monaco
ទំព័រគំរូ:ទិន្នន័យ នៃប្រទេសដាណឺម៉ាក	Template:Country data Denmark
ទំព័រគំរូ:Wikiatlas	Template:Wikiatlas
ទំព័រគំរូ:ទិន្នន័យ នៃប្រទេសប៉ូឡូញ	Template:Country data Poland
ទំព័រគំរូ:Wikipedia policies and guidelines	Template:Wikipedia policies and guidelines
ចំណាត់ថ្នាក់ក្រុម:User fr-1	Category:User fr-1
ទំព័រគំរូ:ទិន្នន័យ នៃប្រទេសណ័រវ៉េ	Template:Country data Norway
ទំព័រគំរូ:ទិន្នន័យប្រទេស ហ្សកហ៊្សី	Template:Country data Georgia
ទំព័រគំរូ:Navbox suite	Template:Navbox suite
ទំព័រគំរូ:Wikiquote	Template:Wikiquote
ទំព័រគំរូ:Country showdata	Template:Country showdata
ទំព័រគំរូ:Image label	Template:Image label
ទំព័រគំរូ:Cat handler	Template:Category handler
ទំព័រគំរូ:ទិន្នន័យប្រទេស ស្រីលង្កា	Template:Country data Sri Lanka
ទំព័រគំរូ:ទិន្នន័យ នៃប្រទេសមិចសិច	Template:Country data Mexico
ទំព័រគំរូ:ទិន្នន័យប្រទេស ក្រិច	Template:Country data Greece
ទំព័រគំរូ:Infobox dot-com company	Template:Infobox dot-com company
ទំព័រគំរូ:ទិន្នន័យ នៃប្រទេសអារ៉ាប៊ីសាអូឌីត	Template:Country data Saudi Arabia
ទំព័រគំរូ:Category tree	Template:Category tree
ទំព័រគំរូ:ទិន្នន័យប្រទេស ក្រូអាត	Template:Country data Croatia
ទំព័រគំរូ:ប្រអប់ព័ត៌មាន អ្នកនិពន្ធ	Template:Infobox writer
ទំព័រគំរូ:Stub category	Template:Stub category
ទំព័រគំរូ:Ja icon	Template:Ja icon
ទំព័រគំរូ:ទិន្នន័យ នៃប្រទេសសហភាពអារ៉ាប់អេមីរ៉េត	Template:Country data United Arab Emirates
ទំព័រគំរូ:Infobox television	Template:Infobox television
ទំព័រគំរូ:Geographic location	Template:Geographic location
ទំព័រគំរូ:Prose	Template:Prose
ទំព័រគំរូ:Infobox musical artist	Template:Infobox musical artist
ទំព័រគំរូ:Finance	Template:Finance sidebar
ទំព័រគំរូ:ទិន្នន័យប្រទេស Serbia	Template:Country data Serbia
ទំព័រគំរូ:Collapsible list	Template:Collapsible list
ទំព័រគំរូ:ទិន្នន័យ នៃប្រទេសអូស្រ្តាលី	Template:Country data Australia
ទំព័រគំរូ:ទិន្នន័យ​នៃប្រទេសប៉ាឡេស្ទីន	Template:PSE
ទំព័រគំរូ:Subatomic particle	Template:Subatomic particle
ទំព័រគំរូ:Sidebar	Template:Sidebar
ទំព័រគំរូ:In use	Template:In use
ទំព័រគំរូ:Es icon	Template:Es icon
ទំព័រគំរូ:ទិន្នន័យ នៃប្រទេសបារាំង	Template:Country data France
ទំព័រគំរូ:Ambox	Template:Ambox
ទំព័រគំរូ:Multiple issues/message	Template:Multiple issues/message
ទំព័រគំរូ:Update	Template:Update
ទំព័រគំរូ:CalendarCustom	Template:Calendar/month/link on
នគរគូមៀ	Gumie
ទំព័រគំរូ:ប្រអប់ព័ត៌មាន មន្ទីរពេទ្យ	Template:Infobox hospital
ទំព័រគំរូ:ប្រអប់ព័ត៌មាន ទស្សនាវដ្ដី	Template:Infobox magazine
ទំព័រគំរូ:Image requested	Template:Image requested
ទំព័រគំរូ:ប្រអប់ព័ត៌មាន ភ្លេងជាតិ	Template:Infobox anthem
ទំព័រគំរូ:Navigation templates	Template:Navigation templates
ទំព័រគំរូ:Very long	Template:Very long
ទំព័រគំរូ:ទិន្នន័យ​នៃប្រទេសគាហ្គីស្ថាន	Template:KGZ
ទំព័រគំរូ:ប្រអប់ព័ត៌មាន សាលារៀន	Template:Infobox school
ទំព័រគំរូ:Fossil range/bar	Template:Fossil range/bar
ទំព័រគំរូ:Userboxbottom	Template:Userboxbottom
ទំព័រគំរូ:Copy to Wikimedia Commons	Template:Copy to Wikimedia Commons
ទំព័រគំរូ:Rnd	Template:Rnd
ទំព័រគំរូ:ចំណាត់ថ្នាក់ក្រុមនៃទំព័រគំរូ	Template:Template category
ទំព័រគំរូ:Font color	Template:Font color
ទំព័រគំរូ:ប្រអប់ព័ត៌មាន ប្រទេស	Template:Infobox country
ទំព័រគំរូ:Max	Template:Max
ទំព័រគំរូ:Infobox software	Template:Infobox software
ទំព័រគំរូ:Column-count	Template:Column-count
ទំព័រគំរូ:Commons&cat	Template:Commons and category
ទំព័រគំរូ:ទិន្នន័យប្រទេស ឡាវ	Template:Country data Laos
ទំព័រគំរូ:Infobox airline	Template:Infobox airline
ទំព័រគំរូ:Wide image	Template:Wide image
ទំព័រគំរូ:ទិន្នន័យ នៃប្រទេសអូទ្រីស	Template:Country data Austria
ទំព័រគំរូ:Collapsible option	Template:Collapsible option
ទំព័រគំរូ:ប្រអប់ព័ត៌មាន ជម្លោះយោធា	Template:Infobox military conflict
វិគីភីឌា:សំណួរ	Wikipedia:Questions
ទំព័រគំរូ:Redirect4	Template:Str left
ទំព័រគំរូ:Cat more	Template:Cat more
ទំព័រគំរូ:ទិន្នន័យ នៃប្រទេសនេប៉ាល់	Template:Country data Nepal
ទំព័រគំរូ:Pagelist	Template:Pagelist
ទំព័រគំរូ:Px	Template:Px
ទំព័រគំរូ:Resolved	Template:Done
ទំព័រគំរូ:Str sub long	Template:Str sub old
ទំព័រគំរូ:Documentation/docname	Template:Documentation/docname
ទំព័រគំរូ:ទិន្នន័យ នៃប្រទេសហ្វាំងឡង់	Template:Country data Finland
ទំព័រគំរូ:Selfref	Template:Selfref
ទំព័រគំរូ:Flatlist	Template:Flatlist
ទំព័រគំរូ:ទិន្នន័យ​នៃប្រទេសហ្វីលីពីន	Template:PHL
ទំព័រគំរូ:ទិន្នន័យ នៃប្រទេសអេស៊ីប	Template:Country data Egypt
ទំព័រគំរូ:ទិន្នន័យ នៃប្រទេសលីថូនី	Template:Country data Lithuania
ទំព័រគំរូ:ប្រអប់ព័ត៌មាន គណបក្សនយោបាយ	Template:Infobox political party
ទំព័រគំរូ:Used in system	Template:Used in system
ទំព័រគំរូ:ទិន្នន័យប្រទេស ជប៉ុន	Template:Country data Japan
ទំព័រគំរូ:Endflatlist	Template:Endflatlist
ទំព័រគំរូ:Expand section	Template:Expand section
ទំព័រគំរូ:ទិន្នន័យ នៃប្រទេសហូឡង់	Template:Country data Netherlands
ទំព័រគំរូ:Tmbox	Template:Tmbox
ទំព័រគំរូ:Navbox with columns	Template:Navbox with columns
ទំព័រគំរូ:ប្រអប់ព័ត៌មាន ល្បែងវីដេអូ	Template:Infobox video game
ទំព័រគំរូ:S-start	Template:S-start
ទំព័រគំរូ:IsLeapYear	Template:IsLeapYear
ទំព័រគំរូ:Age in years and days	Template:Age in years and days
ទំព័រគំរូ:Nom	Template:Nom
ទំព័រគំរូ:Facebook	Template:Facebook
ទំព័រគំរូ:Cleanup	Template:Cleanup
ទំព័រគំរូ:ប្រអប់ព័ត៌មាន សាកលវិទ្យាល័យ	Template:Infobox university
ទំព័រគំរូ:Cite journal	Template:Cite journal
ទំព័រគំរូ:ទិន្នន័យប្រទេស អាស៊ែបៃហ្សង់	Template:Country data Azerbaijan
ទំព័រគំរូ:ទិន្នន័យ​នៃប្រទេសប្រ៊ុយណេ	Template:BRN
ទំព័រគំរូ:វិគីសៀវភៅ	Template:Wikibooks
ទំព័រគំរូ:Hatnote	Template:Hatnote
ទំព័រគំរូ:Image	Template:Image
ទំព័រគំរូ:User browser:Firefox	Template:User fox
ទំព័រគំរូ:Xpd	Template:Xpd
ទំព័រគំរូ:User es-0	Template:User es-0
ទំព័រគំរូ:Time ago	Template:Time ago
ទំព័រគំរូ:Familytree	Template:Family tree
ទំព័រគំរូ:ទិន្នន័យប្រទេស វៀតណាម	Template:Country data Vietnam
ទំព័រគំរូ:Redirect3	Template:Redirect3
ទំព័រគំរូ:S-aft	Template:S-aft
ទំព័រគំរូ:Featured article	Template:Featured article
ទំព័រគំរូ:ទិន្នន័យ នៃប្រទេសរុស្ស៊ី	Template:Country data Russia
ទំព័រគំរូ:Decdeg	Template:Decdeg
ចំណាត់ថ្នាក់ក្រុម:User en-4	Category:User en-4
ចំណាត់ថ្នាក់ក្រុម:User en	Category:User en
ទំព័រគំរូ:Ordinal	Template:Ordinal
ចំណាត់ថ្នាក់ក្រុម:User zh	Category:User zh
ចំណាត់ថ្នាក់ក្រុម:User zh-N	Category:User zh-N
ចំណាត់ថ្នាក់ក្រុម:User en-2	Category:User en-2
ទំព័រគំរូ:ប្រអប់ព័ត៌មាន	Template:Infobox
ទំព័រគំរូ:Infobox instrument	Template:Infobox instrument
ទំព័រគំរូ:TOC right	Template:TOC right
ទំព័រគំរូ:ប្រអប់ព័ត៌មាន ប្រាសាទ	Template:Infobox Hindu temple
ទំព័រគំរូ:Main other	Template:Main other
ទំព័រគំរូ:RankedMedalTable	Template:RankedMedalTable
ទំព័រគំរូ:User zh	Template:User zh
ទំព័រគំរូ:Lang-kk	Template:Lang-kk
ទំព័រគំរូ:Documentation/start box	Template:Documentation/start box
ទំព័រគំរូ:Documentation/end box2	Template:Documentation/end box2
ទំព័រគំរូ:Documentation/start box2	Template:Documentation/start box2
ទំព័រគំរូ:Template other	Template:Template other
ទំព័រគំរូ:Legend	Template:Legend
ទំព័រគំរូ:ប្រអប់ព័ត៌មាន បណ្ណាល័យ	Template:Infobox library
ឃុំហប់	Hab
ទំព័រគំរូ:Cite web	Template:Cite web
ទំព័រគំរូ:YouTube	Template:YouTube
ទំព័រគំរូ:ទិន្នន័យ នៃប្រទេសអ៊ីតាលី	Template:Country data Italy
ទំព័រគំរូ:Current	Template:Current
ទំព័រគំរូ:Ombox	Template:Ombox
ទំព័រគំរូ:ទិន្នន័យប្រទេស	Template:Country data
ទំព័រគំរូ:Wikipedia-screenshot	Template:Wikipedia-screenshot
ទំព័រគំរូ:Won	Template:Won
ទំព័រគំរូ:Tnavbar-collapsible	Template:Navbar-collapsible
ទំព័រគំរូ:Coor URL	Template:Coor URL
ទំព័រគំរូ:Pp-template	Template:Pp-template
ទំព័រគំរូ:Min	Template:Min
ទំព័រគំរូ:Wiktionary	Template:Wiktionary
ទំព័រគំរូ:Mbox templates	Template:Mbox templates (small)
ទំព័រគំរូ:Multi-listen start	Template:Multi-listen start
ទំព័រគំរូ:ទិន្នន័យ នៃប្រទេសស៊ុយអែត	Template:Country data Sweden
ទំព័រគំរូ:Bar box	Template:Bar box
ទំព័រគំរូ:Chem	Template:Chem
ទំព័រគំរូ:Language icon	Template:Link language
ទំព័រគំរូ:Lang-sr	Template:Lang-sr
ហត្ថាកសិករ លីមីតធីត	Hattha Kaksekar
ទំព័រគំរូ:Infobox settlement	Template:Infobox settlement
មធ្យមហែងស៍	Heinz mean
ហែម ចៀវ	Hem Chieu
ទំព័រគំរូ:User ru	Template:User ru
ទំព័រគំរូ:Admin	Template:Admin
ទំព័រគំរូ:IPA	Template:IPA
ទំព័រគំរូ:អត្ថន័យដទៃទៀត	Template:Other uses
ហ៊ឹម ស៊ីវន	Him Sivorn
ទំព័រគំរូ:ទិន្នន័យប្រទេស សហភាពសូវៀត	Template:Country data Soviet Union
ទំព័រគំរូ:ទិន្នន័យ នៃប្រទេសឥណ្ឌា	Template:Country data India
ទំព័រគំរូ:Language with name	Template:Language with name
ទំព័រគំរូ:Imbox	Template:Imbox
ទំព័រគំរូ:Rellink	Template:Rellink
ទំព័រគំរូ:Navbox subgroup	Template:Navbox subgroup
ទំព័រគំរូ:Non-free use rationale	Template:Non-free use rationale
ទំព័រគំរូ:Birth year and age	Template:Birth date and age
ទំព័រគំរូ:List of African capitals	Template:List of African capitals
ទំព័រគំរូ:ប្រអប់ព័ត៌មាន ក្រុមជនជាតិ	Template:Infobox ethnic group
ទំព័រគំរូ:Archive box	Template:Archive box
ទំព័រគំរូ:MONTHNAME	Template:MONTHNAME
ទំព័រគំរូ:Calendar/MonthStartSat	Template:Calendar/isoMonthStartSat
វិគីភីឌា:Text of GNU Free Documentation License	Wikipedia:Text of the GNU Free Documentation License
ទំព័រគំរូ:Commons category-inline	Template:Commons category-inline
ទំព័រគំរូ:រង្វាន់ណូបែល	Template:Nobel Prizes
ទំព័រគំរូ:Sisterlinks	Template:Sister project links
ទំព័រគំរូ:ទិន្នន័យប្រទេស អង់ដូរ៉ា	Template:Country data Andorra
ទំព័រគំរូ:ប្រអប់ព័ត៌មាន តំបន់ការពារ	Template:Infobox protected area
ទំព័រគំរូ:Border	Template:Border
ទំព័រគំរូ:ទិន្នន័យប្រទេស ព័រទុយហ្គាល់	Template:Country data Portugal
ទំព័រគំរូ:Death date and age	Template:Death date and age
ទំព័រគំរូ:MONTHNUMBER	Template:MONTHNUMBER
ចំណាត់ថ្នាក់ក្រុម:People stubs	Category:People stubs
ទំព័រគំរូ:ទិន្នន័យប្រទេស បុរីវ៉ាទីកង់	Template:Country data Vatican City
ទំព័រគំរូ:Top icon	Template:Top icon
ទំព័រគំរូ:Icon	Template:Icon
ចំណាត់ថ្នាក់ក្រុម:Template:Country data templates	Category:Country data templates
ទំព័រគំរូ:Birth category header	Template:Birth category header
ទំព័រគំរូ:Namespace detect	Template:Namespace detect
ចំណាត់ថ្នាក់ក្រុម:ជ័យលាភីរង្វាន់ណូបែល ផ្នែករូបវិទ្យា	Category:Nobel laureates in Physics
ចំណាត់ថ្នាក់ក្រុម:ជ័យលាភីរង្វាន់ណូបែល ផ្នែកគីមីវិទ្យា	Category:Nobel laureates in Chemistry
ទំព័រគំរូ:Fmbox	Template:Fmbox
ទំព័រគំរូ:Navbox with collapsible groups	Template:Navbox with collapsible groups
ទំព័រគំរូ:GeoGroup	Template:GeoGroup
ទំព័រគំរូ:ទិន្នន័យប្រទេស ចិន	Template:Country data China
ទំព័រគំរូ:Wikify	Template:Wikify
ទំព័រគំរូ:ទិន្នន័យ នៃ ប្រទេស អង់គ្លេស	Template:Country data England
ទំព័រគំរូ:ទិន្នន័យ នៃប្រទេសអៀរឡង់	Template:Country data Republic of Ireland
ទំព័រគំរូ:ទិន្នន័យ នៃប្រទេសទួរគី	Template:Country data Turkey
ទំព័រគំរូ:ទិន្នន័យ នៃប្រទេសស្វីស	Template:Country data Switzerland
ទំព័រគំរូ:ទិន្នន័យ នៃប្រទេសហ្វីលីពីន	Template:Country data Philippines
ទំព័រគំរូ:Hidden begin	Template:Hidden begin
ទំព័រគំរូ:ParmPart	Template:ParmPart
ទំព័រគំរូ:Army	Template:Army
ទំព័រគំរូ:ទិន្នន័យ នៃប្រទេសម៉ាឡេស៊ី	Template:Country data Malaysia
ទំព័រគំរូ:ទិន្នន័យប្រទេស អាមេនី	Template:Country data Armenia
ទំព័រគំរូ:Infobox OS	Template:Infobox OS
ទំព័រគំរូ:ទិន្នន័យ នៃប្រទេសតៃវ៉ាន់	Template:Country data Taiwan
ទំព័រគំរូ:ទិន្នន័យប្រទេស វៀតណាមខាងត្បូង	Template:Country data South Vietnam
ទំព័រគំរូ:ទិន្នន័យ នៃប្រទេសភូមា	Template:Country data Myanmar
ទំព័រគំរូ:ទិន្នន័យ នៃប្រទេសឈីលី	Template:Country data Chile
ទំព័រគំរូ:The Original Barnstar	Template:The Original Barnstar
ទំព័រគំរូ:ទិន្នន័យប្រទេស លីបង់	Template:Country data Lebanon
ទំព័រគំរូ:ទិន្នន័យប្រទេស ចិនតៃប៉ិ	Template:Country data Chinese Taipei
ទំព័រគំរូ:ប្រអប់ព័ត៌មាន សៀវភៅ	Template:Infobox book
ទំព័រគំរូ:Tlc	Template:Tlc
ទំព័រគំរូ:ប្រអប់ព័ត៌មាន ភព	Template:Infobox planet
ទំព័រគំរូ:Compact periodic table	Template:Periodic table (32 columns, compact)
ទំព័រគំរូ:Lang-fa	Template:Lang-fa
ទំព័រគំរូ:ICD10	Template:ICD10
ទំព័រគំរូ:ទិន្នន័យ​នៃប្រទេសម៉ាឡេស៊ី	Template:MYS
ទំព័រគំរូ:Infobox website	Template:Infobox website
ទំព័រគំរូ:Globalize	Template:Globalize
ទំព័រគំរូ:Image label end	Template:Image label end
ទំព័រគំរូ:មិនស្គាល់អជ្ញាបណ្ណ	Template:Don't know
ទំព័រគំរូ:Navboxes	Template:Navboxes
ទំព័រគំរូ:Documentation subpage	Template:Documentation subpage
ទំព័រគំរូ:Uncategorized	Template:Uncategorized
ទំព័រគំរូ:ទិន្នន័យ​នៃប្រទេសឥណ្ឌូនេស៊ី	Template:IDN
ទំព័រគំរូ:Talk header for guidelines	Template:Talk header
ទំព័រគំរូ:Quote box	Template:Quote box
ទំព័រគំរូ:CcTLD	Template:CcTLD
ទំព័រគំរូ:Cc-by-2.0	Template:Cc-by-2.0
ទំព័រគំរូ:Lang-my-fonts	Template:Script/Mymr
ទំព័រគំរូ:Oldid	Template:Oldid
ទំព័រគំរូ:Rtl-lang	Template:Rtl-lang
ទំព័រគំរូ:List of Asian capitals by region	Template:List of Asian capitals by region
ទំព័រគំរូ:Bquote	Template:Block quote
ទំព័រគំរូ:ប្រអប់ព័ត៌មានទីកន្លែងកេរដំណែលពិភពលោក	Template:Infobox World Heritage Site
ទំព័រគំរូ:Str len	Template:Str len
ទំព័រគំរូ:Purge	Template:Purge
ទំព័រគំរូ:Lang-de	Template:Lang-de
ទំព័រគំរូ:Empty category	Template:Empty category
ទំព័រគំរូ:Ifempty	Template:If empty
ទំព័រគំរូ:Pre2	Template:Pre2
ទំព័រគំរូ:Lang-la	Template:Lang-la
ទំព័រគំរូ:ប្រអប់ព័ត៌មាន អាគារ	Template:Infobox building
ទំព័រគំរូ:'	Template:'
ទំព័រគំរូ:Lang-el	Template:Lang-el
ទំព័រគំរូ:Chessgames player	Template:Chessgames player
ទំព័រគំរូ:ទិន្នន័យ​នៃប្រទេសអារ៉ាប៊ីសាអូឌីត	Template:SAU
ទំព័រគំរូ:User page	Template:User page
ទំព័រគំរូ:DE	Template:DEU
ទំព័រគំរូ:Lang-my	Template:Lang-my
ទំព័រគំរូ:Stack	Template:Stack
ទំព័រគំរូ:ប្រអប់ព័ត៌មាន ព្រះវិហារគ្រិស្ដសាសនា	Template:Infobox church
ទំព័រគំរូ:ផ្នែក និងទឹកដីនាយសមុទ្ររបស់បារាំង	Template:French overseas departments and territories
ទំព័រគំរូ:Infobox Christian leader	Template:Infobox Christian leader
ទំព័រគំរូ:User	Template:User
ទំព័រគំរូ:Spoken Wikipedia	Template:Spoken Wikipedia
ទំព័រគំរូ:University-stub	Template:University-stub
ទំព័រគំរូ:វិគីភីឌាភាសា	Template:Wikipedias
ទំព័រគំរូ:Clarify	Template:Clarify
ទំព័រគំរូ:Refimprove	Template:Unreferenced
ទំព័រគំរូ:Lorem ipsum	Template:Lorem ipsum
ទំព័រគំរូ:ស្នើសុំប្ដូរឈ្មោះ	Template:Renameuser
ទំព័រគំរូ:CIA World Factbook link	Template:CIA World Factbook link
ទំព័រគំរូ:Image label small	Template:Image label small
ទំព័រគំរូ:Featured article candidates	Template:FAC
ទំព័រគំរូ:អឺរ៉ុប និង សមុទ្រ	Template:Europe and seas labelled map
ទំព័រគំរូ:AddNewSection	Template:AddNewSection
ទំព័រគំរូ:Nihongo	Template:Nihongo
ទំព័រគំរូ:User fr-3	Template:User fr-3
ទំព័រគំរូ:PD-because	Template:PD-because
ទំព័រគំរូ:Th icon	Template:Th icon
ទំព័រគំរូ:Cc-by	Template:Cc-by-1.0
ទំព័រគំរូ:Failed verification	Template:Failed verification
ទំព័រគំរូ:Tag	Template:Tag
ទំព័រគំរូ:Sec link auto	Template:Sec link auto
ទំព័រគំរូ:Pp-meta	Template:Pp-meta
ទំព័រគំរូ:Notelist	Template:Notelist
ទំព័រគំរូ:S-ttl	Template:S-ttl
ទំព័រគំរូ:Infobox former country	Template:Infobox former country
ទំព័រគំរូ:IPA-en	Template:IPA-en
ទំព័រគំរូ:JPN	Template:JPN
ទំព័រគំរូ:ភូមិភាគទាំង៩របស់ជប៉ុន	Template:Regions and administrative divisions of Japan
ទំព័រគំរូ:Merge from	Template:Merge from
ទំព័រគំរូ:Cmbox	Template:Cmbox
ទំព័រគំរូ:ASIN	Template:ASIN
ជំនួយ:តារាង	Help:Table
ទំព័រគំរូ:Precision	Template:Precision
ទំព័រគំរូ:End date	Template:End date
ទំព័រគំរូ:Gbmapping	Template:Gbmappingsmall
ទំព័រគំរូ:User wikipedia/Checkuser	Template:User wikipedia/Checkuser
ទំព័រគំរូ:ទិន្នន័យ​នៃប្រទេសប៉ាគីស្ថាន	Template:PAK
ទំព័រគំរូ:Age in days nts	Template:Age in days
ទំព័រគំរូ:S-bef	Template:S-bef
ទំព័រគំរូ:Nations at the 2008 Summer Olympics	Template:Nations at the 2008 Summer Olympics
ទំព័រគំរូ:Guideline	Template:Guideline
ទំព័រគំរូ:JULIANDAY	Template:JULIANDAY
ទំព័រគំរូ:Xpd0	Template:Xpd0
ទំព័រគំរូ:Xpd3	Template:Xpd3
ទំព័រគំរូ:Mbox	Template:Mbox
ទំព័រគំរូ:Disagree	Template:Disagree
ទំព័រគំរូ:DNB portal	Template:German National Library portal
ទំព័រគំរូ:Talkarchive	Template:Talk archive
ទំព័រគំរូ:Lt	Template:Lt icon
ទំព័រគំរូ:Pagetype	Template:Pagetype
ទំព័រគំរូ:ទិន្នន័យ​នៃប្រទេសអ៊ីរ៉ង់	Template:IRN
ទំព័រគំរូ:ទិន្នន័យ​នៃប្រទេសហ្សកដង់	Template:JOR
ទំព័រគំរូ:Bibleverse	Template:Bibleverse
ទំព័រគំរូ:Infobox historical event	Template:Infobox historical event
ទំព័រគំរូ:ទិន្នន័យ​នៃប្រទេសហុងកុង	Template:HKG
ទំព័រគំរូ:ទិន្នន័យ​នៃប្រទេសកូរ៉េខាងជើង	Template:PRK
ទំព័រគំរូ:Infobox continent	Template:Infobox continent
ទំព័រគំរូ:Date	Template:Date
ទំព័រគំរូ:BHU	Template:BTN
ទំព័រគំរូ:ទិន្នន័យ​នៃប្រទេសសិង្ហបុរី	Template:SGP
ទំព័រគំរូ:ទិន្នន័យ​នៃប្រទេសឥណ្ឌា	Template:IND
ទំព័រគំរូ:ទិន្នន័យ​នៃប្រទេសម៉ាកាវ	Template:MAC
ទំព័រគំរូ:សបា្ដហ៍	Template:Days of the week
ទំព័រគំរូ:To do	Template:To do
ទំព័រគំរូ:Colors	Template:Colors
ទំព័រគំរូ:CURRENTJULIANDAY	Template:CURRENTJULIANDAY
ទំព័រគំរូ:Nobold	Template:Nobold
ចំណាត់ថ្នាក់ក្រុម:User ja-N	Category:User ja-N
ទំព័រគំរូ:Multicol-break	Template:Multicol-break
ទំព័រគំរូ:Largest cities	Template:Largest cities
ទំព័រគំរូ:PDFlink	Template:PDFlink
ទំព័រគំរូ:Ca icon	Template:Ca icon
ទំព័រគំរូ:ទិន្នន័យ នៃប្រទេសអាល្លឺម៉ងខាងកើត	Template:Country data West Germany
ទំព័រគំរូ:Region history	Template:Region history sidebar title
ទំព័រគំរូ:Lang-ru	Template:Lang-ru
វិគីភីឌា:Welcoming committee	Wikipedia:Welcoming committee
ទំព័រគំរូ:Br separated entries	Template:Br separated entries
ទំព័រគំរូ:Infobox saint	Template:Infobox saint
ទំព័រគំរូ:URL	Template:URL
ទំព័រគំរូ:Hidden end	Template:Hidden end
ទំព័រគំរូ:ណែនាំ	Template:Disambiguation
ទំព័រគំរូ:Tlsp	Template:Tlsp
ទំព័រគំរូ:Xt	Template:Xt
ទំព័រគំរូ:ទិន្នន័យ នៃប្រទេសហុងកុង	Template:Country data Hong Kong
ទំព័រគំរូ:DEFAULTSORT	Template:DEFAULTSORT
ទំព័រគំរូ:Copy to Wiktionary	Template:Copy to Wiktionary
ទំព័រគំរូ:No	Template:Not done
ទំព័រគំរូ:Tick	Template:Tick
ចំណាត់ថ្នាក់ក្រុម:ទំព័រគំរូ ប្រអប់ព័ត៌មាន	Category:Infobox templates
ចំណាត់ថ្នាក់ក្រុម:Lists of flags	Category:Lists and galleries of flags
ទំព័រគំរូ:Topic	Template:Topic
ទំព័រគំរូ:ទិន្នន័យប្រទេស Nazi Germany	Template:Country data Nazi Germany
ទំព័រគំរូ:Select skin	Template:Select skin
ទំព័រគំរូ:Plainlist	Template:Plainlist
ចំណាត់ថ្នាក់ក្រុម:ហិរញ្ញវត្ថុសាធារណៈ	Category:Public finance
ទំព័រគំរូ:Divbox	Template:Divbox
ចំណាត់ថ្នាក់ក្រុម:អ្នកថតរូប	Category:Photography
ទំព័រគំរូ:Contains Japanese text	Template:Contains Japanese text
ទំព័រគំរូ:Para	Template:Para
ទំព័រគំរូ:Partial	Template:Partial
ចំណាត់ថ្នាក់ក្រុម:យន្តហោះយោធា	Category:Military aircraft
ទំព័រគំរូ:Conduct policy list	Template:Conduct policy list
ទំព័រគំរូ:Legend inline	Template:Legend inline
ទំព័រគំរូ:Death year and age	Template:Death year and age
ទំព័រគំរូ:LAO	Template:LAO
ទំព័រគំរូ:User zh-min-nan	Template:User nan
ទំព័រគំរូ:User zh-min-nan-1	Template:User nan-1
ទំព័រគំរូ:GRC	Template:GRC
ទំព័រគំរូ:PRT	Template:PRT
ទំព័រគំរូ:ទិន្នន័យ​នៃប្រទេសបង់ក្លាដែស្ស	Template:BGD
ទំព័រគំរូ:States of Austria	Template:States of Austria
ទំព័រគំរូ:Order of magnitude	Template:Order of magnitude
ទំព័រគំរូ:Category see also	Template:Category see also
ទំព័រគំរូ:Tlf	Template:Tlf
ទំព័រគំរូ:For	Template:For
ទំព័រគំរូ:Ifsubst	Template:Ifsubst
ទំព័រគំរូ:Not done-t	Template:Not done-t
ទំព័រគំរូ:Done-t	Template:Done-t
ទំព័រគំរូ:X mark-n	Template:X mark-n
ទំព័រគំរូ:Check mark-n	Template:Check mark-n
ទំព័រគំរូ:Sec link image	Template:Sec link image
ទំព័រគំរូ:Lower	Template:Lower
ទំព័រគំរូ:Voidd	Template:Voidd
ទំព័រគំរូ:Caution	Template:Caution
ទំព័រគំរូ:Flag template documentation	Template:Flag template documentation
ទំព័រគំរូ:Backlog	Template:Backlog
ទំព័រគំរូ:Osmrelation	Template:OSM relation
ទំព័រគំរូ:Science	Template:Science
ទំព័រគំរូ:ISOCALENDAR	Template:ISOCALENDAR
ចំណាត់ថ្នាក់ក្រុម:អង្គការមិនរកប្រាក់កំរៃ	Category:Nonprofit organizations
ទំព័រគំរូ:ប្រអប់ព័ត៌មាន អុីដ្រូសែន	Template:Infobox hydrogen
ទំព័រគំរូ:High-risk	Template:High-risk
ទំព័រគំរូ:Lang-uk	Template:Lang-uk
ទំព័រគំរូ:Contains Chinese text	Template:Contains Chinese text
ទំព័រគំរូ:KHM	Template:KHM
ទំព័រគំរូ:ប្រអប់ព័ត៌មាន អង្គការ	Template:Infobox organization
ទំព័រគំរូ:MNE	Template:MNE
ទំព័រគំរូ:Category TOC	Template:Category TOC
ទំព័រគំរូ:Thumbs up	Template:Thumbs up
ទំព័រគំរូ:Elementbox header	Template:Elementbox header
ទំព័រគំរូ:Resize	Template:Resize
ទំព័រគំរូ:IPA-fr	Template:IPA-fr
ទំព័រគំរូ:Fix	Template:Fix
ទំព័រគំរូ:Lang-nl	Template:Lang-nl
ទំព័រគំរូ:ទិន្នន័យ​នៃប្រទេសមីយ៉ាន់ម៉ា	Template:MMR
ទំព័រគំរូ:Lang-id	Template:Lang-id
ទំព័រគំរូ:GSE	Template:GSEn
ទំព័រគំរូ:MONTHDAYS	Template:MONTHDAYS
ទំព័រគំរូ:ទិន្នន័យ​នៃប្រទេសកូរ៉េខាងត្បូង	Template:KOR
ទំព័រគំរូ:EMedicine2	Template:EMedicine2
ទំព័រគំរូ:Chinese name	Template:Chinese name
ទំព័រគំរូ:Tn	Template:Tn
ទំព័រគំរូ:លំហឈ្មោះ	Template:Namespaces
ចំណាត់ថ្នាក់ក្រុម:User gsw-1	Category:User gsw-1
ទំព័រគំរូ:ទិន្នន័យប្រទេស កាតារ	Template:Country data Qatar
ទំព័រគំរូ:User it-2	Template:User it-2
ទំព័រគំរូ:Val	Template:Val
ទំព័រគំរូ:Lang-fr	Template:Lang-fr
ទំព័រគំរូ:មេកានិចក្លាស់សិច	Template:Classical mechanics
ទំព័រគំរូ:Superimpose	Template:Superimpose
ទំព័រគំរូ:FRA	Template:FRA
ទំព័រគំរូ:Age	Template:Age
ទំព័រគំរូ:Wrap	Template:Wrap
ទំព័រគំរូ:International trade	Template:International trade
ទំព័រគំរូ:Hang on	Template:Hang on
ទំព័រគំរូ:Flagicon image	Template:Flagicon image
ទំព័រគំរូ:Pending	Template:Pending
ទំព័រគំរូ:Infobox person	Template:Infobox person
ទំព័រគំរូ:?	Template:?
ទំព័រគំរូ:Concat	Template:Concat
ទំព័រគំរូ:ទិន្នន័យ នៃប្រទេសអ៊ីស្រាអែល	Template:Country data Israel
ទំព័រគំរូ:Number table sorting	Template:Number table sorting
ទំព័រគំរូ:List of European capitals by region	Template:List of European capitals by region
ទំព័រគំរូ:ទិន្នន័យប្រទេស កូឡុំប៊ី	Template:Country data Colombia
ទំព័រគំរូ:ទិន្នន័យ នៃប្រទេសប៉ាគីស្ថាន	Template:Country data Pakistan
ទំព័រគំរូ:ទិន្នន័យប្រទេស Ghana	Template:Country data Ghana
ទំព័រគំរូ:ទិន្នន័យប្រទេស កូរ៉េខាងត្បូង	Template:Country data South Korea
ទំព័រគំរូ:CIA World Factbook	Template:CIA World Factbook
ទំព័រគំរូ:Legend-line	Template:Legend-line
ចំណាត់ថ្នាក់ក្រុម:ព្រះមហាក្សត្រខ្មែរ	Category:Cambodian monarchs
ទំព័រគំរូ:Election table	Template:Election table
ទំព័រគំរូ:World Trade Organization	Template:World Trade Organization
ទំព័រគំរូ:UF-coord-classes	Template:UF-coord-classes
ទំព័រគំរូ:Coord	Template:Coord
ទំព័រគំរូ:POV	Template:POV
ទំព័រគំរូ:Citation/make link	Template:Citation/make link
ចំណាត់ថ្នាក់ក្រុម:20th-century births	Category:20th-century births
ទំព័រគំរូ:Dmoz	Template:Dmoz
ចំណាត់ថ្នាក់ក្រុម:ពហុកោណ	Category:Polygons
ទំព័រគំរូ:Fide	Template:Fide
ទំព័រគំរូ:User lb-1	Template:User lb-1
ទំព័រគំរូ:Dated maintenance category	Template:Dated maintenance category
ទំព័រគំរូ:User fr-4	Template:User fr-4
ទំព័រគំរូ:អាស៊ីហ្គេម	Template:Asian Games
ទំព័រគំរូ:User la-1	Template:User la-1
ទំព័រគំរូ:ហិរញ្ញវត្ថុសាធារណៈ	Template:Public finance
ទំព័រគំរូ:ទិន្នន័យប្រទេស បារ៉ែន	Template:Country data Bahrain
ទំព័រគំរូ:ព្រះពុទ្ធសាសនា	Template:Buddhism
ទំព័រគំរូ:Biology-stub	Template:Biology-stub
ទំព័រគំរូ:អេឡិចត្រូម៉ាញ៉េទិច	Template:Electromagnetism
ចំណាត់ថ្នាក់ក្រុម:ឯកសារអំពី ទំព័រគំរូ	Category:Template documentation pages
ចំណាត់ថ្នាក់ក្រុម:អត្ថបទខ្លីមិនពេញលេញ អំពីកម្ពុជា	Category:Cambodia stubs
ចំណាត់ថ្នាក់ក្រុម:User pdc	Category:User pdc
ចំណាត់ថ្នាក់ក្រុម:User et	Category:User et
ចំណាត់ថ្នាក់ក្រុម:User fr	Category:User fr
ចំណាត់ថ្នាក់ក្រុម:User id	Category:User id
ចំណាត់ថ្នាក់ក្រុម:User ja	Category:User ja
ចំណាត់ថ្នាក់ក្រុម:User km	Category:User km
ចំណាត់ថ្នាក់ក្រុម:User la	Category:User la
ចំណាត់ថ្នាក់ក្រុម:User li	Category:User li
ចំណាត់ថ្នាក់ក្រុម:User sv	Category:User sv
ចំណាត់ថ្នាក់ក្រុម:User th	Category:User th
ចំណាត់ថ្នាក់ក្រុម:User fr-3	Category:User fr-3
ចំណាត់ថ្នាក់ក្រុម:User it-3	Category:User it-3
ចំណាត់ថ្នាក់ក្រុម:User ja-3	Category:User ja-3
ចំណាត់ថ្នាក់ក្រុម:User tr-3	Category:User tr-3
ចំណាត់ថ្នាក់ក្រុម:User pdc-1	Category:User pdc-1
ចំណាត់ថ្នាក់ក្រុម:User et-1	Category:User et-1
ចំណាត់ថ្នាក់ក្រុម:User li-1	Category:User li-1
ចំណាត់ថ្នាក់ក្រុម:User nl-1	Category:User nl-1
ចំណាត់ថ្នាក់ក្រុម:User tr-1	Category:User tr-1
ចំណាត់ថ្នាក់ក្រុម:User ko-4	Category:User ko-4
ចំណាត់ថ្នាក់ក្រុម:User fr-4	Category:User fr-4
ចំណាត់ថ្នាក់ក្រុម:User it-4	Category:User it-4
ចំណាត់ថ្នាក់ក្រុម:User fr-2	Category:User fr-2
ចំណាត់ថ្នាក់ក្រុម:User it-2	Category:User it-2
ចំណាត់ថ្នាក់ក្រុម:User ja-2	Category:User ja-2
ចំណាត់ថ្នាក់ក្រុម:User la-2	Category:User la-2
ចំណាត់ថ្នាក់ក្រុម:User tr-2	Category:User tr-2
ចំណាត់ថ្នាក់ក្រុម:User fr-N	Category:User fr-N
ចំណាត់ថ្នាក់ក្រុម:User it-N	Category:User it-N
ចំណាត់ថ្នាក់ក្រុម:User nl-N	Category:User nl-N
ចំណាត់ថ្នាក់ក្រុម:User ru-N	Category:User ru-N
ចំណាត់ថ្នាក់ក្រុម:User it-5	Category:User it-5
ចំណាត់ថ្នាក់ក្រុម:កំសាន្ត	Category:Entertainment
ទំព័រគំរូ:Location map Asia2	Template:Location map Asia2
ឃុំកកោះ (ស្រុកមោងឫស្សី)	Kakaoh
ឃុំកំពង់ព្រះ	Kampong Preah
ឃុំកំពង់ព្រៀង	Kampong Preang
សង្កាត់កំពង់ស្វាយ	Kampong Svay, Banteay Meanchey
កម្ពុជាថ្មីប្រចាំថ្ងៃ	Kampuchea Thmei Daily
ស្រុកកណ្ដាលស្ទឹង	Kandal Stueng District
ស្រុកកងមាស	Kang Meas District
ឃុំកន្ទឺ ១	Kantueu Muoy
ឃុំកន្ទឺ ២	Kantueu Pir
ឃុំកោះជីវាំង	Kaoh Chiveang Thvang
ឃុំកោះពងសត្វ	Kaoh Pong Satv
ទំព័រគំរូ:Sister-inline	Template:Sister-inline
ទំព័រគំរូ:User Google	Template:User Google
ចំណាត់ថ្នាក់ក្រុម:Image insertion templates	Category:Single-image insertion templates
ទំព័រគំរូ:IncreaseNegative	Template:IncreaseNegative
សង្កាត់ក្តុលដូនទាវ	Kdol Doun Teav
ឃុំក្តុលតាហែន	Kdol Tahen
ឃុំគារ	Kear (khum)
គាត ឈន់	Keat Chhon
ទំព័រគំរូ:Beta	Template:Beta
ចំណាត់ថ្នាក់ក្រុម:User af	Category:User af
ចំណាត់ថ្នាក់ក្រុម:User af-1	Category:User af-1
ចំណាត់ថ្នាក់ក្រុម:User bar	Category:User bar
ចំណាត់ថ្នាក់ក្រុម:User bar-1	Category:User bar-1
ចំណាត់ថ្នាក់ក្រុម:កោះ	Category:Islands
ទំព័រគំរូ:UF-hcard-person	Template:UF-hcard-person
ចំណាត់ថ្នាក់ក្រុម:User de	Category:User de
ទំព័រគំរូ:Calendar	Template:Calendar
ទំព័រគំរូ:Calendar/MonthStartSun	Template:Calendar/isoMonthStartSun
ទំព័រគំរូ:ប្រតិទិន/MonthStartFri	Template:Calendar/isoMonthStartFri
ទំព័រគំរូ:Calendar/MonthStartMon	Template:Calendar/isoMonthStartMon
ទំព័រគំរូ:Calendar/MonthStartWed	Template:Calendar/isoMonthStartWed
ទំព័រគំរូ:Calendar/MonthStartTue	Template:Calendar/isoMonthStartTue
ចំណាត់ថ្នាក់ក្រុម:User de-2	Category:User de-2
ទំព័រគំរូ:Calendar/MonthStartThu	Template:Calendar/isoMonthStartThu
ចំណាត់ថ្នាក់ក្រុម:User de-3	Category:User de-3
ចំណាត់ថ្នាក់ក្រុម:User de-4	Category:User de-4
ចំណាត់ថ្នាក់ក្រុម:User de-N	Category:User de-N
ចំណាត់ថ្នាក់ក្រុម:User el	Category:User el
ចំណាត់ថ្នាក់ក្រុម:User en-3	Category:User en-3
ចំណាត់ថ្នាក់ក្រុម:User en-N	Category:User en-N
ចំណាត់ថ្នាក់ក្រុម:User es	Category:User es
ចំណាត់ថ្នាក់ក្រុម:User es-1	Category:User es-1
ចំណាត់ថ្នាក់ក្រុម:User es-2	Category:User es-2
ចំណាត់ថ្នាក់ក្រុម:User es-4	Category:User es-4
ចំណាត់ថ្នាក់ក្រុម:User es-N	Category:User es-N
សំលៀកបំពាក់ខ្មែរ	Khmer clothing
ចំណាត់ថ្នាក់ក្រុម:User fi	Category:User fi
ចំណាត់ថ្នាក់ក្រុម:User fi-N	Category:User fi-N
ចំណាត់ថ្នាក់ក្រុម:User gsw	Category:User gsw
ទំព័រគំរូ:N/a	Template:N/a
ទំព័រគំរូ:Bcdb	Template:Bcdb
ចំណាត់ថ្នាក់ក្រុម:User id-1	Category:User id-1
ចំណាត់ថ្នាក់ក្រុម:User id-2	Category:User id-2
ចំណាត់ថ្នាក់ក្រុម:User id-3	Category:User id-3
គាស់ក្រឡ	Koas Krala
ឃុំគាស់ក្រឡ	Koas Krala (commune)
ស្រុកកោះធំ	Koh Thum District
ទំព័រគំរូ:Beijing	Template:Beijing
គង់ សំអឿន	Kong Som Eun
ទំព័រគំរូ:ទិន្នន័យ នៃប្រទេសអាល្លឺម៉ង់	Template:Country data Germany
ឃុំកូប	Koub
ឃុំគោកកឋិន	Kouk Kakthen
ឃុំគោកឃ្មុំ	Kouk Khmum
ឃុំគោករមៀត	Kouk Romiet
ទំព័រគំរូ:Multiple image	Template:Multiple image
ឃុំគយម៉ែង	Koy Maeng
ទំព័រគំរូ:ទិន្នន័យប្រទេស ចក្រភពអង់គ្លេស	Template:Country data United Kingdom
ចំណាត់ថ្នាក់ក្រុម:ធរណីមាត្រ	Category:Geometry
ក្រពើ (ឧបករណ៍ភ្លេង)	Krapeu
ទំព័រគំរូ:អង្គការសហប្រជាជាតិ	Template:United Nations
ទំព័រគំរូ:ប្រអប់ព័ត៌មាន រោគ-ជំងឺ	Template:Infobox medical condition
ទំព័រគំរូ:The Working Wikipedian's Barnstar	Template:The Working Wikipedian's Barnstar
ទំព័រគំរូ:User wikipedia/Administrator	Template:User wikipedia/Administrator
ទំព័រគំរូ:Weather box	Template:Weather box
ដែនជំរកសត្វព្រៃគូលេនព្រហ្មទេព	Kulen Promtep Wildlife Sanctuary
វិគីភីឌា:អត្ថបទ​ប្រចាំ​ថ្ងៃ	Wikipedia:Today's featured article
ទំព័រគំរូ:E number infobox 930-949	Template:E number infobox 930-949
ឃុំគំរូ	Kumru, Cambodia
ចំណាត់ថ្នាក់ក្រុម:User it	Category:User it
ចំណាត់ថ្នាក់ក្រុម:User it-1	Category:User it-1
ចំណាត់ថ្នាក់ក្រុម:User ja-1	Category:User ja-1
ចំណាត់ថ្នាក់ក្រុម:User km-1	Category:User km-1
ចំណាត់ថ្នាក់ក្រុម:User km-2	Category:User km-2
ចំណាត់ថ្នាក់ក្រុម:User km-3	Category:User km-3
ចំណាត់ថ្នាក់ក្រុម:User km-4	Category:User km-4
ចំណាត់ថ្នាក់ក្រុម:User km-N	Category:User km-N
ចំណាត់ថ្នាក់ក្រុម:User ko	Category:User ko
ចំណាត់ថ្នាក់ក្រុម:User ko-1	Category:User ko-1
ចំណាត់ថ្នាក់ក្រុម:User ko-2	Category:User ko-2
ចំណាត់ថ្នាក់ក្រុម:User ko-3	Category:User ko-3
ចំណាត់ថ្នាក់ក្រុម:User ksh	Category:User ksh
ចំណាត់ថ្នាក់ក្រុម:User ksh-N	Category:User ksh-N
ឃុំគុត្តសត	Kuttasat
ចំណាត់ថ្នាក់ក្រុម:User la-1	Category:User la-1
ចំណាត់ថ្នាក់ក្រុម:User lb	Category:User lb
ចំណាត់ថ្នាក់ក្រុម:User lb-1	Category:User lb-1
ទំព័រគំរូ:Multiple issues	Template:Multiple issues
ទំព័រគំរូ:Economics sidebar	Template:Economics sidebar
ទំព័រគំរូ:Cite doi	Template:Cite doi
ទំព័រគំរូ:ប្រអប់ព័ត៌មាន រូបិយវត្ថុ	Template:Infobox currency
ទំព័រគំរូ:Sup	Template:Sup
ឧកញ៉ាសុត្តន្តប្រីជាឥន្ត	L'Okhna Suttantaprija ind
ទំព័រគំរូ:Current U.S. Senators	Template:Current U.S. Senators
ទំព័រគំរូ:Lang-vi	Template:Lang-vi
ទំព័រគំរូ:Translation	Template:Translation WIP
ទំព័រគំរូ:Protection templates	Template:Protection templates
ទំព័រគំរូ:Distinguish	Template:Distinguish
ទំព័រគំរូ:Infobox programming language	Template:Infobox programming language
ទំព័រគំរូ:He icon	Template:He icon
បញ្ជីរាយនាម ជ័យលាភីរង្វាន់ណូបែល ផ្នែកអក្សរសាស្ត្រ	List of Nobel laureates in Literature
វិគីភីឌា:Maintenance	Wikipedia:Maintenance
ទំព័រគំរូ:Information	Template:Information
ទំព័រគំរូ:Pp-protected	Template:Pp
ទំព័រគំរូ:Comics infobox sec	Template:Comics infobox sec
ចំណាត់ថ្នាក់ក្រុម:អត្ថបទវិគីភីឌាដែលត្រូវការការបកប្រែ	Category:Wikipedia articles needing translation
ចំណាត់ថ្នាក់ក្រុម:User ru-1	Category:User ru-1
ទំព័រគំរូ:TOC limit	Template:TOC limit
វិគីភីឌា:បាបេល	Wikipedia:Babel
ទំព័រគំរូ:Hilite	Template:Hilite
ទំព័រគំរូ:High-use	Template:High-use
ល្ខោនខោល	Lakhon khol
ល្ខោនពោលស្រី	Lakhon pol srey
ទំព័រគំរូ:Expand list	Template:Expand list
ទំព័រគំរូ:Country IOC alias GBR	Template:Country IOC alias GBR
ទំព័រគំរូ:Crystalball	Template:Crystalball
ទំព័រគំរូ:Tdeprecated	Template:Deprecated template
ទំព័រគំរូ:Help pages header	Template:Help pages header
ទំព័រគំរូ:Infobox particle	Template:Infobox particle
ចំណាត់ថ្នាក់ក្រុម:1900s births	Category:1900s births
ទំព័រគំរូ:Wikipedia how to	Template:Wikipedia how to
ទំព័រគំរូ:UN Security Council	Template:UN Security Council
ទំព័រគំរូ:Sidebar with collapsible lists	Template:Sidebar with collapsible lists
ទំព័រគំរូ:Talk other	Template:Talk other
ចំណាត់ថ្នាក់ក្រុម:User ms-2	Category:User ms-2
ទំព័រគំរូ:Redirect2	Template:Redirect2
ចំណាត់ថ្នាក់ក្រុម:សមុទ្រ	Category:Seas
ទំព័រគំរូ:ISO standards	Template:ISO standards
ទំព័រគំរូ:User WikiProject Templates	User:Willscrlt/UBX/UbxWPT1Crochets
ទំព័រគំរូ:FishBase genus	Template:FishBase genus
ទំព័រគំរូ:User2	Template:User2
ទំព័រគំរូ:Other people	Template:Other people
ទំព័រគំរូ:CSS3 multiple column layout	Template:CSS3 multiple column layout
ទំព័រគំរូ:User OS:Microsoft Windows	Template:User OS:Windows
ទំព័រគំរូ:FishBase family	Template:FishBase family
ទំព័រគំរូ:IPA-all	Template:IPA-all
គណបក្សសម្ព័ន្ធដើម្បីប្រជាធិបតេយ្យ	League for Democracy Party
ទំព័រគំរូ:Chess diagram 8x10	Template:Chess diagram 8x10
វិសមភាព លេបេដេវ-មីលីន	Lebedev–Milin inequality
ទំព័រគំរូ:Lang-ko	Template:Lang-ko
ទំព័រគំរូ:Lang-it	Template:Lang-it
ចំណាត់ថ្នាក់ក្រុម:User nds	Category:User nds
ទំព័រគំរូ:Sect1911	Template:EB1911
ចំណាត់ថ្នាក់ក្រុម:User nds-1	Category:User nds-1
ទំព័រគំរូ:Coord/dms2dec	Template:Coord/dms2dec
ជំនួយ:Archiving a talk page	Help:Archiving a talk page
ទំព័រគំរូ:ទិន្នន័យ នៃប្រទេសប្រេស៊ីល	Template:Country data Brazil
វិគីភីឌា:WikiProject Computing	Wikipedia:WikiProject Computer science
ចំណាត់ថ្នាក់ក្រុម:អង្គការអន្តរជាតិ	Category:International organizations
ទំព័រគំរូ:មេកានិចកង់ទិច	Template:Quantum mechanics
ទំព័រគំរូ:Db-meta	Template:Db-meta
ទំព័រគំរូ:Db-g1	Template:Db-g1
ទំព័រគំរូ:Sfn	Template:Sfn
ជំនួយ:សៀវភៅ	Help:Books
ទំព័រគំរូ:Infobox settlement/lengthdisp	Template:Infobox settlement/lengthdisp
ចំណាត់ថ្នាក់ក្រុម:សមីការឌីផេរ៉ង់ស្យែល	Category:Differential equations
ចំណាត់ថ្នាក់ក្រុម:ខេត្តក្រុងខ្មែរ	Category:Provinces of Cambodia
ទំព័រគំរូ:Lang-lo	Template:Lang-lo
ចំណាត់ថ្នាក់ក្រុម:User zh-min-nan	Category:User nan
ទំព័រគំរូ:Release date and age	Template:Start date and age
ចំណាត់ថ្នាក់ក្រុម:User zh-min-nan-3	Category:User nan-3
ទំព័រគំរូ:Ms icon	Template:Ms icon
ទំព័រគំរូ:Omega Chess diagram	Template:Omega Chess diagram
ចំណាត់ថ្នាក់ក្រុម:ឧទ្ធម្ភាគចក្រ	Category:Helicopters
ចំណាត់ថ្នាក់ក្រុម:នាយករដ្ឋមន្ត្រី	Category:Prime ministers
ចំណាត់ថ្នាក់ក្រុម:វិទ្យាសាស្ត្រសង្គម	Category:Social sciences
ឈាន	Dhyāna in Buddhism
ទំព័រគំរូ:ទិន្នន័យ នៃប្រទេសហុងគ្រី	Template:Country data Hungary
ទំព័រគំរូ:Non-free game cover	Template:Non-free video game cover
ទំព័រគំរូ:User zh-0	Template:User zh-0
ទំព័រគំរូ:Template reference list	Template:Template reference list
ចំណាត់ថ្នាក់ក្រុម:ឆ្នាំកំណើត ១៩៥១	Category:1951 births
ទំព័រគំរូ:Mdash	Template:--
ទំព័រគំរូ:Zh icon	Template:Zh icon
ទំព័រគំរូ:Advert	Template:Advert
ទំព័រគំរូ:Infobox government agency	Template:Infobox government agency
ទំព័រគំរូ:Babel-N	Template:Babel-N
វិគីភីឌា:Tools	Wikipedia:Tools
ទំព័រគំរូ:User ru-2	Template:User ru-2
ទំព័រគំរូ:Footer ISO 639	Template:Footer ISO 639
ចំណាត់ថ្នាក់ក្រុម:User ru	Category:User ru
ចំណាត់ថ្នាក់ក្រុម:User ru-2	Category:User ru-2
ចំណាត់ថ្នាក់ក្រុម:User ru-3	Category:User ru-3
ចំណាត់ថ្នាក់ក្រុម:វត្តអារាមព្រះពុទ្ធសាសនា	Category:Buddhist temples
ទំព័រគំរូ:S-reg	Template:S-reg
ចំណាត់ថ្នាក់ក្រុម:User sxu	Category:User sxu
ចំណាត់ថ្នាក់ក្រុម:User sxu-1	Category:User sxu-1
ទំព័រគំរូ:Apollo program	Template:Apollo program
ចំណាត់ថ្នាក់ក្រុម:User th-1	Category:User th-1
ចំណាត់ថ្នាក់ក្រុម:User th-N	Category:User th-N
ចំណាត់ថ្នាក់ក្រុម:User tr	Category:User tr
ចំណាត់ថ្នាក់ក្រុម:User tr-4	Category:User tr-4
ចំណាត់ថ្នាក់ក្រុម:User tr-5	Category:User tr-5
ចំណាត់ថ្នាក់ក្រុម:User tr-N	Category:User tr-N
ចំណាត់ថ្នាក់ក្រុម:User vls	Category:User vls
ចំណាត់ថ្នាក់ក្រុម:User vls-1	Category:User vls-1
បញ្ជីរាយនាម នាយករដ្ឋមន្ត្រីកម្ពុជា	List of Prime Ministers of Cambodia
ទំព័រគំរូ:En icon	Template:En icon
ទំព័រគំរូ:Nay	Template:Nay
ទំព័រគំរូ:Alice chess diagram	Template:Bughouse chess diagram
ទំព័រគំរូ:Spaces	Template:Spaces
ទំព័រគំរូ:CURRENTWEEKDAY	Template:CURRENTWEEKDAY
ទំព័រគំរូ:ប្រអប់ភាសា	Template:Lang
ទំព័រគំរូ:FishBase species alt	Template:FishBase
ទំព័រគំរូ:Country flag IOC alias GBR	Template:Country flag IOC alias GBR
ទំព័រគំរូ:Country IOC alias USA	Template:Country IOC alias USA
ទំព័រគំរូ:ទិន្នន័យប្រទេស Russian SFSR	Template:Country data Russian SFSR
ទំព័រគំរូ:In-universe	Template:In-universe
ទំព័រគំរូ:Infobox Olympics Cambodia	Template:Infobox Olympics Cambodia
ជំនួយ:Files	Help:Files
បញ្ជីរាយនាម សាកលវិទ្យាល័យនៅកម្ពុជា	List of universities in Cambodia
ទំព័រគំរូ:ទិន្នន័យប្រទេស តួកម៉េនីស្ថាន	Template:Country data Turkmenistan
ទំព័រគំរូ:2008-Olympic-stub	Template:2008-Olympic-stub
ទំព័រគំរូ:Str index	Template:Str index
ទំព័រគំរូ:TakeNote	Template:A note
ទំព័រគំរូ:Admin help	Template:Admin help
ទំព័រគំរូ:Admin-note	Template:Administrator note
ដែនជំរកសត្វព្រៃលំផាត់	Lomphat Wildlife Sanctuary
ទំព័រគំរូ:Self	Template:Self
ទំព័រគំរូ:Age in years, months, weeks and days	Template:Age in years, months, weeks and days
ទំព័រគំរូ:Alabama	Template:Alabama
ទំព័រគំរូ:ខេត្តអានយ៉ាង	Template:An Giang Province
ទំព័រគំរូ:Angkorian sites	Template:Angkorian sites
ទំព័រគំរូ:Any	Template:Any
ទំព័រគំរូ:Accepted	Template:Approved
ទំព័រគំរូ:Archive list long	Template:Archive list long
ទំព័រគំរូ:Humanities-footer	Template:Humanities
ទំព័រគំរូ:កាលពី	Template:As of
ទំព័រគំរូ:Asbox/stubtree/3	Template:Asbox/stubtree/3
ទំព័រគំរូ:Asbox/templatepage	Template:Asbox/templatepage
ទំព័រគំរូ:ប្រធានបទអាស៊ី	Template:Asia topic
ទំព័រគំរូ:Copyright by Wikimedia	Template:Non-free Wikimedia logo
ទំព័រគំរូ:IPAkeys	Template:IPA keys
ទំព័រគំរូ:Audio editors	Template:Audio editing software
ទំព័រគំរូ:Auxiliary template common notice	Template:Auxiliary template common notice
ទំព័រគំរូ:Aye	Template:Aye
ចំណាត់ថ្នាក់ក្រុម:ធរណីមាត្រត្រីកោណ	Category:Triangle geometry
វិទ្យាល័យព្រះស៊ីសុវត្ថិ	Lycee Sisowath
ទំព័រគំរូ:BDYearsInDecade	Template:BDYearsInDecade
ទំព័រគំរូ:BLP	Template:BLP
ទំព័រគំរូ:BLACK	Template:BLACK
ទំព័រគំរូ:BOTREQ	Template:BOTREQ
ទំព័រគំរូ:Bar percent	Template:Bar percent
ទំព័រគំរូ:Bcdb2	Template:Bcdb2
ទំព័រគំរូ:Begin flag gallery	Template:Begin flag gallery
ទំព័រគំរូ:Str find	Template:Str find
ទំព័រគំរូ:Bu	Template:Bu
ទំព័រគំរូ:ពុទ្ធស្ថាន	Template:BuddhasHolySites
ទំព័រគំរូ:ប្រធានបទ ព្រះពុទ្ធសាសនា	Template:Buddhism topics
ទំព័រគំរូ:Bureaucrat-note	Template:Bureaucrat note
ទំព័រគំរូ:C-SPAN	Template:C-SPAN
ទំព័រគំរូ:CENTURY	Template:CENTURY
ចំណាត់ថ្នាក់ក្រុម:គ្រឹះស្ថានឧត្តមសិក្សាសាធារណៈនៅប្រទេសជប៉ុន	Category:Japanese national universities
ទំព័រគំរូ:CURRENTISOYEAR	Template:CURRENTISOYEAR
ទំព័រគំរូ:Fr icon	Template:Fr icon
ទំព័រគំរូ:Calendar/Sun1stMonthStartអាទិត្យ	Template:Calendar/Sun1stMonthStartSun
ទំព័រគំរូ:ប្រតិទិន/Sun1stMonthStartWed	Template:Calendar/Sun1stMonthStartWed
ឃុំម៉ាឡៃ	Malai (commune)
ទំព័រគំរូ:UF-date-warn	Template:UF-date-warn
ទំព័រគំរូ:Twitter	Template:Twitter
ទំព័រគំរូ:UF-date-part	Template:UF-date-part
ទំព័រគំរូ:Ko icon	Template:Ko icon
ទំព័រគំរូ:សារ ទំព័រគំរូ វិគីភីឌា	Template:Wikipedia template messages
ទំព័រគំរូ:ប្រទេសនិងទឹកដីនៃអាស៊ីអាគ្នេយ៍	Template:Countries and territories of Southeast Asia
ទំព័រគំរូ:Lang-hi	Template:Lang-hi
ទំព័រគំរូ:Chembox header	Template:Chembox header
ទំព័រគំរូ:Convert/-/AoffSoff	Template:Convert/-/AoffSoff
ទំព័រគំរូ:Convert/And0	Template:Convert/And0
ទំព័រគំរូ:Convert/LoutAonDbSoff	Template:Convert/LoutAonDbSoff
ទំព័រគំរូ:Convert/and/AoffSoff	Template:Convert/and/AoffSoff
ទំព័រគំរូ:Convert/bar	Template:Convert/bar
ទំព័រគំរូ:Convert/cm2	Template:Convert/cm2
ទំព័រគំរូ:Convert/mm2	Template:Convert/mm2
ទំព័រគំរូ:Convert/sqin	Template:Convert/sqin
ទំព័រគំរូ:Convert/sqnmi	Template:Convert/sqnmi
ទំព័រគំរូ:Convert/sqyd	Template:Convert/sqyd
ទំព័រគំរូ:Convert/tsubo	Template:Convert/tsubo
ទំព័រគំរូ:Convert/x/AoffSoff	Template:Convert/x/AoffSoff
ទំព័រគំរូ:Convert/±/AoffSoff	Template:Convert/±/AoffSoff
ទំព័រគំរូ:Convert/±/AonSoff	Template:Convert/±/AonSoff
ទំព័រគំរូ:Coord/dec2dms/dm	Template:Coord/dec2dms/dm
ចំណាត់ថ្នាក់ក្រុម:Image with comment templates	Category:Image with comment templates
ឃុំមានជ័យ	Mean Cheay
ខណ្ឌមានជ័យ	Meanchey District
ចំណាត់ថ្នាក់ក្រុម:ទំព័រគំរូសំរាប់ចំនងជើង	Category:Title templates
ទំព័រគំរូ:Country flag IOC alias ZZX	Template:Country flag IOC alias ZZX
ទំព័រគំរូ:EST	Template:EST
ទំព័រគំរូ:Elementbox isotopes stable	Template:Infobox element/isotopes stable
ទំព័រគំរូ:Football squad end	Template:Football squad end
ទំព័រគំរូ:IUCNlink	Template:IUCNlink
ទំព័រគំរូ:IAFD name	Template:IAFD name
ទំព័រគំរូ:Weather box/cold	Template:Weather box/cold
ទំព័រគំរូ:Event	Template:Event
ទំព័រគំរូ:ទិន្នន័យ​នៃប្រទេសរុស្ស៊ី	Template:RUS
ទំព័រគំរូ:UF-COinS	Template:UF-COinS
ម៉ែន សំអន	Men Sam An
ទំព័រគំរូ:Importance/colour	Template:Importance/colour
ទំព័រគំរូ:WEEKDAYNAME	Template:WEEKDAYNAME
ទំព័រគំរូ:Fossil range/marker	Template:Fossil range/marker
ទំព័រគំរូ:Five Oceans	Template:Five oceans
ទំព័រគំរូ:Compu-domain-stub	Template:Compu-domain-stub
ទំព័រគំរូ:ICD9	Template:ICD9
ទំព័រគំរូ:ប្រវត្តិសាស្ត្របារាំង	Template:History of France
ទំព័រគំរូ:MONTH	Template:MONTH
ទំព័រគំរូ:CHL	Template:CHL
ទំព័រគំរូ:ASEAN	Template:Association of Southeast Asian Nations (ASEAN)
ទំព័រគំរូ:Gray's	Template:Gray's
ទំព័រគំរូ:User information templates	Template:Userspace linking templates
ទំព័រគំរូ:Campaign	Template:Campaignbox
ទំព័រគំរូ:ប្រអប់យុទ្ធនាការសង្គ្រាមឥណ្ឌូចិន	Template:Campaignbox Indochina Wars
ទំព័រគំរូ:Category disambiguation	Template:Category disambiguation
ទំព័រគំរូ:Category handler/blacklist	Template:Category handler/blacklist
ទំព័រគំរូ:Category handler/numbered	Template:Category handler/numbered
ក្រសួងកសិកម្ម រុក្ខាប្រមាញ់ និងនេសាទ	Ministry of Agriculture, Forestry and Fisheries (Cambodia)
ក្រសួងវប្បធម៌ និងវិចិត្រសិល្បៈ	Ministry of Culture and Fine Arts (Cambodia)
ទំព័រគំរូ:Cc-by-sa-3.0,2.5,2.0,1.0	Template:Cc-by-sa-3.0,2.5,2.0,1.0
ក្រសួងសុខាភិបាល	Ministry of Health (Cambodia)
ក្រសួងឧស្សាហកម្ម រ៉ែ និងថាមពល	Ministry of Industry, Mining and Energy (Cambodia)
ក្រសួងមហាផ្ទៃ	Ministry of Interior (Cambodia)
ក្រសួងរៀបចំដែនដី នគររូបនីយកម្ម និងសំណង់	Ministry of Land Management, Urban Planning and Construction (Cambodia)
ក្រសួងការពារជាតិ	Ministry of National Defense (Cambodia)
ក្រសួងផែនការ	Ministry of Planning (Cambodia)
ក្រសួងប្រៃសណីយ៍ និងទូរគមនាគមន៍	Ministry of Posts and Telecommunications (Cambodia)
ក្រសួងសាធារណៈការ និងដឹកជញ្ជូន	Ministry of Public Works and Transport (Cambodia)
ទំព័រគំរូ:WEEKDAYNUMBER	Template:WEEKDAYNUMBER
ទំព័រគំរូ:Centralized discussion	Template:Centralized discussion
ទំព័រគំរូ:Central banks	Template:Central banks
ទំព័រគំរូ:ទិន្នន័យ​នៃប្រទេសស៊ីរី	Template:SYR
ទំព័រគំរូ:Check date	Template:Check date
ទំព័រគំរូ:Check talk	Template:Check talk
ទំព័រគំរូ:Check mark templates	Template:Check mark templates
ទំព័រគំរូ:Familytree/step2	Template:Family tree/step2
ទំព័រគំរូ:Toolbar	Template:Toolbar
ទំព័រគំរូ:FCpages	Template:FCpages
ស្រុកមិត្តភាព	Mittakpheap District
ឃុំម្កាក់	Mkak
ទំព័រគំរូ:Yesno	Template:Yesno
ទំព័រគំរូ:For2	Template:For2
ទំព័រគំរូ:China-bio-stub	Template:China-bio-stub
ទំព័រគំរូ:Side box	Template:Side box
ទំព័រគំរូ:ENG	Template:ENG
ទំព័រគំរូ:Ffd	Template:Ffd
ទំព័រគំរូ:Tfd	Template:Template for discussion
ទំព័រគំរូ:Copy to Wikibooks	Template:Copy to Wikibooks
ឃុំមោង	Moung
ទំព័រគំរូ:Citation	Template:Citation
ទំព័រគំរូ:Citation/core	Template:Citation/core
ទំព័រគំរូ:Cat improve	Template:Improve categories
ទំព័រគំរូ:Expert-subject	Template:Expert-subject
ចំណាត់ថ្នាក់ក្រុម:ប្រទេសជាកោះ	Category:Island countries
ទំព័រគំរូ:Translation department	Template:Translation department
ទំព័រគំរូ:ប្រអប់ព័ត៌មាន ភាសា/family-color	Template:Infobox language/family-color
ទំព័រគំរូ:Wontfix	Template:Won't fix
ឃុំណាំតៅ	Nam Tau, Cambodia
ចំណាត់ថ្នាក់ក្រុម:Tracking categories	Category:Tracking categories
ទំព័រគំរូ:Grey	Template:Gray
ទំព័រគំរូ:User la-2	Template:User la-2
ទំព័រគំរូ:User ru-1	Template:User ru-1
ចំណាត់ថ្នាក់ក្រុម:អាំងតេក្រាល	Category:Integrals
ទំព័រគំរូ:User tr-1	Template:User tr-1
ទំព័រគំរូ:User zh-1	Template:User zh-1
ទំព័រគំរូ:User zh-2	Template:User zh-2
ទំព័រគំរូ:User zh-3	Template:User zh-3
ចំណាត់ថ្នាក់ក្រុម:រូបវិទូ	Category:Physicists by nationality
ទំព័រគំរូ:User zh-4	Template:User zh-4
ចំណាត់ថ្នាក់ក្រុម:គមនាគមន៍នៅប្រទេសជប៉ុន	Category:Transport in Japan
ចំណាត់ថ្នាក់ក្រុម:ប្រទេសហ្សំប៊ី	Category:Zambia
ទំព័រគំរូ:Cuisine	Template:Cuisine
សាកលវិទ្យាល័យជាតិគ្រប់គ្រង	National University of Management
អត្តសញ្ញាណជាតិនៃកម្ពុជា	National symbols of Cambodia
ទំព័រគំរូ:ទិន្នន័យប្រទេស យូហ៊្គោស្លាវី	Template:Country data Yugoslavia
ទំព័រគំរូ:Calm talk	Template:Calm
ទំព័រគំរូ:Multi-listen end	Template:Multi-listen end
ចំណាត់ថ្នាក់ក្រុម:ការអប់រំនៅប្រទេសជប៉ុន	Category:Education in Japan
ចំណាត់ថ្នាក់ក្រុម:ការអប់រំនៅកម្ពុជា	Category:Education in Cambodia
ចំណាត់ថ្នាក់ក្រុម:Disambiguation and redirection templates	Category:Disambiguation and redirection templates
ការពិភាក្សារបស់អ្នកប្រើប្រាស់:វ័ណថារិទ្ធ/រូបភាពប្រចាំថ្ងៃ	Wikipedia:Picture of the day
ទំព័រគំរូ:Tlrow	Template:Tlrow
ចំណាត់ថ្នាក់ក្រុម:User nl	Category:User nl
ទំព័រគំរូ:Unbulleted list	Template:Unbulleted list
ចំណាត់ថ្នាក់ក្រុម:User zh-1	Category:User zh-1
ចំណាត់ថ្នាក់ក្រុម:User zh-4	Category:User zh-4
ចំណាត់ថ្នាក់ក្រុម:User zh-3	Category:User zh-3
ចំណាត់ថ្នាក់ក្រុម:User zh-2	Category:User zh-2
ចំណាត់ថ្នាក់ក្រុម:មេកានិច	Category:Mechanics
ចំណាត់ថ្នាក់ក្រុម:អនុគមន៍សនិទាន	Category:Rational functions
ចំណាត់ថ្នាក់ក្រុម:រូបវិទូអាល្លឺម៉ង់	Category:German physicists
ចំណាត់ថ្នាក់ក្រុម:រូបវិទូអ៊ីតាលី	Category:Italian physicists
ចំណាត់ថ្នាក់ក្រុម:រូបវិទូបារាំង	Category:French physicists
ចំណាត់ថ្នាក់ក្រុម:សេវាសាធារណៈ	Category:Public services
ចំណាត់ថ្នាក់ក្រុម:អិចស្ប៉ូណង់ស្យែល	Category:Exponentials
ទំព័រគំរូ:Tnavbar-header	Template:Navbar-header
ចំណាត់ថ្នាក់ក្រុម:ព្រឹត្តិការណ៍កីឡាចំរុះ	Category:Multi-sport events
ចំណាត់ថ្នាក់ក្រុម:គណិតវិទូអាល្លឺម៉ង់	Category:German mathematicians
ទំព័រគំរូ:User wikipedia/autopatrolled	Template:User wikipedia/Autopatrolled
ចំណាត់ថ្នាក់ក្រុម:ខេត្តក្រចេះ	Category:Kratié Province
ចំណាត់ថ្នាក់ក្រុម:ខេត្តកណ្តាល	Category:Kandal Province
ចំណាត់ថ្នាក់ក្រុម:ខេត្តកំពង់ចាម	Category:Kampong Cham Province
ទំព័រគំរូ:ទិន្នន័យប្រទេស វៀតណាមខាងជើង	Template:Country data North Vietnam
ចំណាត់ថ្នាក់ក្រុម:ខេត្តកំពង់ស្ពឺ	Category:Kampong Speu Province
ចំណាត់ថ្នាក់ក្រុម:ខេត្តកំពង់ធំ	Category:Kampong Thom Province
ចំណាត់ថ្នាក់ក្រុម:ខេត្តតាកែវ	Category:Takéo Province
ចំណាត់ថ្នាក់ក្រុម:ខេត្តបន្ទាយមានជ័យ	Category:Banteay Meanchey Province
ចំណាត់ថ្នាក់ក្រុម:ខេត្តមណ្ឌលគិរី	Category:Mondulkiri Province
ចំណាត់ថ្នាក់ក្រុម:ខេត្តរតនៈគិរី	Category:Ratanakiri Province
ចំណាត់ថ្នាក់ក្រុម:ខេត្តស្ទឹងត្រែង	Category:Stung Treng Province
ចំណាត់ថ្នាក់ក្រុម:ខេត្តស្វាយរៀង	Category:Svay Rieng Province
ចំណាត់ថ្នាក់ក្រុម:ខេត្តកោះកុង	Category:Koh Kong Province
ចំណាត់ថ្នាក់ក្រុម:ខេត្តពោធិ៍សាត់	Category:Pursat Province
ចំណាត់ថ្នាក់ក្រុម:ចំនួនគត់រឺឡាទីប	Category:Integers
ទំព័រគំរូ:V	Template:V
ចំណាត់ថ្នាក់ក្រុម:ស៊ីហ្គេម	Category:Southeast Asian Games
ចំណាត់ថ្នាក់ក្រុម:ត្រីកោណមាត្រ	Category:Trigonometry
ចំណាត់ថ្នាក់ក្រុម:ទ្រឹស្តីបទ	Category:Theorems
ចំណាត់ថ្នាក់ក្រុម:ទ្រឹស្តីបទគណិតវិទ្យា	Category:Mathematical theorems
ចំណាត់ថ្នាក់ក្រុម:អាកាសយានដ្ឋាន	Category:Airports
ឃុំនិមិត្ត	Nimitt
ចំណាត់ថ្នាក់ក្រុម:រូបវិទូអាមេរិក	Category:American physicists
ចំណាត់ថ្នាក់ក្រុម:រូបវិទូអង់គ្លេស	Category:English physicists
ចំណាត់ថ្នាក់ក្រុម:អ្នកនិពន្ធល្បី	Category:Cambodian writers
ចំណាត់ថ្នាក់ក្រុម:នាយករដ្ឋមន្ត្រីសិង្ហបុរី	Category:Prime Ministers of Singapore
ចំណាត់ថ្នាក់ក្រុម:រង្វាន់ណូបែល	Category:Nobel Prize
ទំព័រគំរូ:User pfl-1	Template:User pfl-1
ចំណាត់ថ្នាក់ក្រុម:Wikipedia shortcut box first parameter needs fixing	Category:Wikipedia shortcut box first parameter needs fixing
ចំណាត់ថ្នាក់ក្រុម:ប្រទេសកម្ពុជា	Category:Cambodia
ចំណាត់ថ្នាក់ក្រុម:អ្នកនយោបាយប៉ាគីស្ថាន	Category:Pakistani politicians
ទំព័រគំរូ:Lang-hy	Template:Lang-hy
ទំព័រគំរូ:Tlu	Template:Tlu
ទំព័រគំរូ:Retrieved	Template:Retrieved
ចំណាត់ថ្នាក់ក្រុម:អ្នកនយោបាយខ្មែរ	Category:Cambodian politicians
ចំណាត់ថ្នាក់ក្រុម:អ្នករុករកជនជាតិបារាំង	Category:French explorers
ចំណាត់ថ្នាក់ក្រុម:ស្រីលង្កា	Category:Sri Lanka
ចំណាត់ថ្នាក់ក្រុម:ទំព័រគំរូ រង្វាន់ណូបែល	Category:Nobel Prize templates
ចំណាត់ថ្នាក់ក្រុម:ទំព័រគំរូឈ្មោះភាសា	Category:Multilingual support templates
ចំណាត់ថ្នាក់ក្រុម:ទំព័រគំរូក្នុងរូបវិទ្យា	Category:Physics templates
ទំព័រគំរូ:ISO 639 name	Template:ISO 639 name
វិគីភីឌា:ត្រូវការអំណះអំណាង	Wikipedia:Citation needed
ទំព័រគំរូ:FeaturedPicture	Template:Featured picture
ឃុំអូរអំបិល	Ou Ambel
ឃុំអូរបីជាន់	Ou Bei Choan
សង្កាត់អូរចារ	Ou Char
ឃុំអូរដំបង ១	Ou Dambang Muoy
ឃុំអូរដា	Ou Da
ឃុំអូរដំបង ២	Ou Dambang Pir
ឃុំអូររំដួល	Ou Rumduol
ឃុំអូរសំព័រ	Ou Sampor
ឃុំអូរសំរិល	Ou Samrel
ឃុំអូរស្រឡៅ	Ou Sralau
ឃុំអូរតាគី	Ou Ta Ki
គម្រោងសេចក្ដីពុទ្ធសាសនា	Outline of Buddhism
ទំព័រគំរូ:Ed	Template:Ed
ទំព័រគំរូ:ទិន្នន័យប្រទេស Wales	Template:Country data Wales
ទំព័រគំរូ:MONTHABBREV	Template:MONTHABBREV
ចំណាត់ថ្នាក់ក្រុម:អុនសេន	Category:Hot springs
ឃុំប៉ោយចារ	Paoy Char
ចំណាត់ថ្នាក់ក្រុម:ពហុធា	Category:Polynomials
ចំណាត់ថ្នាក់ក្រុម:ពិជគណិតថ្នាក់ដំបូង	Category:Elementary algebra
ចំណាត់ថ្នាក់ក្រុម:អនុគមន៍	Category:Functions and mappings
ចំណាត់ថ្នាក់ក្រុម:ភាសាជប៉ុន	Category:Japanese language
ចំណាត់ថ្នាក់ក្រុម:មធ្យម	Category:Means
ចំណាត់ថ្នាក់ក្រុម:ចតុកោណ	Category:Quadrilaterals
ចំណាត់ថ្នាក់ក្រុម:ត្រីកោណ	Category:Triangles
ចំណាត់ថ្នាក់ក្រុម:សំភារៈ​សំណង់	Category:Building materials
ទំព័រគំរូ:S-off	Template:S-off
ចំណាត់ថ្នាក់ក្រុម:សមីការ	Category:Equations
ពន្ធលើប្រាក់បៀវត្ស	Payroll tax
ចំណាត់ថ្នាក់ក្រុម:ស្ពាននៅប្រទេសជប៉ុន	Category:Bridges in Japan
ឃុំពាមឯក	Peam Aek
ដែនជំរកសត្វព្រៃពាមក្រសោប	Peam Krasop Wildlife Sanctuary
ស្រុកពាមរ	Peam Ro District
ចំណាត់ថ្នាក់ក្រុម:សិទ្ធិ	Category:Rights
ឃុំពេជ្រចិន្តា	Pech Chenda
ចំណាត់ថ្នាក់ក្រុម:User pfl-1	Category:User pfl-1
ទំព័រគំរូ:Agriculture country lists	Template:Agriculture country lists
ទំព័រគំរូ:Hexadecimal	Template:Hexadecimal
ឃុំផ្គាំ	Phkoam
ឃុំផ្លូវមាស	Phlov Meas
ដែនជំរកសត្វព្រៃភ្នំឱរ៉ាល់	Phnom Aural Wildlife Sanctuary
ឃុំភ្នៀត	Phniet
ដែនជំរកសត្វព្រៃភ្នំណាមលៀត	Phnom Nam Lyr Wildlife Sanctuary
ដែនជំរកសត្វព្រៃភ្នំសំកុះ	Phnom Sankos Wildlife Sanctuary
ឃុំភ្នំលៀប	Phnum Lieb
ភ្នំព្រឹក	Phnum Proek
ឃុំភ្នំព្រឹក	Phnum Proek (commune)
ឃុំភ្នំតូច	Phnum Toch
ឃុំភ្នំសំពៅ	Phnum Sampov
ទំព័រគំរូ:Raise	Template:Raise
ឃុំភូមិថ្មី	Phum Thmei
ទំព័រគំរូ:S-end	Template:S-end
ពិសិដ្ឋ ពីលីកា	Pisith Pilika
ទំព័រគំរូ:Periodic tables key	Template:Periodic tables key
ទំព័រគំរូ:Db doc	Template:Db-c1
ទំព័រគំរូ:Template messages	Template:Template messages
ចំណាត់ថ្នាក់ក្រុម:វិភាគគណិតវិទ្យា	Category:Mathematical analysis
ទំព័រគំរូ:Stub documentation	Template:Stub documentation
ទំព័រគំរូ:Contents pages (header bar)	Template:Contents pages (header bar)
ចំណាត់ថ្នាក់ក្រុម:វិសមភាព	Category:Inequalities
ចំណាត់ថ្នាក់ក្រុម:ឧទ្យានជាតិ	Category:National parks
ចំណាត់ថ្នាក់ក្រុម:កោះស៊ូម៉ាត្រា	Category:Sumatra
ចំណាត់ថ្នាក់ក្រុម:មីក្រូសេដ្ឋកិច្ច	Category:Microeconomics
ចំណាត់ថ្នាក់ក្រុម:HTML	Category:HTML
ចំណាត់ថ្នាក់ក្រុម:អាស៊ីហ្គេម	Category:Asian Games
ទំព័រគំរូ:R from Unicode	Template:R from Unicode
ចំណាត់ថ្នាក់ក្រុម:អេឡិចត្រូស្តាទិច	Category:Electrostatics
ចំណាត់ថ្នាក់ក្រុម:អ៊ីសាក់ ញូតុន	Category:Isaac Newton
ចំណាត់ថ្នាក់ក្រុម:អាកាសចរណ៍	Category:Transport
ចំណាត់ថ្នាក់ក្រុម:គណិតវិទ្យាថ្នាក់ដំបូង	Category:Elementary mathematics
ចំណាត់ថ្នាក់ក្រុម:ខេត្តកំពត	Category:Kampot Province
ចំណាត់ថ្នាក់ក្រុម:ខេត្តព្រះវិហារ	Category:Preah Vihear Province
ចំណាត់ថ្នាក់ក្រុម:ខេត្តបាត់ដំបង	Category:Battambang Province
ចំណាត់ថ្នាក់ក្រុម:ខេត្តឧត្ដរមានជ័យ	Category:Oddar Meancheay Province
ចំណាត់ថ្នាក់ក្រុម:ខេត្តព្រៃវែង	Category:Prey Veng Province
ចំណាត់ថ្នាក់ក្រុម:ខេត្តសៀមរាប	Category:Siem Reap Province
ចំណាត់ថ្នាក់ក្រុម:ទ្រឹស្តីបទលេខ	Category:Number theory
ទំព័រគំរូ:ប្រអប់ព័ត៌មាន ភាសា	Template:Infobox language
ទំព័រគំរូ:អត្ថបទខ្លី អំពីកូរ៉េខាងត្បូង	Template:SouthKorea-stub
ទំព័រគំរូ:Wikiversity	Template:Wikiversity
ទំព័រគំរូ:Quickindexnav	Template:Quickindexnav
ទំព័រគំរូ:Statistics	Template:Statistics
ឃុំពន្លៃ	Ponley
វិធីសាស្រ្តស៊េរីស្វ័យគុណ	Power series solution of differential equations
ចំណាត់ថ្នាក់ក្រុម:ភាសាអ៊ីតាលី	Category:Italian language
ចំណាត់ថ្នាក់ក្រុម:ភាសាអេស្ប៉ាញ	Category:Spanish language
ចំណាត់ថ្នាក់ក្រុម:រថក្រោះ	Category:Tanks
ខណ្ឌប្រាំពីរមករា	Prampi Makara District
ឃុំប្រាសាទ	Prasat Char
ឃុំព្រែកខ្ពប	Preaek Khpob
ឃុំព្រែកនរិន្ទ	Preaek Norint
សង្កាត់ព្រែកព្រះស្តេច	Preaek Preah Sdach
ឃុំព្រះនេត្រព្រះ	Preah Netr Preah
ឃុំព្រះពន្លា	Preah Ponlea
ឃុំព្រែកជីក	Prek Chik
ទំព័រគំរូ:គោលការណ៍មូលដ្ឋានរបស់វិគីភីឌា	Template:Wikipedia principles
ឃុំព្រៃចាស់	Prey Chas
ឃុំព្រៃស្វាយ	Prey Svay
ឃុំព្រៃតូច	Prey Touch
ឃុំព្រៃត្រឡាច	Prey Tralach
ទំព័រគំរូ:Usbktop	Template:Usbktop
ទំព័រគំរូ:Usbk	Template:Usbk
ខេត្តនៃកម្ពុជា	Provinces of Cambodia
អាំងតេក្រាលនៃអនុគមន៍សនិទានដឺក្រេទី២	Quadratic integral
ទំព័រគំរូ:Lists by country	Template:Lists by country
ទំព័រគំរូ:Infobox polygon	Template:Infobox polygon
ចំណាត់ថ្នាក់ក្រុម:កោះរបស់ឥណ្ឌូនេស៊ី	Category:Islands of Indonesia
រាជ សម្បត្តិ	Reach Sambath
ឃុំរាំងកេសី	Reang Kesei
ទំព័រគំរូ:Update after	Template:Update after
ទំព័រគំរូ:WPBannerMeta	Template:WPBannerMeta
ទំព័រគំរូ:Cross	Template:Cross
ខេត្តលង់ហោរ	Vĩnh Long Province
សិទ្ធិធ្វើបាតុកម្ម	Right to protest
ទំព័រគំរូ:Navbox hatnote templates	Template:Hatnote templates
ឃុំរបស់មង្គល	Robas Mongkol
ចំណាត់ថ្នាក់ក្រុម:ភ្នំពេញ	Category:Phnom Penh
ចំណាត់ថ្នាក់ក្រុម:ឧទ្យានជាតិនៃព្រះរាជាណាចក្រកម្ពុជា	Category:National parks of Cambodia
ឃុំរហាល	Rohal
ឃុំរហាត់ទឹក	Rohat Tuek
ឃុំរកា (ស្រុកសង្កែ)	Roka
រនាតដែក	Roneat dek
រនាតធុង	Roneat thung
រនាតឯក	Roneat ek
ទំព័រគំរូ:CountryAbbr	Template:CountryAbbr
សង្កាត់រតនៈ	Rotanak
រាជបណ្ឌិត្យសភាកម្ពុជា	Royal Academy of Cambodia
សាកលវិទ្យាល័យភូមិន្ទកសិកម្ម	Royal University of Agriculture, Cambodia
សាកលវិទ្យាល័យភូមិន្ទវិចិត្រសិល្បៈ	Royal University of Fine Arts
សាកលវិទ្យាល័យភូមិន្ទនីតិសាស្ត្រនិងវិទ្យាសាស្ត្រសេដ្ឋកិច្ច	Royal University of Law and Economics
ឃុំឫស្សីក្រាំង	Ruessei Krang
ឃុំប្ញស្សីក្រោក	Ruessei Kraok
ឃុំរូងជ្រៃ	Rung Chrey
ខណ្ឌឫស្សីកែវ	Russey Keo District
ទំព័រគំរូ:Split	Template:Split
ស្រុកស្អាង	S'ang District
ស៊ីប៉ា (អង្គការ)	SIPAR
កម្វុ	Kambu Swayambhuva
ទំព័រគំរូ:រូបវិទ្យា	Template:Branches of physics
ឃុំសំបួរ (ស្រុកមង្គលបុរី)	Sambuor
ស្រុកសាមគ្គីមានជ័យ	Sameakki Mean Chey District
សម្បជញ្ញៈ	Sampajañña
សំរោង	Samraong
ឃុំសំរោង	Samraong, Banteay Meanchey (commune)
ឃុំសំរោងក្នុង	Samraong Knong
ចំណាត់ថ្នាក់ក្រុម:ធរណីមាត្រអ៊ីពែបូលីក	Category:Hyperbolic geometry
វិគីភីឌា:ឯកសារកម្មទំព័រគំរូ	Wikipedia:Template documentation
ឃុំសន្តិភាព	Santepheap
ឃុំសារង្គ	Sarongk
ឃុំស្តៅ	Sdau
ទំព័រគំរូ:CompactTOC8	Template:Compact ToC
ខណ្ឌសែនសុខ	Sen Sok District
ឃុំសិរីមានជ័យ	Serei Maen Cheay
ទំព័រគំរូ:Template sandbox notice	Template:Template sandbox notice
ទំព័រគំរូ:Dmbox	Template:Dmbox
ទំព័រគំរូ:Hydrogen compounds	Template:Hydrogen compounds
ទំព័រគំរូ:Tnavbar-navframe	Template:Navbar-navframe
ទំព័រគំរូ:Image frame	Template:Image frame
ទំព័រគំរូ:Ti	Template:Ti
ទំព័រគំរូ:Information page	Template:Information page
ទំព័រគំរូ:Subcat guideline	Template:Subcat guideline
ទំព័រគំរូ:Sec link	Template:Sec link
ចំណាត់ថ្នាក់ក្រុម:ម៉ាញ៉េតូស្តាទិច	Category:Magnetostatics
ចំណាត់ថ្នាក់ក្រុម:ក្រលាផ្ទៃ	Category:Area
ទំព័រគំរូ:File title	Template:File title
ទំព័រគំរូ:Pp-move	Template:Pp-move
ទំព័រគំរូ:WPFCevent	Template:Infobox former country/event
ទំព័រគំរូ:Infobox broadcasting network	Template:Infobox broadcasting network
ចំណាត់ថ្នាក់ក្រុម:លោការីត	Category:Logarithms
Portal:Current events/Headlines	Portal:Current events/Headlines
ទំព័រគំរូ:JD	Template:JD
ទំព័រគំរូ:CURRENTMINUTE	Template:CURRENTMINUTE
ទំព័រគំរូ:Substituted	Template:Subst only
ស្ទឹងសៀមរាប	Siem Reap River
ទំព័រគំរូ:ទិន្នន័យ​នៃប្រទេសអ៊ូបេគីស្ថាន	Template:UZB
ទំព័រគំរូ:OnHold	Template:On hold
ជំរំជនភៀសខ្លួន សាយធូ	Site Two Refugee Camp
ទំព័រគំរូ:Question	Template:Question
សង្កាត់ស្លាកែត	Sla Kaet
ឃុំស្លក្រាម	Sla Kram
ឃុំស្នឹង	Snoeng
ដែនជំរកសត្វព្រៃស្នូល	Snoul Wildlife Sanctuary
ឃុំសឿ	Soea
ឃុំសឹង្ហ	Soengh
សុខ ស្រីមុំ	Sok Sreymom
រឿងសូផាត	Sophat
ស៊ូ យ៉ាទី	Sou Yaty
បញ្ជីរាយនាម ជ័យលាភីរង្វាន់ណូបែល ផ្នែកគីមីវិទ្យា	List of Nobel laureates in Chemistry
ឃុំសូភី	Souphi
ទំព័រគំរូ:ខេត្ត-រាជធានីកម្ពុជា	Template:Provinces of Cambodia
ឃុំស្ពានស្រែង	Spean Sraeng Rouk
ទំព័រគំរូ:ទិន្នន័យ នៃប្រទេសអេស្ប៉ាញ	Template:Country data Spain
ទំព័រគំរូ:Usage of IPA templates	Template:Usage of IPA templates
ឃុំស្រះរាំង	Srah Reang
ឃុំស្រះជីក	Srah Chik
ស្រឡៃ	Sralai
កាសែតស្រឡាញ់ខ្មែរ	Sralanh Khmer
ទំព័រគំរូ:Pad	Template:Pad
ទំព័រគំរូ:If pagename	Template:When pagename is
ទំព័រគំរូ:ទិន្នន័យប្រទេស កាណាដា	Template:Country data Canada
ស្រុកស្ទោង	Stoung District
ទំព័រគំរូ:Class	Template:Class
ទំព័រគំរូ:Class mask	Template:Class mask
ក្រុងសួង	Suong, Cambodia
ទំព័រគំរូ:Collapsible sections option	Template:Collapsible sections option
ទំព័រគំរូ:Column-rule	Template:Column-rule
ទំព័រគំរូ:Connected contributor	Template:Connected contributor
ទំព័រគំរូ:Consensus	Template:Consensus
ទំព័រគំរូ:Conservation status	Template:Conservation status
ទំព័រគំរូ:Contradiction-inline	Template:Contradiction-inline
ទំព័រគំរូ:Convert/BTU	Template:Convert/BTU
ទំព័រគំរូ:Convert/C-change	Template:Convert/C-change
ទំព័រគំរូ:Convert/Dual/LoffAoffDxSoffT	Template:Convert/Dual/LoffAoffDxSoffT
ទំព័រគំរូ:Convert/LoffAoffDorSoff	Template:Convert/LoffAoffDorSoff
ទំព័រគំរូ:Convert/LoffAonDsSoffT	Template:Convert/LoffAoffDbrSoffT
ទំព័រគំរូ:Convert/and/AonSoff	Template:Convert/and/AonSoff
ឃុំស្វាយចេក	Svay Chek (commune)
ទំព័រគំរូ:Convert/list of units	Template:Convert/list of units
ទំព័រគំរូ:Convert/list of units/foot note	Template:Convert/list of units/foot note
ទំព័រគំរូ:Convert/list of units/length/SI	Template:Convert/list of units/length/SI
ទំព័រគំរូ:Convert/list of units/length/metric	Template:Convert/list of units/length/metric
ទំព័រគំរូ:Convert/nm	Template:Convert/nm
ទំព័រគំរូ:Convert/numdisp/frac	Template:Hands/numdisp/frac
ទំព័រគំរូ:Convert/numdisp/frac1	Template:Hands/numdisp/frac1
ទំព័រគំរូ:Convert/x/AonSoff	Template:Convert/x/AonSoff
ទំព័រគំរូ:Cookbook	Template:Cookbook
ទំព័រគំរូ:Coord/prec dec	Template:Coord/prec dec
ទំព័រគំរូ:CopyrightedFreeUseProvided	Template:CopyrightedFreeUseProvided
ទំព័រគំរូ:Council of Europe	Template:Council of Europe
ទំព័រគំរូ:Country IOC alias CAM	Template:Country IOC alias CAM
ទំព័រគំរូ:Flag	Template:Flag
ទំព័រគំរូ:Intellectual property	Template:Intellectual property
ទំព័រគំរូ:ទិន្នន័យប្រទេស ម៉ាល់ឌីវ	Template:Country data Maldives
ទំព័រគំរូ:ទិន្នន័យ នៃប្រទេសសិង្ហបុរី	Template:Country data Singapore
ទំព័រគំរូ:ទិន្នន័យប្រទេស យេម៉ែន	Template:Country data Yemen
ឃុំតាបែន	Ta Baen
ឃុំតាគង់	Ta Kong
ឃុំតាក្រី	Ta Krai
ឃុំតាគ្រាម	Ta Kream
ឃុំតាឡំ	Ta Lam
ឃុំតាលាស់	Ta Loas
ឃុំតាម៉ឺន	Ta Meun
ឃុំតាប៉ុន	Ta Pon
ឃុំតាពូង	Ta Pung
ឃុំតាសែន	Ta Saen
ឃុំតាសាញ	Ta Sanh
ឃុំតាសា្ត	Ta Sda
ឃុំតាតោក	Ta Taok
ទំព័រគំរូ:Lang-pl	Template:Lang-pl
ជនជាតិទំពួន	Tampuan people
ឃុំទានកាំ	Tean Kam
ទំព័រគំរូ:Country flag IOC alias USA	Template:Country flag IOC alias USA
ទំព័រគំរូ:ទំព័រគំរូវប្បធម៌អាស៊ី	Template:Culture of Asia templates
ទំព័រគំរូ:DANFS	Template:DANFS
ទំព័រគំរូ:DPP/logo	Template:DPP/logo
រ៉ូយ៉ាល់គ្រុប	The Royal Group
ល្ខោនខ្មែរ	Theatre of Cambodia
ទំព័រគំរូ:Unreliable sources	Template:Unreliable sources
ឃុំធិបតី	Thipakdei
ទំព័រគំរូ:Str right	Template:Str right
កាលប្បវត្តិសិង្ហបុរី	Timeline of Singaporean history
ទំព័រគំរូ:Diff	Template:Diff
ឃុំត្រែង	Traeng
ទ្រសោធំ	Tro sau thom
ទ្រខ្មែរ	Tro Khmer
ទ្រសោតូច	Tro sau toch
ទ្រអ៊ូ	Tro u
ទំព័រគំរូ:ប្រវត្តិសាស្ត្រវៀតណាម	Template:History of Vietnam
ឃុំទឹកថ្លា	Tuek Thla, Banteay Meanchey
សង្កាត់ទឹកថ្លា	Tuek Thla, Phnom Penh
រឿង ទុំទាវ	Tum Teav
ឃុំទួលពង្រ	Tuol Pongro
សង្កាត់ទួលតាឯក	Tuol Ta Aek
ចំណាត់ថ្នាក់ក្រុម:Protection templates	Category:Protection templates
សាកលវិទ្យាល័យវិទ្យាសាស្ត្រសុខាភិបាល	University of Health Sciences – Cambodia
វ៉ាន់ឌី កាអុន	Vandy Kaonn
ចំណាត់ថ្នាក់ក្រុម:ភាសាអង់គ្លេស	Category:English language
អ៊ូ វីរៈ	Virak Ou
សង្កាត់វត្តគរ	Voat Kor
វត្តបុទម	Wat Botum
វត្តមហាមន្ត្រី	Wat Moha Montrey
វត្តសារាវន្ត	Wat Saravan
ទំព័រគំរូ:FOSS	Template:FOSS
ទំព័រគំរូ:សង្គមនិយមតាមរដ្ឋ	Template:Socialism by state
ស្រុកកំពង់រោទិ៍	Kampong Rou District
Yahoo! Gallery	Yahoo! Gallery
យាយ ម៉ៅ	Yeay Mao
ទំព័រគំរូ:Scientists whose names are used as SI units	Template:Scientists whose names are used as SI units
ទំព័រគំរូ:OCA	Template:OCA
ទំព័រគំរូ:G8	Template:G8 nations
ទំព័រគំរូ:Cambodia-geo-stub	Template:Cambodia-geo-stub
ទំព័រគំរូ:Monarchies	Template:Monarchies
ទំព័រគំរូ:WikiProject Biography	Template:WikiProject Biography
ទំព័រគំរូ:សំលៀកបំពាក់	Template:Clothing
ទំព័រគំរូ:Fapages	Template:Fapages
ទំព័រគំរូ:Countries and regions of the Caucasus	Template:Countries and regions of the Caucasus
ទំព័រគំរូ:Guideline list	Template:Guideline list
ទំព័រគំរូ:Technology	Template:Technology
ទំព័រគំរូ:Diatomicelements	Template:Diatomicelements
ទំព័រគំរូ:Nature nav	Template:Nature
ទំព័រគំរូ:Style	Template:Style
ទំព័រគំរូ:ទីក្រុងធំៗបំផុតកម្ពុជា	Template:Largest cities of Cambodia
ទំព័រគំរូ:Time Persons of the Year 2001–2025	Template:Time Persons of the Year 2001–2025
ទំព័រគំរូ:OSCE	Template:OSCE
ទំព័រគំរូ:Natural sciences-footer	Template:Natural science
ទំព័រគំរូ:Indo-Iranian languages	Template:Indo-Iranian languages
ទំព័រគំរូ:Help navigation	Template:Help navigation
ទំព័រគំរូ:ឋានន្តរសក្ដិរាជវង្សនិងអភិជន	Template:Royal and noble ranks
ទំព័រគំរូ:BranchesofChemistry	Template:Branches of chemistry
ទំព័រគំរូ:Burmese script	Template:Contains Burmese text
ទំព័រគំរូ:User Alternate Acct	Template:User alternative account
ទំព័រគំរូ:Infobox country Olympics	Template:Infobox country Olympics
ទំព័រគំរូ:ប្រអប់យុទ្ធនាការ សង្គ្រាមវៀតណាម	Template:Campaignbox Vietnam War
ទំព័រគំរូ:Number of portals	Template:Number of portals
ទំព័រគំរូ:ជ័យលាភីរង្វាន់ណូបែល ផ្នែកគីមីវិទ្យា ឆ្នាំ ១៩០១-១៩២៥	Template:Nobel Prize in Chemistry Laureates 1901–1925
ទំព័រគំរូ:Microeconomics	Template:Microeconomics
ទំព័រគំរូ:User vi-2	Template:User vi-2
ទំព័រគំរូ:User vi-1	Template:User vi-1
ចំណាត់ថ្នាក់ក្រុម:Wikipedia documentation pages	Category:Wikipedia documentation pages
ទំព័រគំរូ:User zh-min-nan-4	Template:User nan-4
ទំព័រគំរូ:User zh-min-nan-2	Template:User nan-2
ទំព័រគំរូ:User km-0	Template:User km-0
ទំព័រគំរូ:User id-2	Template:User id-2
ទំព័រគំរូ:UF-hcard-geo	Template:UF-hcard-geo
ទំព័រគំរូ:PDB	Template:PDB
ទំព័រគំរូ:Template shortcut	Template:Template shortcut
ទំព័រគំរូ:OMIM2	Template:OMIM2
ទំព័រគំរូ:Nav book tool	Template:Nav book tool
ទំព័រគំរូ:Likely	Template:Likely
ទំព័រគំរូ:Lang-th	Template:Lang-th
ទំព័រគំរូ:Lang-sq	Template:Lang-sq
ទំព័រគំរូ:Lang-pi	Template:Lang-pi
ទំព័រគំរូ:Lang-pa	Template:Lang-pa
ទំព័រគំរូ:Lang-es	Template:Lang-es
ទំព័រគំរូ:Lang-ca	Template:Lang-ca
ទំព័រគំរូ:Lang-bo	Template:Lang-bo
ទំព័រគំរូ:Lang-az	Template:Lang-az
ទំព័រគំរូ:Km icon	Template:Km icon
ទំព័រគំរូ:In5	Template:In5
ទំព័រគំរូ:ISO 639 name eo	Template:ISO 639 name eo
ទំព័រគំរូ:ISO 3166	Template:ISO 3166
ទំព័រគំរូ:Getalias	Template:Getalias
ទំព័រគំរូ:DiseasesDB2	Template:DiseasesDB2
ទំព័រគំរូ:Country flag IOC alias CAM	Template:Country flag IOC alias CAM
ទំព័រគំរូ:Mammal-stub	Template:Mammal-stub
ចំណាត់ថ្នាក់ក្រុម:នាមត្រូលជនជាតិជប៉ុន	Category:Japanese-language surnames
ចំណាត់ថ្នាក់ក្រុម:ក្រុមហ៊ុនអាកាសចរណ៍	Category:Airliners
ចំណាត់ថ្នាក់ក្រុម:ពិជគណិត	Category:Algebra
ចំណាត់ថ្នាក់ក្រុម:មុំ	Category:Angle
ចំណាត់ថ្នាក់ក្រុម:នព្វន្ធ	Category:Arithmetic
ទំព័រគំរូ:Template notes	Template:Template notes
Module:Citation	Module:Citation
ចំណាត់ថ្នាក់ក្រុម:ស្ពាននៅអាស៊ី	Category:Bridges in Asia
ចំណាត់ថ្នាក់ក្រុម:ស្ពាននៅកម្ពុជា	Category:Bridges in Cambodia
ចំណាត់ថ្នាក់ក្រុម:ព្រះពុទ្ធសាសនានៅប្រទេសបារាំង	Category:Buddhism in France
ចំណាត់ថ្នាក់ក្រុម:អត្ថបទខ្លីមិនពេញលេញ អំពីព្រះពុទ្ធសាសនា	Category:Buddhism stubs
ទំព័រគំរូ:Multicol	Template:Multicol
សិទ្ធិកុមារ	Children's rights
ចំណាត់ថ្នាក់ក្រុម:អាស៊ីខាងកើត	Category:East Asia
ទំព័រគំរូ:Chess diagram 6x6	Template:Chess diagram 6x6
ចំណាត់ថ្នាក់ក្រុម:អេឡិចត្រូម៉ាញ៉េទិច	Category:Electromagnetism
ទំព័រគំរូ:Lang-mn	Template:Lang-mn
ទំព័រគំរូ:Lang-sa	Template:Lang-sa
ទំព័រគំរូ:Lang-sv	Template:Lang-sv
វិគីភីឌា:វិគីគម្រោងប្រវត្តិសាស្ត្រ	Wikipedia:WikiProject History
វិគីភីឌា:WikiProject Education	Wikipedia:WikiProject Education
វិគីភីឌា:វិគីគម្រោង សាកលវិទ្យាល័យ	Wikipedia:WikiProject Universities
ចំណាត់ថ្នាក់ក្រុម:រាជរដ្ឋាភិបាលកម្ពុជា	Category:Government of Cambodia
ទំព័រគំរូ:Precision/tz	Template:Precision/tz
ទំព័រគំរូ:Precision/tz/1	Template:Precision/tz/1
ទំព័រគំរូ:Lts	Template:Lts
ចំណាត់ថ្នាក់ក្រុម:សិទ្ធិមនុស្សនៅកម្ពុជា	Category:Human rights in Cambodia
ចំណាត់ថ្នាក់ក្រុម:ខេត្តកំពង់ឆ្នាំង	Category:Kampong Chhnang Province
ទំព័រគំរូ:Coord how-to	Template:Coord how-to
ចំណាត់ថ្នាក់ក្រុម:បណ្ណាល័យ	Category:Libraries
ចំណាត់ថ្នាក់ក្រុម:មេរថក្រោះសមរភូមិ	Category:Main battle tanks
ជំនួយ:Books/Frequently Asked Questions	Help:Books/FAQ
ជំនួយ:Books/Printed books	Help:Books/Printed books
ជំនួយ:Books/for experts	Help:Books/for experts
ជំនួយ:អសង្ស័យកម្ម	Help:Disambiguation
ជំនួយ:មាតិកា/សេចក្តីផ្តើម	Help:Getting started
វិគីភីឌា:IPA for Thai and Lao	Help:IPA for Thai and Lao
វិគីភីឌា:Link color	Help:Link color
ជំនួយ:ជំនួយពហុភាសា (ព្រាហ្ម)	Help:Multilingual support (Indic)
ចំណាត់ថ្នាក់ក្រុម:យន្តហោះយោធាគ្រូបណ្តុះបណ្តាល	Category:Military trainer aircraft
ចំណាត់ថ្នាក់ក្រុម:ទំព័រគំរូ សិទ្ធិ	Category:Rights templates
ទំព័រគំរូ:Tech-stub	Template:Tech-stub
ចំណាត់ថ្នាក់ក្រុម:Navigational boxes without horizontal lists	Category:Navigational boxes without horizontal lists
ទំព័រគំរូ:ទិន្នន័យ​នៃប្រទេសម៉ុងហ្គោល	Template:MNG
ទំព័រគំរូ:Pronunciation	Template:Pronunciation
ទំព័រគំរូ:Non-free newspaper image	Template:Non-free newspaper image
ចំណាត់ថ្នាក់ក្រុម:ចំនួនកុំផ្លិច	Category:Complex numbers
ចំណាត់ថ្នាក់ក្រុម:គ្រោង​វិភាគ	Category:Structural analysis
ចំណាត់ថ្នាក់ក្រុម:Subtemplates of Template Convert	Category:Subtemplates of Template Convert
ចំណាត់ថ្នាក់ក្រុម:User pfl	Category:User pfl
ចំណាត់ថ្នាក់ក្រុម:ទំព័រគំរូTOC	Category:Wikipedia table of contents templates
ទំព័រគំរូ:Image label begin	Template:Image label begin
ចំណាត់ថ្នាក់ក្រុម:រង្វង់និងស៊្វែរ	Category:Circles
ទំព័រគំរូ:Bg icon	Template:Bg icon
វិគីភីឌា:Requests	Wikipedia:Requests
ចំណាត់ថ្នាក់ក្រុម:កងកម្លាំងអាកាស	Category:Air forces
ចំណាត់ថ្នាក់ក្រុម:សាកលវិទ្យាល័យនៅប្រទេសជប៉ុន	Category:Universities and colleges in Japan
ទំព័រគំរូ:Pp-semi-usertalk	Template:Pp-semi-usertalk
ទំព័រគំរូ:Pp-semi-sock	Template:Pp-sock
វិគីភីឌា:សារ ទំព័រគំរូ/បោសសំអាត	Wikipedia:Template messages/Cleanup
ទំព័រគំរូ:Resources for collaboration	Template:Resources for collaboration
វិគីភីឌា:Community portal/Opentask	Wikipedia:Community portal/Opentask
ចំណាត់ថ្នាក់ក្រុម:គ្រឹះស្ថានឧត្តមសិក្សានៅកម្ពុជា	Category:Universities in Cambodia
ទំព័រគំរូ:ប្រតិទិន/Sun1stMonthStartThu	Template:Calendar/Sun1stMonthStartThu
ទំព័រគំរូ:GUAM countries	Template:GUAM Organization for Democracy and Economic Development
វិគីភីឌា:សារ ទំព័រគំរូ/Redirect pages	Wikipedia:Template messages/Redirect pages
ទំព័រគំរូ:BirthsInCentury	Template:Births in century
ចំណាត់ថ្នាក់ក្រុម:វប្បធម៌ខ្មែរ	Category:Cambodian culture
ទំព័រគំរូ:Ombox/core	Template:Ombox/core
ទំព័រគំរូ:US$	Template:US$
ទំព័រគំរូ:IPA-lo	Template:IPA-lo
ទំព័រគំរូ:Geodis	Template:Geodis
ចំណាត់ថ្នាក់ក្រុម:User en-1	Category:User en-1
ចំណាត់ថ្នាក់ក្រុម:Calendar templates	Category:Calendar templates
ចំណាត់ថ្នាក់ក្រុម:User de-1	Category:User de-1
ចំណាត់ថ្នាក់ក្រុម:Wikipedia protected templates	Category:Wikipedia protected templates
ទំព័រគំរូ:Asbox	Template:Asbox
ទំព័រគំរូ:Nowrap begin	Template:Nowrap begin
ទំព័រគំរូ:Marriage	Template:Marriage
ទំព័រគំរូ:Pre	Template:Pre
ទំព័រគំរូ:ខ្មែរក្រហម	Template:Khmer Rouge
ទំព័រគំរូ:ខ្លីមិនពេញលេញ ព្រះពុទ្ធសាសនា	Template:Buddhism-stub
ទំព័រគំរូ:ShadowsCommons	Template:ShadowsCommons
ទំព័រគំរូ:Split section	Template:Split section
ទំព័រគំរូ:Chaturanga diagram	Template:Chaturanga diagram
ទំព័រគំរូ:សេរីភាព	Template:Liberty
ទំព័រគំរូ:ែដលកំពុងរឺកចំេរីន	Template:Under construction
ទំព័រគំរូ:Not English	Template:Not English
ទំព័រគំរូ:Thank you	Template:Thank you
ទំព័រគំរូ:រដ្ឋ និងទឹកដីក្នុងមណ្ឌលឥទ្ធិពលជប៉ុនចក្រពត្តិកំឡុងសង្គ្រាមលោកលើកទី២	Template:States and territories in the sphere of influence of Imperial Japan during World War II
ទំព័រគំរូ:Isdoing	Template:Isdoing
ទំព័រគំរូ:Convert/AU	Template:Convert/AU
ទំព័រគំរូ:Philippine Presidents	Template:Philippine Presidents
ទំព័រគំរូ:សង្គ្រាមត្រជាក់	Template:Cold War
ទំព័រគំរូ:Infobox laboratory	Template:Infobox laboratory
ទំព័រគំរូ:ព្រះត្រៃបិដក	Template:PaliCanon
ទំព័រគំរូ:Pipe	Template:Pipe
ស្រុកកំរៀង	Kamrieng District
វិគីភីឌា:WikiProject Council/Guide	Wikipedia:WikiProject Council/Guide
វិគីភីឌា:WikiProject Council/Directory	Wikipedia:WikiProject Council/Directory
វិគីភីឌា:Tutorial/Keep in mind	Wikipedia:Tutorial/Keep in mind
ទំព័រគំរូ:Very large	Template:Very large
ទំព័រគំរូ:Organisation of Islamic Cooperation	Template:Organisation of Islamic Cooperation
ចំណាត់ថ្នាក់ក្រុម:កោះជ្វា	Category:Java
ទំព័រគំរូ:Frac	Template:Frac
ទំព័រគំរូ:Ntsh	Template:Ntsh
ជំនួយ:របារឧបករណ៍កែប្រែ	Help:Edit toolbar
វិគីភីឌា:គម្រោងវិគីជាបងប្អូន	Wikipedia:Wikimedia sister projects
ទំព័រគំរូ:Evalp	Template:Evalp
សាកលវិទ្យាល័យ​ត្រាវិញ	Tra Vinh University
ទំព័រគំរូ:Start date	Template:Start date
ទំព័រគំរូ:General geometry	Template:General geometry
ទំព័រគំរូ:MediaWiki	Template:MediaWiki
វិគីភីឌា:Contributing to Wikipedia	Wikipedia:Contributing to Wikipedia
ទំព័រគំរូ:Law	Template:Law
ចំណាត់ថ្នាក់ក្រុម:ការធ្វើសេចក្ដីរាយការណ៏ពត៌មាន	Report
ទំព័រគំរូ:International organizations	Template:International organizations
ទំព័រគំរូ:Mbox templates see also	Template:Mbox templates see also
ទំព័រគំរូ:Testcase	Template:Testcase
ទំព័រគំរូ:Infobox settlement/densdisp	Template:Infobox settlement/densdisp
ឃុំតាផូ	Ta Phou
ទំព័រគំរូ:WW2InfoBox	Template:WW2InfoBox
ទំព័រគំរូ:SMS	Template:SMS
ទំព័រគំរូ:Speedy deletion templates	Template:Speedy deletion templates
ទំព័រគំរូ:Religious text primary	Template:Religious text primary
ទំព័រគំរូ:Unknown	Template:Unknown
សង្កាត់អូរម៉ាល់	Ou Mal
ទំព័រគំរូ:Terminated	Template:Terminated
ទំព័រគំរូ:User zh-min-nan-3	Template:User nan-3
ទំព័រគំរូ:Dropped	Template:Dropped
ទំព័រគំរូ:កម្ពុជា	Template:Cambodia topics
ទំព័រគំរូ:Free	Template:Free
ទំព័រគំរូ:Bio-stub	Template:Bio-stub
ទំព័រគំរូ:Iblist name	Template:Iblist name
ទំព័រគំរូ:Db-t3	Template:Db-t3
ទំព័រគំរូ:មេដឹកនាំអាស៊ីអាគ្នេយ៍	Template:Southeast Asian leaders
ទំព័រគំរូ:Mooma artist	Template:Mooma artist
ទំព័រគំរូ:ការបោះឆ្នោតនៅកម្ពុជា	Template:Cambodian elections
វិគីភីឌា:Owl	Template:Owl
ទំព័រគំរូ:TranslatePassage	Template:TranslatePassage
ទំព័រគំរូ:អតីតអាណានិគមបារាំងនៅអាស៊ី និងអូសេអានី	Template:Former French colonies in Asia and Oceania
ទំព័រគំរូ:Misleading	Template:Misleading
ទំព័រគំរូ:សហភាពឥណ្ឌូចិន	Template:French Indochina
ទំព័រគំរូ:Three other uses	Template:Three other uses
ទំព័រគំរូ:Missing information	Template:Missing information
ទំព័រគំរូ:ចលនាឯករាជ្យវៀតណាម	Template:Vietnamese independence movement
ទំព័រគំរូ:Nonfree	Template:Nonfree
ទំព័រគំរូ:FPO number	Template:FPO number
វិគីភីឌា:Ribbons	Wikipedia:Ribbons
ទំព័រគំរូ:Db-g2	Template:Db-g2
ទំព័រគំរូ:Vatican City topics	Template:Vatican City topics
ទំព័រគំរូ:Redirect6	Template:Redirect6
ទំព័រគំរូ:Begin flag row	Template:Begin flag row
ទំព័រគំរូ:Ibdof name	Template:Ibdof name
ទំព័រគំរូ:Isfdb name	Template:Isfdb name
ទំព័រគំរូ:ប្រវត្តិសាស្ត្រភូមា	Template:History of Burma
ទំព័រគំរូ:Lang-my-name-MLCTS	Template:Lang-my-name-MLCTS
ទំព័រគំរូ:Table-experimental	Template:Table-experimental
ទំព័រគំរូ:Ibdof title	Template:Ibdof title
ទំព័រគំរូ:User km-1	Template:User km-1
ទំព័រគំរូ:Psychoanalysis	Template:Psychoanalysis
ទំព័រគំរូ:Herbs & spices	Template:Herbs & spices
ទំព័រគំរូ:Taxobox name	Template:Taxobox name
ទំព័រគំរូ:WSJ topic	Template:WSJ topic
ទំព័រគំរូ:Tim	Template:Tim
ទំព័រគំរូ:User km-3	Template:User km-3
ទំព័រគំរូ:Other category header templates	Template:Other category-header templates
ទំព័រគំរូ:User km-4	Template:User km-4
ទំព័រគំរូ:MINUTE	Template:MINUTE
ទំព័រគំរូ:YEARCC	Template:YEARCC
ទំព័រគំរូ:User km	Template:User km
ទំព័រគំរូ:Andorra topics	Template:Andorra topics
ទំព័រគំរូ:Football kit box	Template:Football kit box
ក្រសួងសេដ្ឋកិច្ច និងហិរញ្ញវត្ថុ	Ministry of Economy and Finance (Cambodia)
ទំព័រគំរូ:Elementbox isotopes decay	Template:Infobox element/isotopes decay
វិគីភីឌា:Scripts	Wikipedia:Scripts
ទំព័រគំរូ:User km-2	Template:User km-2
ទំព័រគំរូ:End flag row	Template:End flag row
ទំព័រគំរូ:End flag gallery	Template:End flag gallery
ទំព័រគំរូ:Ecommerce	Template:E-commerce
ទំព័រគំរូ:ប្រវត្តិសាស្ត្រលាវ	Template:History of Laos
ទំព័រគំរូ:YEARYY	Template:YEARYY
ទំព័រគំរូ:Incorrect	Template:Incorrect
ទំព័រគំរូ:Last edited by	Template:Last edited by
ទំព័រគំរូ:List navbox	Template:List navbox
ទំព័រគំរូ:ប្រវត្តិសាស្ត្រខ្មែរ	Template:History of Cambodia
ទំព័រគំរូ:La Francophonie	Template:La Francophonie
ទំព័រគំរូ:WikiProject Footer	Template:WikiProject Footer
ឃុំអូរប្រាសាទ	Ou Prasat
ទំព័រគំរូ:WSS	Template:WikiProject Stub sorting navbar
ទំព័រគំរូ:Tetl	Template:Tetl
មធ្យមអ៊ីដង់ទ្រិច	Identric mean
វិគីភីឌា:អំពី ប្រអប់ខ្សាច់	Wikipedia:About the Sandbox
វិគីភីឌា:Tutorial/Wrap-up and more info	Wikipedia:Tutorial/Wrap-up and more info
វិគីភីឌា:Project namespace	Wikipedia:Project namespace
ទំព័រគំរូ:User Recently Discovered Userboxes	Template:User Recently Discovered Userboxes
វិគីភីឌា:សារ ទំព័រគំរូ/Disputes	Wikipedia:Template messages/Disputes
ទំព័រគំរូ:ចក្រភពនាយសមុទ្ររបស់បារាំង	Template:French overseas empire
វិគីភីឌា:Service awards	Wikipedia:Service awards
វិគីភីឌា:Kindness Campaign	Wikipedia:Kindness Campaign
ទំព័រគំរូ:ព្រះពុទ្ធសាសនាថេរវាទ	Template:Theravada Buddhism
វិគីភីឌា:ពានរង្វាន់	Wikipedia:Awards
ទំព័រគំរូ:Possible	Template:Possible
ទំព័រគំរូ:Normalwraplink	Template:Normalwraplink
ទំព័រគំរូ:Magnify icon	Template:Magnify icon
ទំព័រគំរូ:Specialpageslist	Template:Specialpageslist
វិគីភីឌា:Hatnotes	Wikipedia:Hatnote
ទំព័រគំរូ:National flags	Template:National flags
ទំព័រគំរូ:Loc	Template:Loc
ទំព័រគំរូ:Pron-en	Template:Pron-en
ទំព័រគំរូ:Overlinked	Template:Overlinked
ទំព័រគំរូ:Gov-stub	Template:Gov-stub
ទំព័រគំរូ:Subject bar	Template:Subject bar
ទំព័រគំរូ:N.b.	Template:N.b.
ទំព័រគំរូ:Big	Template:Larger
ទំព័រគំរូ:Month3	User:HandigeHarry/Month3
វិគីភីឌា:Other awards	Wikipedia:Other awards
ហុក ឡងឌី	Hok Lundy
ទំព័រគំរូ:Infobox file format	Template:Infobox file format
ទំព័រគំរូ:Elect	Template:Elect
ទំព័រគំរូ:អត្ថបទខ្លី អំពីកម្ពុជា	Template:Cambodia-stub
ទំព័រគំរូ:Images	Template:Images
ទំព័រគំរូ:ក្រុមជនជាតិនៅវៀតណាម	Template:Ethnic groups in Vietnam
ទំព័រគំរូ:Db-g3	Template:Db-g3
ទំព័រគំរូ:Db-g12	Template:Db-g12
ទំព័រគំរូ:Economic Cooperation Organization	Template:Economic Cooperation Organization
វិគីភីឌា:WikiProject Military history/Military navigation	Template:Military navigation
ទំព័រគំរូ:No result	Template:No result
ទំព័រគំរូ:UN International Years	Template:UN International Years
ទំព័រគំរូ:Multi-column numbered list	Template:Multi-column numbered list
វិគីភីឌា:Version 1.0 Editorial Team	Wikipedia:Version 1.0 Editorial Team
ទំព័រគំរូ:Country IOC alias ZZX	Template:Country IOC alias ZZX
ទំព័រគំរូ:Declined	Template:Declined
ទំព័រគំរូ:Focusletter	Template:Focusletter
ទំព័រគំរូ:Public services	Template:Public services
ទំព័រគំរូ:Permanently protected	Template:Permanently protected
ទំព័រគំរូ:Happy Birthday 7	Template:Happy Birthday 7
ទំព័រគំរូ:Mobile County, Alabama	Template:Mobile County, Alabama
ទំព័រគំរូ:IPA-th	Template:IPA-th
ឃុំកំរៀង	Kamrieng (commune)
វិគីភីឌា:Birthday Committee	Wikipedia:Birthday Committee
ទំព័រគំរូ:EC number	Template:EC number
សង្កាត់ស្វាយប៉ោ	Svay Pao
ទំព័រគំរូ:R from incomplete name	Template:R from short name
វិគីភីឌា:WikiProject Buddhism	Wikipedia:WikiProject Buddhism
ទំព័រគំរូ:Articles of the Universal Declaration of Human Rights	Template:Articles of the Universal Declaration of Human Rights
ទំព័រគំរូ:Raumschach diagram	Template:Raumschach diagram
ទំព័រគំរូ:Portal nav footer	Template:Portal nav footer
ទំព័រគំរូ:Unrelated	Template:Unrelated
ទំព័រគំរូ:វប្បធ៌មបុរេប្រវត្តិវៀតណាម	Template:Prehistoric and ancient cultures of Vietnam
ទំព័រគំរូ:Thank	Template:Thank
ឃុំទ្រាស	Treas
ឃុំថ្មពួក	Thma Puok (commune)
ទំព័រគំរូ:នយោបាយកម្ពុជា	Template:Politics of Cambodia
ទំព័រគំរូ:ប្រធានបទរាជវង្សចូវ	Template:Zhou dynasty topics
ទំព័រគំរូ:User id-1	Template:User id-1
ទំព័រគំរូ:Location map Malaysia peninsula	Template:Location map Malaysia peninsula
ទំព័រគំរូ:វីគីភីឌា-សៀវភៅ	Template:Wikipedia books
ទំព័រគំរូ:Wikipedia 1.0 Navigation	Template:Wikipedia 1.0 Navigation
ទំព័រគំរូ:Denied	Template:Denied
ទំព័រគំរូ:Infobox Buddhist term	Template:Infobox Buddhist term
វិគីភីឌា:Stub Makers	Wikipedia:Stub Makers
ការប្រាស្រ័យទាក់ទងអន្តរបុគ្គល	Interpersonal communication
ទំព័រគំរូ:Scientists whose names are used as non SI units	Template:Scientists whose names are used as non SI units
ទំព័រគំរូ:S-inc	Template:S-inc
ទំព័រគំរូ:Nuttall	Template:Nuttall
ទំព័រគំរូ:Campaignbox World War II	Template:Campaignbox World War II
ទំព័រគំរូ:Finance-stub	Template:Finance-stub
ឃុំវត្តតាមិម	Voat Ta Muem
ទំព័រគំរូ:Polynomials	Template:Polynomials
វិគីភីឌា:Barnstars 2.0/Barnstar of National Merit	Wikipedia:Barnstars 2.0/Barnstar of National Merit
ទំព័រគំរូ:TopicTOC-World War II	Template:TopicTOC-World War II
ទំព័រគំរូ:TVQ	Template:TVQ
ឃុំព្រែកហ្លួង	Preaek Luong
ទំព័រគំរូ:Subpages	Template:Subpages
ទំព័រគំរូ:ប្រធានបទវៀតណាម	Template:Vietnam topics
ទំព័រគំរូ:Infobox institute	Template:Infobox institute
ទំព័រគំរូ:IPAlink	Template:IPA link
ទំព័រគំរូ:UN document	Template:UN document
ក្រសួងអប់រំ យុវជន និងកីឡា	Ministry of Education, Youth and Sport (Cambodia)
ទំព័រគំរូ:Outline footer	Template:Outline footer
ទំព័រគំរូ:អ្នកប្រើប្រាស់វ.គ.ប្រ.	Template:User WPH
ទូរទស្សន៍បាយ័ន	Bayon Television
វិគីភីឌា:WikiProject Council	Wikipedia:WikiProject Council
ទំព័រគំរូ:ForLoop/aux	Template:ForLoop/aux
ទំព័រគំរូ:Climate chart/celsius column	Template:Climate chart/celsius column
ទំព័រគំរូ:Unresolved	Template:Unresolved
ទំព័រគំរូ:Payoff matrix	Template:Payoff matrix
ទំព័រគំរូ:PhylomapB	Template:PhylomapB
ទំព័រគំរូ:ស្រុកនៃកម្ពុជា	Template:Districts of Cambodia
ទំព័រគំរូ:S-hou	Template:S-hou
វិគីភីឌា:As of	Wikipedia:As of
ទំព័រគំរូ:Marvelwiki	Template:Marvelwiki
ទំព័រគំរូ:Journalism	Template:Journalism sidebar
ទំព័រគំរូ:The Sun	Template:The Sun
ទំព័រគំរូ:Mammals	Template:Mammals
វិគីភីឌា:Infobox colours	Wikipedia:Infobox colours
ទំព័រគំរូ:Importance	Template:Importance
វិគីភីឌា:Help namespace	Wikipedia:Help namespace
ទំព័រគំរូ:Unnecessary	Template:Unnecessary
ទំព័រគំរូ:Dynamic list	Template:Dynamic list
ទំព័រគំរូ:Working	Template:Working
វិគីភីឌា:Manual of Style (ប្រអប់ព័ត៌មាន)	Wikipedia:Manual of Style/Infoboxes
ទំព័រគំរូ:អតីតអាណានិគមបារាំងនៅអាមេរិក	Template:Former French colonies in the Americas
ទំព័រគំរូ:Lead missing	Template:Lead missing
ទំព័រគំរូ:Politics sidebar	Template:Politics sidebar
ទំព័រគំរូ:Infobox Chinese	Template:Infobox Chinese
ផែនការក៥	K5 Plan
ទំព័រគំរូ:Infobox Monarchy	Template:Infobox monarchy
ទំព័រគំរូ:Location map many	Template:Location map many
ទំព័រគំរូ:Worldcat id	Template:Worldcat id
វិគីភីឌា:Tutorial/TabsHeader	Wikipedia:Tutorial/TabsHeader
ទំព័រគំរូ:Map caption	Template:Map caption
ទំព័រគំរូ:Tltts	Template:Tltts
ទំព័រគំរូ:Weekday in month	Template:Weekday in month
វិគីភីឌា:សារ ទំព័រគំរូ/ប្រភពនៃអត្ថបទ	Wikipedia:Template messages/Sources of articles
ទំព័រគំរូ:Further2	Template:Further2
ទំព័រគំរូ:Efn	Template:Efn
ទំព័រគំរូ:Reflist-talk	Template:Reflist-talk
ទំព័រគំរូ:FullURL Diff	Template:FullURL Diff
វិទ្យាស្ថានបច្ចេកវិទ្យាកម្ពុជា	Institute of Technology of Cambodia
ទំព័រគំរូ:S-ppo	Template:S-ppo
ទំព័រគំរូ:Time	Template:Time
ចំណាត់ថ្នាក់ក្រុម:យន្តហោះប្រដេញ	Category:Fighter aircraft
ទំព័រគំរូ:Element color/Actinoids	Template:Element color/Actinoids
ទំព័រគំរូ:Element color/Alkaline earth metals	Template:Element color/Alkaline earth metals
ទំព័រគំរូ:Use mdy dates	Template:Use mdy dates
ទំព័រគំរូ:Ombox/shortcut	Template:Ombox/shortcut
ទំព័រគំរូ:Table cell templates	Template:Table cell templates
ទំព័រគំរូ:Tlxs	Template:Tlxs
ទំព័រគំរូ:Sec link/text	Template:Sec link/text
ទំព័រគំរូ:Weather box/colh	Template:Weather box/colh
ទំព័រគំរូ:Weather box/colpastel	Template:Weather box/colpastel
ទំព័រគំរូ:Convert/to(-)	Template:Convert/to(-)
ទំព័រគំរូ:Convert/list of units/rowtop	Template:Convert/list of units/rowtop
ទំព័រគំរូ:Convert/list of units/area/short list	Template:Convert/list of units/area/short list
ទំព័រគំរូ:Str len/core	Template:Str len/core
ទំព័រគំរូ:Respell	Template:Respell
ទំព័រគំរូ:Rnd/-	Template:Rnd/-
ទំព័រគំរូ:Native name	Template:Native name
ទំព័រគំរូ:Noitalic	Template:Noitalic
ទំព័រគំរូ:Organization infoboxes	Template:Organization infoboxes
គោលនយោបាយវិនិយោគ	Investment policy
ទំព័រគំរូ:Infobox coord	Template:Infobox coord
ទំព័រគំរូ:Harvard citation/core	Template:Harvard citation/core
ទំព័រគំរូ:Lists of flags	Template:Lists of flags
ទំព័រគំរូ:Quotation templates see also	Template:Quotation templates
ទំព័រគំរូ:\	Template:\
ទំព័រគំរូ:Google+	Template:Google+
ទំព័រគំរូ:BirthDeathAge	Template:BirthDeathAge
ទំព័រគំរូ:Divbox/style/green	Template:Divbox/style/green
ទំព័រគំរូ:Divbox/style/none	Template:Divbox/style/none
ទំព័រគំរូ:Indian Rupee	Template:Indian Rupee
ទំព័រគំរូ:Infobox cooperative	Template:Infobox cooperative
ទំព័រគំរូ:IPA-ca	Template:IPA-ca
ទំព័រគំរូ:IPAslink	Template:IPAslink
ទំព័រគំរូ:Issubst	Template:Issubst
ទំព័រគំរូ:MSW3 Groves	Template:MSW3 Groves
ទំព័រគំរូ:Office-table	Template:Office-table
ទំព័រគំរូ:Discreet abbreviation	Template:Discreet abbreviation
ទំព័រគំរូ:Shipboxflag	Template:Shipboxflag
ទំព័រគំរូ:Incumbent pope	Template:Incumbent pope
ទំព័រគំរូ:Wikiquote-inline	Template:Wikiquote-inline
ទំព័រគំរូ:Taxonomy/Angiosperms	Template:Taxonomy/Angiosperms
ទំព័រគំរូ:Taxonomy/Bikonta	Template:Taxonomy/Bikonta
ទំព័រគំរូ:Taxonomy/Chordata	Template:Taxonomy/Chordata
ទំព័រគំរូ:Taxonomy/Craniata	Template:Taxonomy/Craniata
ទំព័រគំរូ:Taxonomy/Deuterostomia	Template:Taxonomy/Deuterostomia
ទំព័រគំរូ:Taxonomy/Eumetazoa	Template:Taxonomy/Eumetazoa
ទំព័រគំរូ:Taxonomy/Filozoa	Template:Taxonomy/Filozoa
ទំព័រគំរូ:Taxonomy/Gnathostomata	Template:Taxonomy/Gnathostomata
ទំព័រគំរូ:Taxonomy/Holozoa	Template:Taxonomy/Holozoa
ទំព័រគំរូ:Taxonomy/Incertae sedis	Template:Taxonomy/Incertae sedis
ទំព័រគំរូ:Taxonomy/Mammalia	Template:Taxonomy/Mammalia
ទំព័រគំរូ:Taxonomy/Mammaliaformes	Template:Taxonomy/Mammaliaformes
ទំព័រគំរូ:Taxonomy/Nephrozoa	Template:Taxonomy/Nephrozoa
ទំព័រគំរូ:Taxonomy/Opisthokonta	Template:Taxonomy/Opisthokonta
ទំព័រគំរូ:Taxonomy/Pinophyta	Template:Taxonomy/Pinophyta
ទំព័រគំរូ:Taxonomy/Plantae	Template:Taxonomy/Plantae
ទំព័រគំរូ:Taxonomy/Unikonta	Template:Taxonomy/Unikonta
ទំព័រគំរូ:Multi-listen item	Template:Multi-listen item
ទំព័រគំរូ:Element color/Alkali metals	Template:Element color/Alkali metals
ទំព័រគំរូ:Element color/Lanthanoids	Template:Element color/Lanthanoids
ទំព័រគំរូ:Element color/Other nonmetals	Template:Element color/Nonmetals
ទំព័រគំរូ:Infobox settlement/areadisp	Template:Infobox settlement/areadisp
ទំព័រគំរូ:Infobox settlement/checkauto	Template:Infobox settlement/checkauto
ទំព័រគំរូ:Infobox settlement/link	Template:Infobox settlement/link
ទំព័រគំរូ:Weather box/oneline/date	Template:Weather box/oneline/date
ទំព័រគំរូ:Hidden sort key	Template:Hidden sort key
ទំព័រគំរូ:You're welcome	Template:You're welcome
ទំព័រគំរូ:អតីតអាណានិគមបារាំងនៅអាហ្វ្រិក និងមហាសមុទ្រឥណ្ឌា	Template:Former French colonies in Africa and the Indian Ocean
ទំព័រគំរូ:Twinkle standard installation	Template:Twinkle standard installation
ទំព័រគំរូ:តំណភ្ជាប់ខាងក្រៅ	Template:External links
ទំព័រគំរូ:Testcases side by side	Template:Testcases side by side
រូបភាពដែលបាត់បង់	The Missing Picture (film)
ទំព័រគំរូ:Infobox high court	Template:Infobox high court
ទំព័រគំរូ:សិទ្ធិ	Template:Rights
ទំព័រគំរូ:Taxonomy/Avialae/skip	Template:Child taxa/Avialae/skip
ទំព័រគំរូ:ប្រអប់ព័ត៌មាន វត្តអារាមព្រះពុទ្ធសាសនា	Template:Infobox Buddhist temple
ទំព័រគំរូ:Warchivenav	Template:Warchivenav
ទំព័រគំរូ:Numrec/Kosovo	Template:Numrec/Kosovo
ទំព័រគំរូ:Collapsible lists option	Template:Collapsible lists option
ទំព័រគំរូ:Age in years and days textual version	Template:Age in years and days (textual)
ទំព័រគំរូ:Spoken Wikipedia-2	Template:Spoken Wikipedia-2
ទំព័រគំរូ:IUCN2011.2	Template:IUCN2011.2
ទំព័រគំរូ:Editnotice pagename	Template:Editnotice pagename
ទំព័រគំរូ:Cite comic	Template:Cite comic
ទំព័រគំរូ:Earth's landforms	Template:Earth's landforms
ទំព័រគំរូ:ISO 639-3 navigation	Template:ISO 639-3 navigation
ទំព័រគំរូ:Infobox National Olympic Committee	Template:Infobox National Olympic Committee
ទំព័រគំរូ:NYTtopic	Template:NYTtopic
ទំព័រគំរូ:Tla	Template:Tla
ទំព័រគំរូ:Howto	Template:Howto
ទំព័រគំរូ:Infobox អាកាសធាតុ/line	Template:Weather box/line
ទំព័រគំរូ:Weather box/colp	Template:Weather box/colp
ទំព័រគំរូ:Weather box/colt	Template:Weather box/colt
វិគីភីឌា:Userboxes/WikiProjects	Wikipedia:Userboxes/WikiProjects
ទំព័រគំរូ:Refimprove section	Template:Refimprove section
ទំព័រគំរូ:RFPP	Template:RFPP
ទំព័រគំរូ:Cleanup-reorganize	Template:Cleanup-reorganize
ទំព័រគំរូ:សិទ្ធិមនុស្ស	Template:Human rights
ជំនួយ:ការប្តូរទីតាំងទំព័រ	Help:Redirect
ទំព័រគំរូ:Markup	Template:Markup
ទំព័រគំរូ:ប្រអប់ព័ត៌មាន ភាសា/genetic2	Template:Infobox language/genetic
ទំព័រគំរូ:Start date and years ago	Template:Start date and years ago
ទំព័រគំរូ:Convert/Dual/LoffAnoneDbSoff	Template:Convert/Dual/LoffAnoneDbSoff
ទំព័រគំរូ:Convert/list of units/extra	Template:Convert/list of units/extra
ទំព័រគំរូ:Convert/list of units/length	Template:Convert/list of units/length
ទំព័រគំរូ:Convert/list of units/length/impus	Template:Convert/list of units/length/impus
ទំព័រគំរូ:Convert/list of units/length/maritime	Template:Convert/list of units/length/maritime
ទំព័រគំរូ:Convert/list of units/length/other	Template:Convert/list of units/length/other
ទំព័រគំរូ:Convert/list of units/length/short list	Template:Convert/list of units/length/short list
ទំព័រគំរូ:Convert/list of units/rowuninotetopwaltab	Template:Convert/list of units/rowuninotetopwaltab
ទំព័រគំរូ:Convert/list of units/speed/short list	Template:Convert/list of units/speed/short list
ទំព័រគំរូ:Convert/list of units/temperature/short list	Template:Convert/list of units/temperature/short list
ទំព័រគំរូ:Convert/list of units/triple	Template:Convert/list of units/triple
ទំព័រគំរូ:Convert/list of units/volume/short list	Template:Convert/list of units/volume/short list
ទំព័រគំរូ:Convert/U.S.galatm	Template:Convert/U.S.galatm
ទំព័រគំរូ:Class/colour	Template:Class/colour
ទំព័រគំរូ:Pp-office	Template:Pp-office
ទំព័រគំរូ:MoreInfo	Template:MoreInfo
ទំព័រគំរូ:Inprogress	Template:Inprogress
ទំព័រគំរូ:WEEKDAY	Template:WEEKDAY
ទំព័រគំរូ:Style/IPA	Template:Style/IPA
ទំព័រគំរូ:Style/yid	Template:Style/yid
ទំព័រគំរូ:KMT/logo	Template:KMT/logo
គណៈកម្មាធិការជាតិរៀបចំការបោះឆ្នោត	National Election Committee of Cambodia
ខឹម វាសនា	Khem Veasna
ទំព័រគំរូ:Page tabs	Template:Page tabs
ទំព័រគំរូ:IPA-ko	Template:IPA-ko
Module:Convert	Module:Convert
ទំព័រគំរូ:Green Party of England and Wales/meta/shortname	Template:Green Party of England and Wales/meta/shortname
ទំព័រគំរូ:Infobox comics location	Template:Infobox comics location
ទំព័រគំរូ:UK Independence Party/meta/shortname	Template:UK Independence Party/meta/shortname
ទំព័រគំរូ:Project header	Template:WikiProject status/Active
ទំព័រគំរូ:Dts/core	Template:Dts/outmdy2
ទំព័រគំរូ:Weather box/cols	Template:Weather box/cols
វិគីភីឌា:សារ ទំព័រគំរូ/General	Wikipedia:Template messages/General
វិគីភីឌា:សារ ទំព័រគំរូ/តំណភ្ជាប់	Wikipedia:Template messages/Links
វិគីភីឌា:សារ ទំព័រគំរូ/Deletion	Wikipedia:Template messages/Deletion
ទំព័រគំរូ:Unichar	Template:Unichar
ទំព័រគំរូ:Ambox/core	Template:Ambox/core
ទំព័រគំរូ:Fishing	Template:Fishing
ទំព័រគំរូ:HOUR	Template:HOUR
ទំព័រគំរូ:Policy shortcut	Template:Policy shortcut
ទំព័រគំរូ:Sec link/relative url	Template:Sec link/relative url
ទំព័រគំរូ:Tmbox/core	Template:Tmbox/core
ទំព័រគំរូ:Unlikely	Template:Unlikely
ទំព័រគំរូ:Panasonic	Template:Panasonic
ទំព័រគំរូ:គោលនយោបាយសាធារណៈ	Template:Public policy
ទំព័រគំរូ:Distinguish2	Template:Distinguish2
ទំព័រគំរូ:Subatomic particle/list	Template:Subatomic particle/list
ទំព័រគំរូ:Inconclusive	Template:Inconclusive
ទំព័រគំរូ:Tltt	Template:Tltt
ទំព័រគំរូ:Types of government minister	Template:Types of government ministers
ទំព័រគំរូ:Element color/Unknown (white)	Template:Element color/Unknown (white)
ទំព័រគំរូ:Off-topic	Template:Off-topic
ទំព័រគំរូ:Scinote/e	Template:Scinote/e
ទំព័រគំរូ:Tltt/tip	Template:Tltt/tip
ទំព័រគំរូ:User oops	Template:User oops
ទំព័រគំរូ:Userpage bar	Template:Userpage bar
ទំព័រគំរូ:Asbox/stubtree/2	Template:Asbox/stubtree/2
ទំព័រគំរូ:WPSS-cat	Template:WPSS-cat
ទំព័រគំរូ:Temporarily protected	Template:Temporarily protected
ទំព័រគំរូ:Evaldemo/3	Template:Evaldemo/3
ទំព័រគំរូ:ខេត្តបាត់ដំបង	Template:Battambang Province
ទំព័រគំរូ:Divhide	Template:Divhide
ទំព័រគំរូ:Football kit/pattern list	Template:Football kit/pattern list
ទំព័រគំរូ:Calendar/Sun1stMonthStartសៅរ៍	Template:Calendar/Sun1stMonthStartSat
ទំព័រគំរូ:Calendar/Sun1stMonthStartMon	Template:Calendar/Sun1stMonthStartMon
ទំព័រគំរូ:ក្រុមជនជាតិនៅកម្ពុជា	Template:Ethnic groups in Cambodia
ទំព័រគំរូ:Divbox/style/blue	Template:Divbox/style/blue
ទំព័រគំរូ:Divbox/style/plain	Template:Divbox/style/plain
ទំព័រគំរូ:Divbox/style/yellow	Template:Divbox/style/yellow
ទំព័រគំរូ:Infobox instrument/Classification	Template:Infobox instrument/Classification
ទំព័រគំរូ:ខេត្តកណ្តាល	Template:Kandal Province
ទំព័រគំរូ:Language icon/Notes	Template:Link language/Notes
ទំព័រគំរូ:Inuse-section	Template:Inuse-section
ទំព័រគំរូ:ខេត្តកំពង់ស្ពឺ	Template:Kampong Speu Province
វិគីភីឌា:Userboxes/Userboxes	Wikipedia:Userboxes/Userboxes
ទំព័រគំរូ:សេដ្ឋកិច្ច	Template:Economics
Portal:Current events/Sidebar	Portal:Current events/Sidebar
ទំព័រគំរូ:អត្តសញ្ញាណនៃកម្ពុជា	Template:Symbols of Cambodia
ទំព័រគំរូ:ទិន្នន័យប្រទេស អូម៉ង់	Template:Country data Oman
ទំព័រគំរូ:ទិន្នន័យប្រទេស កាមេរូន	Template:Country data Cameroon
វិគីភីឌា:Tutorial/Tabs	Wikipedia:Tutorial/Tabs
វិគីភីឌា:Tutorial/Tab1	Wikipedia:Tutorial/Tab1
វិគីភីឌា:Tutorial/Tab2	Wikipedia:Tutorial/Tab2
វិគីភីឌា:Tutorial/TabsBottom	Wikipedia:Tutorial/TabsBottom
វិគីភីឌា:Tutorial/TabsTop	Wikipedia:Tutorial/TabsTop
វិគីភីឌា:Tutorial/TabsTopWithEdit	Wikipedia:Tutorial/TabsTopWithEdit
វិគីភីឌា:Tutorial/Registration/Header	Wikipedia:Tutorial/Registration/Header
វិគីភីឌា:Tutorial/Talk pages/Header	Wikipedia:Tutorial/Talk pages/Header
វិគីភីឌា:Tutorial/Formatting/Header	Wikipedia:Tutorial/Formatting/Header
វិគីភីឌា:Tutorial/Editing/Header	Wikipedia:Tutorial/Editing/Header
វិគីភីឌា:Tutorial/Wrap-up and more info/Header	Wikipedia:Tutorial/Wrap-up and more info/Header
វិគីភីឌា:Tutorial/Citing sources/Header	Wikipedia:Tutorial/Citing sources/Header
វិគីភីឌា:Tutorial/Wikipedia links/Header	Wikipedia:Tutorial/Wikipedia links/Header
វិគីភីឌា:Tutorial/Keep in mind/Header	Wikipedia:Tutorial/Keep in mind/Header
អាកាសចរណ៍ឡាវ ជើងហោះហើរ លេខ៣០១	Lao Airlines Flight 301
សន្ធិសញ្ញាសន្តិភាពទីក្រុងប៉ារីស ឆ្នាំ១៩៩១	1991 Paris Peace Accords
ព្យុះហៃយ៉ាន	Typhoon Haiyan
ពិសេស:បំលាស់ប្ដូរថ្មីៗ	Special:RecentChanges
កម្ពុជា នៅស៊ីហ្គេម ២០១៣	Cambodia at the 2013 Southeast Asian Games
Module:Citation/CS1	Module:Citation/CS1
ផាន់ ប៉េង	Peng Phan
មន្ទារ	Magnolia liliifera
គល់ បញ្ញា	Koul Panha
ខេត្តត្បូងឃ្មុំ	Tbong Khmum Province
Module:HtmlBuilder	Module:HtmlBuilder
Module:Coordinates	Module:Coordinates
Module:Navbox	Module:Navbox
វិគីភីឌា:Barnstars 2.0/Awards by WikiProject	Wikipedia:Barnstars 2.0/Awards by WikiProject
វិគីភីឌា:សារ ទំព័រគំរូ/លំហឈ្មោះ អ្នកប្រើប្រាស់	Wikipedia:Template messages/User namespace
ទ្រឹស្តីបទការ៉េបី	Legendre's three-square theorem
ទំព័រគំរូ:Calendar/Sun1stMonthStartអង្គារ	Template:Calendar/Sun1stMonthStartTue
សាកលវិទ្យាល័យហ្សាម៉ាន់	Zaman University
សាកលវិទ្យាល័យបញ្ញាសាស្ត្រកម្ពុជា	Paññāsāstra University of Cambodia
ទំព័រគំរូ:Taxonomy/Tetrapoda	Template:Taxonomy/Tetrapoda
ទំព័រគំរូ:Taxonomy/Teleostomi	Template:Taxonomy/Teleostomi
ស ខេង	Sar Kheng
ឃួន សុដារី	Khuon Sodary
វិគីភីឌា:សារ ទំព័រគំរូ/លំហឈ្មោះ ឯកសារ	Wikipedia:Template messages/File namespace
Call of Duty: Advanced Warfare	Call of Duty: Advanced Warfare
ព្រះនាងសោមា	Queen Soma
អូន ព័ន្ធមុនីរ័ត្ន	Aun Porn Moniroth
ខៀវ ជុំ	Khieu Chum
បញ្ជីនៃទង់ជាតិអង្គភាពរដ្ឋបាលរាជវង្សង្វៀនរបស់	Flags of the Nguyen dynasty's administrative units
ស៊ន សៀវម៉ី	Sorn Seavmey
សឺន គុយ	Chavay Kuy
ស្ពានអ្នកលឿង	Neak Loeung Bridge
ទំព័រគំរូ:ឫសីនៃទេវកថាហិណ្ឌូ	Template:Rishis of Hindu mythology
