ئافرىقا	Africa
ياپونىيە	Japan
جەنۇبىي ئامېرىكا	South America
نورۋېگىيە	Norway
Shotlandiye	Scotland
Wélsh	Wales
ۋېنگرىيە	Hungary
ئىسپانىيە	Spain
ئامېرىكا قوشما شىتاتلىرى	United States
بېلگىيە	Belgium
ليۇكسېمبۇرگ	Luxembourg
يەر شارى	Earth
گېئورگى ۋاشىنگتون	George Washington
فىنلاندىيە	Finland
شۋېتسىيە	Sweden
دانىيە	Denmark
لەھىستان	Poland
لىتۋا	Lithuania
ئىتالىيە	Italy
شۋېتسارىيە	Switzerland
ئاۋستىرىيە	Austria
گرېتسىيە	Greece
تۈركىيە جۇمھۇرىيىتى	Turkey
پورتۇگالىيە	Portugal
ياۋروپا	Europe
ئاسىيا	Asia
شىمالىي ئامېرىكا	North America
ۋىكىپېدىيە	Wikipedia
گوللاندىيە	Netherlands
Nyu York Shehiri	New York City
ۋاشىنگتون	Washington, D.C.
San Fransisko	San Francisco
Bérlin	Berlin
Los Anjélés	Los Angeles
كومپيۇتېر	Computer
بېرن	Bern
Jenwe	Geneva
سيۇرىخ	Zürich
خەلقارالىق تور	Internet
باراك ئوباما	Barack Obama
ئۇرۇگۋاي	Uruguay
London	London
كايرو	Cairo
ئالما	Apple
پارىژ	Paris
مېكسىكا	Mexico
Kaliforniye Shitati	California
Boston	Boston
مارس	Mars
كېنىيە	Kenya
ئېفىئوپىيە	Ethiopia
گانا جۇمھۇرىيىتى	Ghana
شىر	Lion
فرانسىيە	France
ئېسپېرانتو	Esperanto
ئىت	Dog
بۈيۈك بېرىتانىيە	United Kingdom
مۈشۈك	Cat
جۇڭخۇا خەلق جۇمھۇرىيىتى	China
فرانسۇز تىلى	French language
برازىلىيە	Brazil
روسىيە	Russia
قارا دېڭىز	Black Sea
مانگو	Mango
Toronto	Toronto
Alabama Shitati	Alabama
San Pawlo	São Paulo
Kwébék	Quebec
ۋىكىپېدىيە ۋەخپى	Wikimedia Foundation
جىمى ۋالىس	Jimmy Wales
گېرمانىيە	Germany
بېلورۇسسىيە	Belarus
نېمىس تىلى	German language
ئىسلاندىيە	Iceland
ئېستونىيە	Estonia
ساتۇرن	Saturn
ئايروپىلان	Airplane
جورج ۋولكېر بۇش	George W. Bush
لاتۋىيە	Latvia
ئۇكرائىنا	Ukraine
چېخ جۇمھۇرىيەتى	Czech Republic
سلوۋاكىيە	Slovakia
سلوۋېنىيە	Slovenia
مولدوۋا	Moldova
رۇمىنىيە	Romania
بۇلغارىيە	Bulgaria
Rim	Rome
ماكېدونىيە	Republic of Macedonia
ئالبانىيە	Albania
گرېنلاندىيە	Greenland
كرودىيە	Croatia
بوسنىيە ۋە ھېرسېگوۋىنا	Bosnia and Herzegovina
ئەزەربەيجان	Azerbaijan
ئاندوررا	Andorra
سىپرۇس	Cyprus
گرۇزىيە	Georgia (country)
قازاقىستان	Kazakhstan
مالتا	Malta
موناكو	Monaco
چېرنوگورىيە	Montenegro
ۋاتىكان شەھىرى	Vatican City
سان مارىنو	San Marino
Bryussél	Brussels
كۇبا	Cuba
بېلىز	Belize
باربادوس	Barbados
ئاممىباپ ئاپتوموبىل	Volkswagen
ھىندونېزىيە	Indonesia
Wolfgang Amadeus Mozart	Wolfgang Amadeus Mozart
بىتخوۋىن	Ludwig van Beethoven
تۈرك تىلى	Turkish language
جەنۇبىي ئافرىقا	South Africa
ئالجىرىيە	Algeria
ئۆزبېكىستان	Uzbekistan
Poznan	Poznań
Tashkent	Tashkent
Warshawa	Warsaw
ياۋروۋىزىيون ناخشا مۇسابىقىسى	Eurovision Song Contest
تېلېۋىزور	Television
ئىسلاندىيە تىلى	Icelandic language
چىلى	Chile
ئەيسا مەسىھ	Jesus
گالىلېي	Galileo Galilei
مېركۇرىي	Mercury (planet)
تارىخ	History
ئالما شىركىتى	Apple Inc.
ۋېنېرا	Venus
مۇھاببەت	Love
يۇپىتېر	Jupiter
سامان يولى سىستىمېسى	Milky Way
ئۇران (پلانىت)	Uranus
نىكولا ساركوزى	Nicolas Sarkozy
نېپتۇن	Neptune
ئاسترونومىيە	Astronomy
سىنگاپور	Singapore
پلۇتون	Pluto
Montréal	Montreal
لىختېنشتېين	Liechtenstein
Kambrij	Cambridge
Facebook	Facebook
بىرىنچى دۇنيا ئۇرۇشى	World War I
Kolon	Cologne
سكوپليې	Skopje
Shchétsin	Szczecin
لاتىن تىلى	Latin
بەھرېيىن	Bahrain
ئەرمېنىيە	Armenia
سېربىيە	Serbia
Istanbul	Istanbul
ئاۋستىرالىيە	Australia
فىزىكا	Physics
ئارگېنتىنا	Argentina
پېرۇ	Peru
بىئولوگىيە	Biology
شىمالىي چاۋشيەن	North Korea
كامبوجا	Cambodia
قۇرئان كەرىم	Quran
دىنوزاۋر	Dinosaur
ئىسلام دىنى	Islam
ليۇبليانا	Ljubljana
Lion	Lyon
ياۋروپا ئىتتىپاقى	European Union
سوفىيە	Sofia
شېئىر	Poetry
Milan	Milan
Turin	Turin
سوڭ	Anus
ئېۋېرېست	Mount Everest
ﻧﺎﭘﻮﻟﯧﺌﻮﻥ ﺑﻮﻧﺎﭘﺎﺭﺕ	Napoleon
ۋېزۇۋىي	Mount Vesuvius
قۇياش	Sun
قۇياش سىستېمىسى	Solar System
ھىدروگېن	Hydrogen
گېلىي	Helium
چىش	Human tooth
لىتىي	Lithium
بېرىللىي	Beryllium
شەرقىي تىمور	East Timor
ئوسلو	Oslo
Bonn	Bonn
سېرېرا	Ceres (dwarf planet)
لىسبون	Lisbon
ئېرىدا	Eris (dwarf planet)
دۇبائى	Dubai
بور	Boron
Wérsayl	Versailles (France city)
كاربون	Carbon
ۋولگا دەرياسى	Volga River
ئازوت	Nitrogen
ئوكسىگېن	Oxygen
مۇزىكا	Music
Wénitsiye	Venice
Rénn Shehiri	Rennes
Lil	Lille
Moskwa	Moscow
فىتور	Fluorine
ئىتاليان تىلى	Italian language
نىئون گازى	Neon
Sankt-Pétérburg	Saint Petersburg
چاد	Chad
ناترىي	Sodium
ماگنىي	Magnesium
ئاليۇمىن	Aluminium
يېڭى زېلاندىيە	New Zealand
ھىندىستان	India
سىلىتسىي	Silicon
فرانسىي	Francium
Tuwalu	Tuvalu
فوسفور	Phosphorus
تۆمۈر	Iron
Ton’ga	Tonga
گۈڭگۈرت	Sulfur
ساموئا	Samoa
سولومون تاقىم ئاراللىرى	Solomon Islands
ۋانۇئاتۇ	Vanuatu
خلور گازى	Chlorine
پاپۇئا يېڭى گۋىنېيە	Papua New Guinea
پالاۋ	Palau
ئارگون	Argon
ناۋرۇ	Nauru
مىكرونېزىيە فېدېراتسىيىسى	Federated States of Micronesia
كالىي	Potassium
كالتىسىي	Calcium
قوغۇشۇن	Lead
مارشال تاقىم ئاراللىرى	Marshall Islands
كىرىباتى	Kiribati
موڭغۇلىيە	Mongolia
فىجى	Fiji
سكاندىي	Scandium
تىتان	Titanium
ۋېنېسۇئېلا	Venezuela
چىڭگىزخان	Genghis Khan
ۋانادىي	Vanadium
Méané Shitati	Maine
خروم	Chromium
ئات	Horse
ئامستېردام	Amsterdam
ھايۋانات	Animal
سۇرىنام	Suriname
مانگان	Manganese
پاراگۋاي	Paraguay
گايانا	Guyana
ئېكۋادور	Ecuador
رېنىي	Rhenium
كولومبىيە	Colombia
كوبالت	Cobalt
ۋولفرام	Tungsten
نىكېل	Nickel
بۇددا دىنى	Buddhism
بولىۋىيە	Bolivia
مىس	Copper
ترىنىداد ۋە توباگو	Trinidad and Tobago
سېنت ۋىنسېنت ۋە گرېنادىن ئاراللىرى	Saint Vincent and the Grenadines
سىنك	Zinc
Yéngi Xampishir Shitati	New Hampshire
سېنت ليۇسىيە	Saint Lucia
داۋېىنچى	Leonardo da Vinci
سېنت كىتس ۋە نېۋىس	Saint Kitts and Nevis
زەمبۇرۇغ	Fungus
يامايكا	Jamaica
گرېنادا	Grenada
Massachuséts Shitati	Massachusetts
گۋاتېمالا	Guatemala
باھاما	The Bahamas
Konnéktikat Shitati	Connecticut
ئانتىگۇئا ۋە باربۇدا	Antigua and Barbuda
Haway Shitati	Hawaii
ھوندۇراس	Honduras
دومىنىكا	Dominica
دومىنىكان جۇمھۇرىيەتى	Dominican Republic
ھايتى	Haiti
ئەل سالۋادور	El Salvador
ئىران	Iran
ئىراق	Iraq
Alyaska Shitati	Alaska
كوستارىكا	Costa Rica
ئىسرائىلىيە	Israel
پاناما	Panama
يەمەن	Yemen
پولەك تىلى	Polish language
ئىئوردانىيە	Jordan
نىكاراگۇئا	Nicaragua
Florida Shitati	Florida
قىرغىزىستان	Kyrgyzstan
Arizona Shitati	Arizona
كۇۋەيت	Kuwait
لائوس	Laos
لىۋان	Lebanon
Orégon Shitati	Oregon
مالدىۋ ئاراللىرى	Maldives
ئامېرىكا قىتئەسى	Americas
Yuta Shitati	Utah
مالايسىيا	Malaysia
بىرما	Burma
نېپال	Nepal
ئومان	Oman
پاكىستان	Pakistan
قاتار	Qatar
سەئۇدى ئەرەبىستان	Saudi Arabia
سرىلانكا	Sri Lanka
ستالىن	Joseph Stalin
سۇرىيە	Syria
بىراتۇ	Plato
گاللىي	Gallium
تاجىكىستان	Tajikistan
تەيۋەن	Taiwan
گېرمانىي	Germanium
تايلاند	Thailand
ئارسېن	Arsenic
تۈركمەنىستان	Turkmenistan
سېلېن	Selenium
ئەرەب بىرلەشمە خەلىپىلىكى	United Arab Emirates
بروم	Bromine
Platina	Platinum
ۋيېتنام	Vietnam
Nowosibirski	Novosibirsk
جەنۇبىي چاۋشيەن	South Korea
كرىپتون	Krypton
ئافغانىستان	Afghanistan
رۇبىدىي	Rubidium
ئالتۇن	Gold
قازان	Kazan
بانگلادېش	Bangladesh
مالى	Mali
ئانگولا	Angola
بۇتان	Bhutan
برۇنېي	Brunei
تانزانىيە	Tanzania
فىلىپپىن	Philippines
ئوتتۇرا ئافرىقا جۇمھۇرىيىتى	Central African Republic
جەنۇبى قۇتۇپ	South Pole
شىمالى قۇتۇپ	North Pole
ئىسساك نيوتۇن	Isaac Newton
ئالبېرىت ئېينىشتېين	Albert Einstein
سترونتسىي	Strontium
ئىتترىي	Yttrium
ۋىسمۇت	Bismuth
سېرىق رەڭ	Yellow
توگو	Togo
تۇنىس	Tunisia
زامبىيە	Zambia
زىمبابۋې	Zimbabwe
بېيجىڭ شەھىرى	Beijing
تۇۋا	Tuva
بېنىن	Benin
بوتسۋانا	Botswana
بۇركىنا فاسو	Burkina Faso
بۇرۇندى	Burundi
كومور ئاراللىرى	Comoros
كونگو جۇمھۇرىيىتى	Republic of the Congo
كونگو دېموكراتىك جۇمھۇرىيىتى	Democratic Republic of the Congo
San Antonio	San Antonio
جىبۇتى	Djibouti
پولونىي	Polonium
ئېكۋاتور گۋىنېيىسى	Equatorial Guinea
ئېرىترېيە	Eritrea
Yéngi Déhli	New Delhi
تبىلىسى	Tbilisi
ئاستاتىن	Astatine
گابون	Gabon
گامبىيە	The Gambia
ۋىنېيە	Guinea
گۋىنېيە بىسسائۇ	Guinea-Bissau
پىل چىشى قىرغىغى	Ivory Coast
كامېرۇن	Cameroon
يېشىل تۇمشۇق ئاراللىرى	Cape Verde
لېسوتو	Lesotho
لىبېرىيە	Liberia
لىۋىيە	Libya
ماداگاسكار	Madagascar
مالاۋى	Malawi
Shtutgart	Stuttgart
ماۋرىتانىيە	Mauritania
ماۋرىتىئۇس	Mauritius
ماراكەش	Morocco
موزامبىك	Mozambique
نامىبىيە	Namibia
نىگېر	Niger
نىگېرىيە	Nigeria
دارۋىن	Charles Darwin
ئۇگاندا	Uganda
رۋاندا	Rwanda
سىركونىي	Zirconium
San Tomé we Prinsipé	São Tomé and Príncipe
سېنېگال	Senegal
سېيشېل ئاراللىرى	Seychelles
سيېررا لېئونې	Sierra Leone
سومالى	Somalia
نىئوبىي	Niobium
جولیس سیزر	Julius Caesar
سۇدان	Sudan
سۋازىلېند	Swaziland
مولبېدىن	Molybdenum
تېخېتىسىي	Technetium
Hamburg	Hamburg
گۇجارات	Gujarat
بىرلەشكەن دۆلەتلەر تەشكىلاتى	United Nations
گېئولوگىيە	Geology
Exmetabad	Ahmedabad
يۈرەك	Heart
تېرە	Skin
پراگا	Prague
كۆك رەڭ	Blue
كۈمۈش	Silver
قەلەي	Tin
ئۇران	Uranium
سۈرمە	Antimony
پلوتونىي	Plutonium
نېپتونىي	Neptunium
كسېنون	Xenon
سېزىي	Caesium
پروتاكتىنىي	Protactinium
بارىي	Barium
تورىي	Thorium
گافنىي	Hafnium
ئاكتىنىي	Actinium
تانتال	Tantalum
بىل كلىنتون	Bill Clinton
رادىي	Radium
رادون	Radon
Bombay	Mumbai
Michigan Shitati	Michigan
پوئېرتو رىكو	Puerto Rico
Illinoyiz Shitati	Illinois
Shimaliy Dakota Shitati	North Dakota
لومبارد	Lombardy
Jenubiy Dakota Shitati	South Dakota
Montana Shitati	Montana
Wyoming Shitati	Wyoming
قۇدس	Jerusalem
Aydaxo Shitati	Idaho
Washin'giton Shitati	Washington (state)
رۇزېرفوردىي	Rutherfordium
Néwada shitati	Nevada
دۇبنىي	Dubnium
سىبورگىي	Seaborgium
بوھرىي	Bohrium
ھاسسىي	Hassium
مېيتنېرىي	Meitnerium
Kolorado Shitati	Colorado
دارمستادتىي	Darmstadtium
رۆنتگېنىي	Roentgenium
كوپېرنىي	Copernicium
تۈر:تۈرلەر يولباشچىسى	Category:Contents
ئاپېنىن تاغ تىزمىسى	Apennine Mountains
ئالپ تاغلىرى	Alps
پاسكال	Blaise Pascal
Gant	Ghent
Chikago	Chicago
ئۇنۇنترىي	Ununtrium
فلېروۋىي	Flerovium
ئۇنۇنپېنتىي	Ununpentium
لىۋىرمورىي	Livermorium
ئۇنۇنسېپتىي	Ununseptium
ئۇنۇنئوكتىي	Ununoctium
Arném	Arnhem
ئىسپان تىلى	Spanish language
مونتېۋىدېئو	Montevideo
Filadélfiye	Philadelphia
Kalkutta	Kolkata
Déhli	Delhi
داكا	Dhaka
Ban'galor	Bangalore
Ömüchük	Spider
ئىسلامئاباد	Islamabad
ظاصتاص يئضةن مئؤة	Fruit
مايمۇن	Monkey
Wirginiye Shitati	Virginia
غەربىي ۋىرگىنىيە شىتاتى	West Virginia
Nyuyork Shitati	New York
سېرىي	Cerium
پرازېئودىمىي	Praseodymium
Rodé Arili Shitati	Rhode Island
نېئودىي	Neodymium
Maryland Shitati	Maryland
Délawiyer Shitati	Delaware
يېۋروپىي	Europium
Oxayo Shtati	Ohio
Pénsilwaniye Shitati	Pennsylvania
Yéngi Jérséy Shtati	New Jersey
فىنلاندىيە تىلى	Finnish language
Indiyanna Shitati	Indiana
ئاپتوموبىل	Car
Giorgiye Shitati	Georgia (U.S. state)
Zagréb	Zagreb
Téksas Shitati	Texas
Jenubiy Karolina Shitati	South Carolina
سىتسىلىيە	Sicily
مانىلا	Manila
ساردىنىيە ئارىلى	Sardinia
Bordo	Bordeaux
Buénos Ayrés	Buenos Aires
مېكسىكا شەھىرى	Mexico City
توكيو	Tokyo
Barsélona	Barcelona
Missisipi Shitati	Mississippi
Ténnéssi Shitati	Tennessee
Astana	Astana
Yéngi Méksika Shitati	New Mexico
ئافېنا	Athens
Minnésota Shitati	Minnesota
باغداد	Baghdad
Karakas	Caracas
Wiskonsin Shitati	Wisconsin
Puna	Pune
AC مىلان	A.C. Milan
Lowa Shitati	Iowa
Nébraska Shitati	Nebraska
گۋاتېمالا شەھىرى	Guatemala City
Kanzas Shitati	Kansas
ھىندى تىلى	Hindi
ماراتىچە	Marathi language
Missori Shitati	Missouri
Loyizanna Shitati	Louisiana
Kéntukki Shitati	Kentucky
Arkanzas Shtati	Arkansas
ئوردو تىلى	Urdu
Oklaxoma Shitati	Oklahoma
Potsdam	Potsdam
Hanofér	Hanover
Myunxén	Munich
Drézdén	Dresden
ۋالىبول	Volleyball
Wyéna	Vienna
Kopénhagén	Copenhagen
Stokgolm	Stockholm
Xélsinki	Helsinki
دۇبلىن	Dublin
رېيكياۋىك	Reykjavík
Tallin	Tallinn
رىگا	Riga
براتىسلاۋا	Bratislava
Budapésht	Budapest
Danzig	Gdańsk
Frankfort	Frankfurt
Wroklaw	Wrocław
لانتان	Lanthanum
جۈي	Promethium
چالغا	Samarium
گادولنىي	Gadolinium
تېربىي	Terbium
Katolik dini	Catholicism
ليۇكسېمبۇرگ شەھىرى	Luxembourg (city)
دىسپروزىي	Dysprosium
ۋادۇز	Vaduz
ئىنجىل	Bible
گولمىي	Holmium
ئېربىي	Erbium
فنوم پېن	Phnom Penh
تۇلىي	Thulium
سايگون	Ho Chi Minh City
ئىتتېربىي	Ytterbium
لۇتېتسىي	Lutetium
خانوي	Hanoi
ھەقىقى ئەيسا چېركاۋى	True Jesus Church
ئىنگىلىز تىلى	English language
Bangkok	Bangkok
ئاندوررا كەنتى	Andorra la Vella
كۇئالالۇمپۇر	Kuala Lumpur
تەيبېي شەھىرى	Taipei
ئامېرىتسىي	Americium
كىيۇرىي	Curium
Concepción, Chile	Concepción, Chile
بېركېلىي	Berkelium
كالىفورنىي	Californium
ئېينشتېينىي	Einsteinium
فېرمىي	Fermium
مېندېلېيېۋىي	Mendelevium
كىيېۋ	Kiev
نوبېلىي	Nobelium
لاۋرېنسىي	Lawrencium
كارېلىيە	Republic of Karelia
Ottawa	Ottawa
Manitoba Ölkisi	Manitoba
Albérta	Alberta
Nowa Skotiye Ölkisi	Nova Scotia
يېرېۋان	Yerevan
دارېسسالام	Dar es Salaam
خارتۇم	Khartoum
Yéngi Brunswik Ölkisi	New Brunswick
Britani Kolumbiye	British Columbia
Saskachéwan	Saskatchewan
Néwfundland Ölkisi	Newfoundland and Labrador
Gherbiy Shimal Rayoni	Northwest Territories
Yukon Rayoni	Yukon
Florénsa	Florence
Ésén	Essen
كومى	Komi Republic
Léypzig	Leipzig
Nyurnbérg	Nuremberg
Édmonton	Edmonton
Man'géym	Mannheim
Wiktoriye, Britani Kolumbiye	Victoria, British Columbia
Winnipég	Winnipeg
Halifaks	Halifax, Nova Scotia
Kwébék Shehiri	Quebec City
ئېلېكترون	Electron
Birmin'gxam	Birmingham
مىنىسكى	Minsk
مىكروسوفىت شىركىتى	Microsoft
پروتون	Proton
Kurow	Kurów
Naplés	Naples
Braunshwéyg	Braunschweig
Madrid	Madrid
سۇ ئاستى كېمىسى	Submarine
مايكېل جېكسۇن	Michael Jackson
Bogota	Bogotá
لىما	Lima
Santiyago	Santiago
كىتو	Quito
سۇكرې	Sucre
ئاسۇنسىئون	Asunción
Öçke	Goat
Héydélbérg	Heidelberg
كاتماندۇ	Kathmandu
سان خوسې (كوستارىكا)	San José, Costa Rica
سان سالۋادور	San Salvador
Kanbérra	Canberra
Sidnéy	Sydney
يېشىل رەڭ	Green
Mélburn	Melbourne
قىزىل رەڭ	Red
ماناگۇئا	Managua
رابات	Rabat
قۇيرۇقلۇق يۇلتۇز	Comet
ئالجىر	Algiers
تۇنىس شەھىرى	Tunis
ترىپولى	Tripoli
تېھران	Tehran
جاكارتا	Jakarta
Enqere	Ankara
رىياد	Riyadh
بېلگراد	Belgrade
ئادىگېيە	Adygea
پرايا	Praia
دەمەشىق	Damascus
يامۇسسۇكرو	Yamoussoukro
فرانسىيىگە قاراشلىق گۋىئانا	French Guiana
لومې	Lomé
ئاممان	Amman
بېيرۇت	Beirut
مۇسكات	Muscat, Oman
نىكوسىيە	Nicosia
دوھا	Doha
نايروبى	Nairobi
لۇساكا	Lusaka
ئامازون	Amazon.com
قۇياش تۇتۇلۇشى	Solar eclipse
كامپالا	Kampala
Mektep	School
ھارارې	Harare
Prétoriye	Pretoria
Astiraxan	Astrakhan
Tiktak top	Table tennis
Wikipedia:Sandbox	Wikipedia:Sandbox
قالماقىستان	Kalmykia
Osasko	Osasco
Glasgow	Glasgow
Kuritiba	Curitiba
Orman	Forest
بوغاز كۆۋرۈكى	Bosphorus Bridge
كۇڭزى	Confucius
كوربين بيلو	Corbin Bleu
Surat	Surat
ياۋرۇ	Euro
ئامېرىكا دولىرى	United States dollar
يەر ئوتتۇرا دېڭىزى	Mediterranean Sea
خاڭجۇ شەھىر	Hangzhou
مەسىھچىلىك	Christianity
قېلىپ:ئاسىيا	Template:Countries of Asia
Séatl	Seattle
Baltimor	Baltimore
ئادېلايدې	Adelaide
داغىستان	Dagestan
Monzón	Monzón
گۇجارات تىل	Gujarati language
پورتۇگال تىلى	Portuguese language
مۇستاپا كامال	Mustafa Kemal Atatürk
چېچېنىيە	Chechnya
كۋېچۇئا تىلى	Quechuan languages
ئىنگۇشېتىيە	Ingushetia
شىمالىي ئوسېتىيە	North Ossetia–Alania
كاباردىنو-بالقارىستان	Kabardino-Balkaria
ئالماس	Diamond
ياپون تىلى	Japanese language
Énsklopédiye	Encyclopedia
ئۇيغۇرچە ۋىكىپىدىيە	Main Page
Latex	LaTeX
كوندېنساتور	Capacitor
قاراچاي-چېركېسىيە	Karachay-Cherkessia
موردوۋىيە	Mordovia
ۋاسكېتبول	Basketball
چاڭجياڭ دەرياسى	Yangtze
ئۇدمۇرتىيە	Udmurtia
مارى	Mari El
ھىمالايا تاغ تىزمىسى	Himalayas
ئاند تاغلىرى	Andes
قىيىلىق تاغلار	Rocky Mountains
Kapétown	Cape Town
چۇۋاشىيە	Chuvashia
تەڭرىتاغ	Tian Shan
كاۋكاز تاغ تىزمىسى	Caucasus Mountains
تاتارىستان	Tatarstan
1279-يىلى	1279
ۋېىنىست	Vincent van Gogh
باشقۇرتىستان	Bashkortostan
Semerqend	Samarkand
Buxara	Bukhara
بېتلېخېم	Bethlehem
Andalusiye	Andalusia
كايمان تاقىم ئاراللىرى	Cayman Islands
Kordowa	Córdoba, Andalusia
شىئەن شەھىرى	Xi'an
كابۇل	Kabul
لاسا شەھىرى	Lhasa
غىلاپ	Vagina
تامىل تىلى	Tamil language
پەلسەپە	Philosophy
ئالەم ئايرۇپىلانى	Spaceflight
ئالتاي تاغ تىزمىسى	Altai Mountains
تۈر:Candidates for speedy deletion	Category:Candidates for speedy deletion
ئالتاي	Altai Republic
پىئانىنو	Piano
Hebe Camargo	Hebe Camargo
Portland, Orégon	Portland, Oregon
ئانارخىزم	Anarchism
لىبېرالىزىم	Liberalism
فاشىسىت	Fascism
مىللەتچىلىك	Nationalism
غەربىي ساھارا	Western Sahara
ھىلاري كلىنتون	Hillary Rodham Clinton
خاكاسىيە	Khakassia
Strasburg	Strasbourg
ياكۇتىيە	Sakha Republic
كرودىيە تىلى	Croatian language
گائۇس	Carl Friedrich Gauss
بۇرياتىيە	Buryatia
جامىس جويىس	James Joyce
كاتالان تىلى	Catalan language
Burχa	Buddhahood
دىنسىزلىق	Atheism
لى بەي	Li Bai
دۇنيا بانكىسى	World Bank
كونسېرۋاتىپ	Conservatism
شىمالىي ئاتلانتىك ئەھدى تەشكىلاتى	NATO
نوبېل مۇكاپاتى	Nobel Prize
چىن شىخۇاڭ	Qin Shi Huang
خەن سۇلالىسى	Han dynasty
فېمىنىزم	Feminism
ئىدېئولوگىيە	Ideology
پەي توپ	Badminton
يۈەن سۇلالىسى	Yuan dynasty
كولۇمبو	Christopher Columbus
يەھۇدىلار	Jews
سېرىق دەريا	Yellow River
قۇلاق	Ear
بۇرۇن	Nose
كۆز	Eye
مۇسكۇل	Muscle
Töge	Camel
پىل	Elephant
چۈمۈلە	Ant
سۈي سۇلالىسى	Sui dynasty
گوللاندىيە تىلى	Dutch language
ماگرىت ساچىر	Margaret Thatcher
ياڭ جىيەن	Emperor Wen of Sui
دېئوكسىرىبونۇكلېئىك كىسلاتا	DNA
سۇڭ سۇلالىسى	Song dynasty
Çeyze	Eggplant
رۇس تىلى	Russian language
ساخالىن	Sakhalin
نېفىت ئېكىسپورت قىلغۇچى دۆلەتلەر تەشكىلاتى (OPEC)	OPEC
خەلقئارا پۇل فوندى تەشكىلاتى	International Monetary Fund
دۇنيا سودا تەشكىلاتى	World Trade Organization
سۋاھىلىچە	Swahili language
توكيو ئۇنىۋېرستېتى	University of Tokyo
خەنزۇ تىلى	Chinese language
ئۆپكە	Lung
نەپەسلىنىش سىستېمى	Respiratory system
رۇمىنىيە تىلى	Romanian language
بۇلغارىيە تىلى	Bulgarian language
يەر تەۋرەش	Earthquake
ماگادان	Magadan
تەبىئىي پەن	Natural science
فرانكلىن روزۋېلت	Franklin D. Roosevelt
ﺋﯩﺒﯩﻦ ﺳﯩﻨﺎ	Avicenna
نىلسۇن ماندىلا	Nelson Mandela
مارتىن لوتىر كىڭ	Martin Luther King Jr.
Yanardag	Volcano
ئىسسىق بەلباغ سىكلونى	Tropical cyclone
تېلۇگۇ تىلى	Telugu language
گرۇزىن تىلى	Georgian language
ئىقتىسادشۇناسلىق	Economics
يېن	Japanese yen
قىزىل تۈلكە	Red fox
ئىسكىرىپكا	Violin
چوڭ ئىسكىروپكا	Cello
ئىسكەندەر زۇلقەرنەيىن	Alexander the Great
ئۆمەر ئىبنى خەتتاب	Umar
ئامۇ دەرياسى	Amu Darya
سۈت	Milk
سۇن جۇڭشەن	Sun Yat-sen
شياڭگاڭ	Hong Kong
Miami	Miami
كاراچى	Karachi
Rio dé Janéyro	Rio de Janeiro
سوغۇق ئۇرۇش	Cold War
شاڭخەي شەھىرى	Shanghai
Bilbaw	Bilbao
Séwéliye	Seville
چىڭ سۇلالىسى	Qing dynasty
توماس ئىدىسون	Thomas Edison
ئالبان تىلى	Albanian language
باسكى تىلى	Basque language
ئاراگون تىلى	Aragonese language
ئەرمەن تىلى	Armenian language
ئۇكرائىن تىلى	Ukrainian language
Walénsiye	Valencia
Malaga	Málaga
شۋېتسىيە تىلى	Swedish language
دانىش تىلى	Danish language
نورۋېگىيە تىلى	Norwegian language
ليۇكسېمبۇرگ تىلى	Luxembourgish language
چېخ تىلى	Czech language
سلوۋاك تىلى	Slovak language
كارل ماركىس	Karl Marx
سلوۋېن تىلى	Slovene language
ماجار تىلى	Hungarian language
ۋولتىر	Voltaire
ئېستون تىلى	Estonian language
لاتۋىيە تىلى	Latvian language
لىتۋا تىلى	Lithuanian language
ھىندى دىنى	Hinduism
بېلورۇس تىل	Belarusian language
يېلىن	Breast
ئاتوم	Atom
گرېك تىلى	Greek language
ئرېلاندىيە تىلى	Irish language
مالتا تىلى	Maltese language
پارس تىلى	Persian language
ئىسلام	Religion
كورىيەچە	Korean language
Injilning birinchi tomi	Book of Genesis
كانتونچە	Cantonese
ئېكسودۇس	Book of Exodus
ۋيېتنام تىلى	Vietnamese language
كخمېر تىلى	Khmer language
لائوس تىلى	Lao language
تايلاندچە	Thai language
بىرما تىلى	Burmese language
مالاي تىلى	Malay language
ھىندونېزىيە تىلى	Indonesian language
موڭغۇل تىلى	Mongolian language
Baku	Baku
قازاق تىلى	Kazakh language
قىرغىز تىلى	Kyrgyz language
تاجىك تىلى	Tajik language
ئۆزبېك تىلى	Uzbek language
تۈركمەن تىلى	Turkmen language
يەھۇدى دىنى	Judaism
تىمپۇ	Thimphu
باندار سەرى بەگاۋان	Bandar Seri Begawan
ئىبرانى تىلى	Hebrew language
ئەزەربەيجان تىلى	Azerbaijani language
ماكېدون تىلى	Macedonian language
سېرب تىلى	Serbian language
سېربو-كرودىيىلىكلەر تىلى	Serbo-Croatian
بوسنىيە تىلى	Bosnian language
گالىسىيەچە	Galician language
ۋېلش تىلى	Welsh language
دىلى	Dili
شوتلاندىيە گائېل تىلى	Scottish Gaelic
Wyéntyan	Vientiane
مالې	Malé
Bishkek	Bishkek
Düshenbe	Dushanbe
جىگەر	Liver
تلا	Spleen
بۆرەك	Kidney
دوۋساق	Urinary bladder
نېرۋا سىستىمېسى	Nervous system
ئوكيانىيە	Ocean
مۇھەممەد ئەلەيھىسسالام	Muhammad
ئىمام ئەلغازالىي	Al-Ghazali
رىچارد نىكسون	Richard Nixon
قورساق قىسم	Abdomen
داۋجياۋ دىنى	Taoism
سوپىزم (تەسەۋۋۇپ)	Sufism
ۋېنا تومۇرى	Vein
بېنگال تىلى	Bengali language
تىل	Tongue
پانكرېئاتىت	Pancreas
بويۇن	Neck
ئېغىز بوشلۇقى	Mouth
بوغۇز	Larynx
فالكلاند تاقىم ئاراللىرى	Falkland Islands
سازاڭسىمان ئۆسۈكچە	Vermiform appendix
ئېلىزابېت II	Elizabeth II
تاڭ سۇلالىسى	Tang dynasty
كېننېدى	John F. Kennedy
تاڭ تەيزوڭ	Emperor Taizong of Tang
بالزاك	Honoré de Balzac
مىڭ سۇلالىسى	Ming dynasty
جۇ يۈەنجاڭ	Hongwu Emperor
رېگان	Ronald Reagan
زۇلۇچە	Zulu language
زازا تىلى	Zazaki language
پلازما	Plasma (physics)
رىم گىلادىئاتورلار مەيدانى	Colosseum
Saragossa	Zaragoza
Bélfast	Belfast
ئېلېمېنتلارنىڭ دەۋرىي جەەدۋىلى	Periodic table
قۇرۇق ئۈزۈم	Grape
ھەسەل	Honey
شېكەر	Sugar
روبوت	Robot
ماشىنىسازلىق	Machine
ئايلىنىش سىستېمىسى	Circulatory system
ئىچكى ئاجراتما سىستېمىسى	Endocrine system
كىسلاتا	Acid
سارايېۋو	Sarajevo
تۇز	Salt
فۇنكسىيە	Function (mathematics)
مولېكۇلا	Molecule
ئېنېرگىيە	Energy
ئىنفرا قىزىل نۇر	Infrared
ماسسا	Mass
مېتال	Metal
پولات	Steel
نانو تېخنىكىسى	Nanotechnology
ئەينەك	Glass
ۋاكۇئۇم	Vacuum
ئېلېكترون ئىلمى	Electronics
.توك (توك ئېقىمى)	Electric current
ئىككى پۇتلۇق لامپا	Diode
ئامېرىكىغا قاراشلىق ۋىرگىن تاقىم ئاراللىرى	United States Virgin Islands
شېنياڭ شەھىرى	Shenyang
چۇڭچىڭ شەھىرى	Chongqing
تيەنجىن شەھىرى	Tianjin
Lahor	Lahore
ۋۇخەن شەھىرى	Wuhan
نۆۋەتتىكى ھادىسە	List of sovereign states
ناگويا	Nagoya
تاش قورال دەۋرى	Stone Age
ئېيىق	Bear
فوتوسىنتېز رولى	Photosynthesis
برېتون تىلى	Breton language
پىرېنېي تاغلىرى	Pyrenees
Détroyt	Detroit
بۇرج دۇبەي	Burj Khalifa
Sedichin Sépili	Great Wall of China
ئاياسوڧيا	Hagia Sophia
ئابباسىيلار خاندانلىقى	Abbasid Caliphate
سەلىپنىڭ شەرققە يۈرۈش قىلىشى	Crusades
موڭغۇل ئىمپېرىيىسى	Mongol Empire
ئوسمان ئىمپېرىيىسى	Ottoman Empire
ئىسپانىيە-ئامېرىكا ئۇرۇشى	Spanish–American War
مىللى دارامەت	Gross domestic product
ئېلېكتر	Electricity
يادرو ئېنېرگىيىسى	Nuclear power
ھور ماشىنىسى	Steam engine
Antwérp	Antwerp
باش سۆڭىكى	Skull
ئانار	Pomegranate
ئاپېلسىن	Orange (fruit)
دۇنيا تىلى	Romansh language
جۇاڭزۇ تىلى	Zhuang languages
شىبە تىلى	Xibe language
ئۇيغۇر تىلى	Uyghur language
سىنگال تىلى	Sinhala language
ناخۇئاتل تىلى	Nahuatl
مونتسەررات	Montserrat
خارۋارد ئۇنىۋېرسىتېتى	Harvard University
Pisa	Pisa
باشقۇرتچە	Bashkir language
قېلىپ:Location map Earth	Module talk:Location map/data/Earth/attribution
باغلانغان ئۆردەك	Le Canard enchaîné
ئەرەب تىلى	Arabic language
كيۇسيۇ ئارىلى	Kyushu
خونسيو ئارىلى	Honshu
شىكوكۇ	Shikoku
كورسىكا ئارىلى	Corsica
ئاڧرىقانچە	Afrikaans
بۆرە بورسۇق	Wolverine
ئاۋمېن	Macau
خۇ جىنتاۋ	Hu Jintao
شى جىنپىڭ	Xi Jinping
زىراپە	Giraffe
شېنجېن شەھىرى	Shenzhen
گۇئاڭدوڭ ئۆلكىسى	Guangdong
گۇاڭشى جۇاڭزۇ ئاپتونۇم رايونى	Guangxi
سوۋېت ئىتتىپاقى	Soviet Union
شياڭگاڭ ئۇنىۋېرستېتى	University of Hong Kong
شياڭگاڭ جۇڭگو تىللىرى ئۇنۋېرسىتېتى	Chinese University of Hong Kong
رۇبلى	Ruble
پۇت	Foot
دولا	Shoulder
قالقانبەز	Thyroid
Wikipedia:Tor Jamiyeti	Wikipedia:Village pump
Wérmont Shitati	Vermont
San Diyégo	San Diego
San Xosé	San Jose, California
Dénwér	Denver
Hyuston	Houston
Féniks	Phoenix, Arizona
Dallas	Dallas
Austin	Austin, Texas
Mémfis, Ténnéssi	Memphis, Tennessee
Sharlot	Charlotte, North Carolina
Kolumbu, Oxéo	Columbus, Ohio
گۇاڭجۇ شەھىرى	Guangzhou
جىياڭ جىشى	Chiang Kai-shek
ۋېن جىياباۋ	Wen Jiabao
Guam Aril	Guam
ئامېرىكىغا قاراشلىق ساموئا	American Samoa
شىمالىي مارىئانا فېدېراتسىيىسى	Northern Mariana Islands
نەنجىڭ شەھىرى	Nanjing
بېيجىڭ ئۇنىۋېرسىتېتى	Peking University
ئۈرۈمچى شەھىرى	Ürümqi
جياڭسۇ ئۆلكىسى	Jiangsu
جېجياڭ ئۆلكىسى	Zhejiang
گۇئادەلوپە	Guadeloupe
مارتىنىكا	Martinique
شىزاڭ ئاپتونوم رايونى	Tibet Autonomous Region
دالاي لاما	14th Dalai Lama
تۆگىقۇش	Ostrich
Sakraménto	Sacramento, California
چاۋشيەن	Korea
لى كېچياڭ	Li Keqiang
Manchéstér	Manchester
تۇركس ۋە كايكوس تاقىم ئاراللىرى	Turks and Caicos Islands
ۋىتامىن A	Vitamin A
ياۋروپا چىمپيونلۇق لوڭقىسى	UEFA Champions League
پالمىزارلىق ئىپار مۈشۈكى	Asian palm civet
Pyongyang	Pyongyang
New Testament	New Testament
ئادالەت ۋە تەرەققىيات پارتىيىسى	Justice and Development Party (Turkey)
گۈللىنىش پارتىيىسى	Republican People's Party (Turkey)
مىللى دارامەت بويىچە دۆلەت تەرتىپى	List of countries by GDP (nominal)
خېيلوڭجياڭ ئۆلكىسى	Heilongjiang
ما يىنجىئۇ	Ma Ying-jeou
بۇخارېست	Bucharest
پوئىرتورىكان مۇستەقىللىق پارتىيىسى	Puerto Rican Independence Party
Tirana	Tirana
ئېشەك	Donkey
سىچۈەن ئۆلكىسى	Sichuan
مۇھەممەر قەززافى	Muammar Gaddafi
بارس	Tiger
چۆپ ئاش	Vermicelli
سامسۇڭ گۇرۇھى	Samsung
شىمالىي ياۋروپا	Scandinavia
كىشىنېۋ	Chișinău
بیلگیسايار مۈھەندیسلیغی	Computer science
Şalom	Şalom
ئارۇبا	Aruba
خېبېي ئۆلكىسى	Hebei
پرىنسېتون ئۇنىۋېرستېتى	Princeton University
نېفىت	Petroleum
پېنسىلۋانىيە نېمىس تىلى	Pennsylvania German language
پرژىۋالسكى ياۋا ئات	Przewalski's horse
قوي	Ovis
ئىرلاندىيە	Ireland
Chéshir	Cheshire
Nortumbér Wilayiti	Northumberland
Staffordshir	Staffordshire
ﻟﯘﺷﯜﻥ	Lu Xun
Shimaliy Amptonshir	Northamptonshire
Bédfordshir	Bedfordshire
Kornwél	Cornwall
Bristol	Bristol
Déwonshir	Devon
خالتىلىق چاشقانلار ئائىلىسى	Macropodidae
Nashwil	Nashville, Tennessee
Xampishir	Hampshire
Bérkshir	Berkshire
Bukkinxamshir	Buckinghamshire
Ésséks	Essex
Ként	Kent
Ulanbatur	Ulan Bator
ئېرنېست ھېمىڭۋاي	Ernest Hemingway
Idinburg	Edinburgh
ئاشخاباد	Ashgabat
پىياز	Onion
پەمىدۇر	Tomato
جورج بۇش	George H. W. Bush
بالقانلار	Balkans
پروتېستانت دىنى	Protestantism
سەلەنا	Selena
Atlanta	Atlanta
بېرمۇدا	Bermuda
باش	Head
ۋېللىنگتون	Wellington
روبوتلارنىڭ ئۈچ قانۇنى	Three Laws of Robotics
ئالفېرد نوبىل	Alfred Nobel
لیلا چڑھاو	Lila Downs
907-يىلى	907
Wankuwér	Vancouver
Liwérpol	Liverpool
Brémén	Bremen
يېڭى نورۋېگىيە تىلى	Nynorsk
پوند ستېرلىڭ	Pound sterling
ئانگۋىللا	Anguilla
فائېروس تىل	Faroese language
مۈشۈك ئائىلىسى	Felidae
ISO 3166-1	ISO 3166-1
تاتار تىلى	Tatar language
ئەنگلىيىگە قاراشلىق ۋىرگىن تاقىم ئاراللىرى	British Virgin Islands
كىچىك سېسىق كۈزەنى	Least weasel
فرىزانچە	Frisian languages
ئاق ئاغمىخان	Stoat
قارشىلىق	Electrical resistance and conductance
ناۋاسسا ئاراللىرى	Navassa Island
سېنت بارتھېلەمي ئاراللىرى	Saint Barthélemy
شىمالىي گېرمانىيە دىئالېكتى	Low German
ئاغمىخان ئائىلىسى	Mustelidae
ساينت مارتىن	Saint Martin
بۆكەن	Antelope
قارا بۇلغۇن	Sable
سۈنئىي ھەمراھ	Satellite
قوتاز	Yak
ب م ۋ	BMW
Kuk Taqim Aralliri	Cook Islands
رەشىدە داتى	Rachida Dati
شەرقىي ئاسىيا	East Asia
ئوتتۇرا ئاسىيا	Central Asia
ئاق تۆش بۇلغۇن	Beech marten
ياۋا ئات	Wild horse
ئامخارا تىلى	Amharic
Képinek	Lepidoptera
چاچ	Hair
ھىجرىيە كالېندارى	Islamic calendar
جيامۇسى شەھىرى	Jiamusi
كەبەك	Kebek
دىرىخلې	Peter Gustav Lejeune Dirichlet
ئاستۇرىيە تىلى	Asturian language
قاما	European otter
چېڭدۇ شەھىر	Chengdu
يىلپىز	Snow leopard
جېڭجۇ شەھىرى	Zhengzhou
تېرېسا ئانا	Mother Teresa
DELL شىركىتى	Dell
فرانسىيىگە قاراشلىق پولىنېزىيە	French Polynesia
618-يىلى	618
روژدېستۋو ئاراللىرى	Christmas Island
Krakow	Kraków
بېيجىڭ پايتەخت ئايروپورتى	Beijing Capital International Airport
تىراختور	Tractor Sazi F.C.
ۋېنىسىيە تىلى	Venetian language
تەيۋەن ئۇنۋېرسىتې	National Taiwan University
جامى	Mosque
دۇڭشياڭ تىلى	Santa language
تۇڭگان تىلى	Dungan language
كورسىكا تىلى	Corsican language
فىلىپىنچە	Filipino language
چۇۋاش تىلى	Chuvash language
قرىم تاتار تىلى	Crimean Tatar language
ھايتى كرېئول تىلى	Haitian Creole
قارا قالپاق تىلى	Karakalpak language
ياۋا تىلى	Javanese language
مۈشۈكئېيىق	Giant panda
قالماق تىلى	Kalmyk Oirat
مانجۇ تىلى	Manchu language
كانناداچە	Kannada language
مۇڭغۇل تىللىرى	Mongolic languages
پوچېركا	Hand
دۇفۇ	Du Fu
يېڭى كالېدونىيە	New Caledonia
ئورىياچە	Oriya language
نېپال تىلى	Nepali language
نېئاپول تىلى	Neapolitan language
نورمان تىلى	Norman language
تېئودور روزېۋېلت	Theodore Roosevelt
تېلاۋىف	Tel Aviv
Nis	Nice
سالار تىلى	Salar language
سىتسىلىيە تىلى	Sicilian language
ساردىنىيە تىلى	Sardinian language
ژىيۇل ۋېرن	Jules Verne
سىندى تىلى	Sindhi language
سۇندا تىلى	Sundanese language
شونا تىلى	Shona language
Niué Arili	Niue
تاگالوگ تىلى	Tagalog language
تۈركى تىللار ئائىلىسى	Turkic languages
تونگاچە	Tongan language
ئۇرال تىللىرى	Uralic languages
تىگرىنىيەچە	Tigrinya language
Oksford	Oxford
غەربىي يۇغۇر تىلى	Western Yugur language
تۇنگۇس مانجۇ تىللىرى	Tungusic languages
زاڭزۇ تىلى	Standard Tibetan
سارى ئۇغۇر	Yugur
ۋۇ تىلى	Wu Chinese
ۋىلسون	Woodrow Wilson
ياقۇت تىلى	Sakha language
يورۇباچە	Yoruba language
سېسوتوچە	Sotho language
Rottérdam	Rotterdam
Yéngi Orléan	New Orleans
فۇشەن شەھىر	Foshan
ئوكسفورد ئۇنىۋېرسىتېتى	University of Oxford
ئەھمىدى نىجات	Mahmoud Ahmadinejad
Saynt Xéléna Arili	Saint Helena
بارماق	Digit (anatomy)
ساينت پىئېر ئارىلى ۋە مىكېلون تاقىم ئاراللىرى	Saint Pierre and Miquelon
ئون پەرھىز	Ten Commandments
Yohannésburg	Johannesburg
قاپلان	Leopard
Saltzburg	Salzburg
X نۇرى	X-ray
شىنجاڭ ئۇيغۇر ئاپتونوم رايونى	Xinjiang
Albukwér kwé	Albuquerque, New Mexico
Oklaxoma Shehiri	Oklahoma City
برىسبان	Brisbane
ئىسساك ئاسىموۋ	Isaac Asimov
جەنۇبىي گىئورگىيە ۋە ساندۋىچ ئاراللىرى	South Georgia and the South Sandwich Islands
كۇۋائىت شەھىرى	Kuwait City
ئەرەبلەر	Arabs
سۇمېرلار	Sumer
كولومبو	Colombo
ئالمۇتا	Almaty
قانداغاي	Moose
ۋاللىس ۋە فۇتۇنا تاقىم ئاراللىرى	Wallis and Futuna
تاتار مىللىتى	Tatars
خوككايدو ئارىلى	Hokkaido
ئۇرال تاغلىرى	Ural Mountains
ماددا	Matter
ئوساكا	Osaka
كامبرىج ئۇنىۋېرستېتى	University of Cambridge
ئاكا-ئۇكا رايتلار	Wright brothers
گۇئارانچە	Guarani language
شور دېڭىز	Aral Sea
ئىستانبۇل بوغازى	Bosphorus
Izmir	İzmir
كەئەلىڭ كوكوس تاقىم ئاراللىرى	Cocos (Keeling) Islands
مېرسېدېس - بېنز	Mercedes-Benz
كۋېنسلاند	Queensland
Minnéapolis	Minneapolis
دەرەخ خالتىلىق ئېيىقى	Koala
2011-يىلدىكى ياپونىيە يەر تەۋرەش ۋە دېڭىز تاشقىنى	2011 Tōhoku earthquake and tsunami
لىنگالاچە	Lingala
مالايالامچە	Malayalam
يىپەك يولى	Silk Road
Kalgari	Calgary
ئوستىيىن	Jane Austen
قوڭۇر ئېيىق	Brown bear
كۇرد تىلى	Kurdish languages
مولداۋىيە تىلى	Moldovan language
يېڭى تاش قۇرال دەۋرى	Neolithic
مورېسبى پورتى	Port Moresby
خىمىيىلىك رېئاكسىيە	Chemical reaction
لاھەي	The Hague
جۇاڭزۇ مىللىتى	Zhuang people
ئوسمانلى تۈركچىسى	Ottoman Turkish language
يۇھاننا بايان قىلغان خۇش خەۋەر	Gospel of John
توكېلاۋ تاقىم ئاراللىرى	Tokelau
چاغاتاي ئۇيغۇر يېزىقى	Chagatai language
تۋىچە	Asante dialect
چېڭلۇڭ	Jackie Chan
توخار تىلى	Tocharian languages
ئېلان	Advertising
Zeytun	Olive
ئاۋكلاند	Auckland
سەككىز دۆلەت گۇرۇھى (G8)	G8
ئاۋكادۇر	Avocado
قىزىل قان دانىچىلىرى	Red blood cell
ئوقۇتقۇچى	Teacher
تىز	Knee
ئۆرۈك	Prunus armeniaca
گلۇكوزا	Glucose
Sint-Truiden	Sint-Truiden
ئالتاي تىللىرى سىستېمىسى	Altaic languages
ناتالىيە پورتمەن	Natalie Portman
Ran'gon	Yangon
ناگاساكى	Nagasaki
يوكوخاما	Yokohama
ئادانا	Adana
لازېر نۇرى	Laser
Lyuju shehiri	Liuzhou
خەلق پۇلى يۈەنى	Renminbi
Ritis	Leeds
رەجەپ تاييىپ ئەردوغان	Recep Tayyip Erdoğan
قىزغۇچ سېرىق	Orange (colour)
شىمال بۇغىسى	Reindeer
لۇقا بايان قىلغان خۇش خەۋەر	Gospel of Luke
كونا تاش قۇرال دەۋرى	Paleolithic
ئانتاليا ۋىلايىتى	Antalya Province
ھەزرىتى ئەيسا ئەلچىلىرىنىڭ پائالىيەتلىرى	Acts of the Apostles
پەرۋەز مۇشەررەڧ	Pervez Musharraf
ئادانا ۋىلايىتى	Adana Province
تاشقا ئايلانغان جىسىم	Fossil
بۇرسا	Bursa
ئۇرۇق	Seed
ئەنخۇي ئۆلكىسى	Anhui
خەلقئارا ئولىمپىك كومىتىتى	International Olympic Committee
ماڭلاي	Forehead
ئىچكى موڭغۇل ئاپتونوم رايونى	Inner Mongolia
Nottingxam	Nottingham
راكېتا	Rocket
كۇردىستان	Kurdistan
ستانفورد ئۇنىۋېرستېتى	Stanford University
فۇجيەن ئۆلكىسى	Fujian
Kanzas Shehiri, Missuri	Kansas City, Missouri
كىچىك مۈشۈكئېيىق	Red panda
موڭغۇل مىللىتى	Mongols
ۋەھىيلەر	Book of Revelation
Sirtlan	Hyena
كاسا	Buttocks
خەينەن ئۆلكىسى	Hainan
رىمان	Bernhard Riemann
گەنسۇ ئۆلكىسى	Gansu
ئاق قان ھۈجەيرىسى	White blood cell
ئەنگلىيىلىكلەر	English people
ئاناتول فرانس	Anatole France
ئوتلاق ياۋا مۈشۈكى	African wildcat
جەينەك	Elbow
سۇجۇ شەھىرى	Suzhou
جاڭگال مولۇنى	Jungle cat
بېنگال مولۇنى تاغ مۈشۈكى	Leopard cat
Wénju shehiri	Wenzhou
ۋۇشى شەھىرى	Wuxi
Shawshin shehiri	Shaoxing
خەنزۇ مىللىتى	Han Chinese
نىڭبو شەھىرى	Ningbo
ئابدۇللاھ گۈل	Abdullah Gül
نېمىسلار	Germans
خاربىن شەھىرى	Harbin
Orkéstr	Orchestra
تۈرك قەھۋەسى	Turkish coffee
قىزىل ياقۇت	Ruby
كەشمىر	Kashmir
گالاتا ساراي	Galatasaray S.K.
كەۋىن رۇد	Kevin Rudd
يۈننەن ئۆلكىسى	Yunnan
مالكولم X	Malcolm X
مەۋلانا جالالىددىن رۇمى	Rumi
Plimowt	Plymouth
شەندۇڭ ئۆلكىسى	Shandong
قول	Arm
Dérbi	Derby
ياقۇت رەڭلىك	Emerald
كىرىستال	Crystal
خېنەن ئۆلكىسى	Henan
بۇرسا ۋىلايىتى	Bursa Province
ئارتۋىن ۋىلايىتى	Artvin Province
كىندىك	Navel
ئادىيامان ۋىلايىتى	Adıyaman Province
لياۋنىڭ ئۆلكىسى	Liaoning
خىمىيىلىك باغ	Chemical bond
GNU	GNU
توچىگى ناھىيىسى	Tochigi Prefecture
سېمونت	Cement
جىلىن ئۆلكىسى	Jilin
ئافيون قاراھىسار ۋىلايىتى	Afyonkarahisar Province
بېربېرلار	Berber people
ئېچىتقۇ	Yeast
خۇنەن ئۆلكىسى	Hunan
ھونلار	Huns
چىڭخەي ئۆلكىسى	Qinghai
ئۇيغۇر مىللىتى	Uyghur people
بىلەجىك ۋىلايىتى	Bilecik Province
خۇبېي ئۆلكىسى	Hubei
شەنشى ئۆلكىسى	Shanxi
يۈز	Cheek
قوڭۇر رەڭلىك	Brown
گۇيلىن ئۆلكىسى	Guizhou
بالىكەسىر ۋىلايىتى	Balıkesir Province
كيوتو كىلىشىمنامىسى	Kyoto Protocol
ئانىلار بايرىمى	Mother's Day
خەلقئارا ئىسلام كېڭىشى تەشكىلاتى	Organisation of Islamic Cooperation
چاناققالە ۋىلايىتى	Çanakkale Province
مىياگى ناھىيىسى	Miyagi Prefecture
Luknow	Lucknow
شېنشى ئۆلكىسى	Shaanxi
رىملىقلارغا يېزىلغان خەت	Epistle to the Romans
مالىكىي مەزھىبى	Maliki
ئوقۇغۇچى	Student
Kobe	Kobe
ئىۋاتە ناھىيىسى	Iwate Prefecture
كولۇمبىيە ئۇنىۋېرستېتى	Columbia University
بوستون ئۇنىۋېرستېتى	Boston University
يالې ئۇنىۋېرسىتېتى	Yale University
پېنسىلۋانىيە ئۇنىۋېرستېتى	University of Pennsylvania
Portland, Méané	Portland, Maine
نيۇيورك ئۇنىۋېرستېتى	New York University
ئىتاليانلار	Italians
پارىژ مېتروسى	Paris Métro
پىرىت	Pyrite
فىلىپىلىكلەرگە يېزىلغان خەت	Epistle to the Philippians
ئېگىزلىك گېرمان تىلى	High German languages
قېلىپ:Taxobox	Template:Taxobox
قارا ئېقىم	Kuroshio Current
خەلق گېزىتى	People's Daily
جياڭشى ئۆلكىسى	Jiangxi
ئىلھام ئالىيېۋ	Ilham Aliyev
زاردارى	Asif Ali Zardari
نۇرسۇلتان نازاربايېۋ	Nursultan Nazarbayev
نىڭشيا خۇيزۇ ئاپتونۇم رايونى	Ningxia
ئىسلام كەرىموۋ	Islam Karimov
شۈجو شەھىرى	Xuzhou
Lyenyün'gang shehiri	Lianyungang
ساۋكات مىرزىيويەۋ	Shavkat Mirziyoyev
خۇەيئەن شەھىرى	Huai'an
Yangjo shehiri	Yangzhou
Teyju shehiri, Jyangsu	Taizhou, Jiangsu
Nentung shehiri	Nantong
جاڭجياڭ شەھىرى	Zhenjiang
چاڭجو شەھىر	Changzhou
ئەھمەد داۋۇد ئوغلۇ	Ahmet Davutoğlu
تەيجۇ شەھىرى	Taizhou, Zhejiang
جۇشەن شەھىرى	Zhoushan
شىجياجۇاڭ شەھىرى	Shijiazhuang
تاڭشەن شەھىرى	Tangshan
Chinxuangdaw shehiri	Qinhuangdao
خەندەن شەھىرى	Handan
Bawding shehiri	Baoding
پەنجاب تىلى	Punjabi language
پاشتوچە	Pashto language
ساڭجو شەھىرى	Cangzhou
Langfang shehiri	Langfang
Juxey shehiri	Zhuhai
شەنتۇ شەھىرى	Shantou
Xuyjo shehiri	Huizhou
Dongwen shehiri	Dongguan
Jongshen shehiri	Zhongshan
مىقدار سۆز	Numeral (linguistics)
ئۆت خالتىسى	Gallbladder
Jaypur	Jaipur
فۇجو شەھىرى	Fuzhou
Nenping shehiri	Nanping
Putyen shehiri	Putian
Senming shehiri	Sanming
Chüenju shehiri	Quanzhou
شيامېن شەھىرى	Xiamen
Jyangju shehiri	Zhangzhou
Longyen shehiri	Longyan
Ningdé shehiri	Ningde
Shining shehiri	Xining
تاغىل سېسىق كۈزەن	Marbled polecat
ئادەم ئەلەيھىسسالام	Adam
خۇئاڭشى شەھىرى	Huangshi
ئائومورى ناھىيىسى	Aomori Prefecture
فۇكۇشىما ناھىيىسى	Fukushima Prefecture
تەييۈەن شەھىرى	Taiyuan
داتۇڭ شەھىر	Datong
داليەن شەھىرى	Dalian
ئەنشەن شەھىرى	Anshan
يىڭكۇ شەھىرى	Yingkou
لياۋياڭ شەھەر	Liaoyang
يوزگات ۋىلايىتى	Yozgat Province
چوڭ مېڭە پوستلاق ماددىسى	Cerebral cortex
ئوڭچى	Right-wing politics
كارل ۋون دونىتىز	Karl Dönitz
سۆسۈنە ياقۇت	Amethyst
بىنگۆل ۋىلايىتى	Bingöl Province
تايغان بۇغا	Red deer
ئارداھان ۋىلايىتى	Ardahan Province
ئايدىن ۋىلايىتى	Aydın Province
ئاماسيا ۋىلايىتى	Amasya Province
قازاق مىللىتى	Kazakhs
ئاغرى ۋىلايىتى	Ağrı Province
بۇردۇر ۋىلايىتى	Burdur Province
كورىنتلىقلارغا يېزىلغان بىرىنچى خەت	First Epistle to the Corinthians
باتمان ۋىلايىتى	Batman Province
كۇرىل ئاراللىرى	Kuril Islands
يېڭى يەر	Novaya Zemlya
Patna	Patna
سۇلتان ئاخمەت جامىي	Sultan Ahmed Mosque
ۋان ۋىلايىتى	Van Province
كونيا ۋىلايىتى	Konya Province
ئاكىتا ناھىيىسى	Akita Prefecture
سېگولەن رويال	Ségolène Royal
بولۇ ۋىلايىتى	Bolu Province
دېنىزلى ۋىلايىتى	Denizli Province
شافىئىي مەزھىپى	Shafi'i
گىپىس	Gypsum
ئېڭەك	Chin
ئامېرىكا ياۋا كالىسى	American bison
Léyséstér	Leicester
ساكاريا ۋىلايىتى	Sakarya Province
ئاقساراي ۋىلايىتى	Aksaray Province
قارس ۋىلايىتى	Kars Province
دىيارباقىر ۋىلايىتى	Diyarbakır Province
مور	Mushroom
تەيبېي 101	Taipei 101
ئەدىرنە ۋىلايىتى	Edirne Province
ظوسذث	Lettuce
بىتلىس ۋىلايىتى	Bitlis Province
ئىباراكى ناھىيىسى	Ibaraki Prefecture
ھاتاي ۋىلايىتى	Hatay Province
زىيا گۆكئالىپ	Ziya Gökalp
پان تۈركىزم	Pan-Turkism
يۇگوسلاۋىيە سوتسىيالىست فېدېرال جۇمھۇرىيىتى	Socialist Federal Republic of Yugoslavia
تۈرك	Turkic peoples
بارتىن ۋىلايىتى	Bartın Province
باش بارماق	Thumb
كوجائەلى ۋىلايىتى	Kocaeli Province
تۈرك خاقانلىقى	Turkish people
سازاڭسىمان مەددە	Caenorhabditis elegans
چاڭچۈن شەھىرى	Changchun
جىلىن شەھىرى	Jilin City
ئېمۇ قۇشى	Emu
خاككارى ۋىلايىتى	Hakkâri Province
راۋالپىندى	Rawalpindi
Emir Kusturica	Emir Kusturica
ماشىنىىسازلىق ئىنژىنىرلىقى	Mechanical engineering
ئاينۇ مىللىتى	Ainu people
ئورانگوتان	Ape
يېشىل ياقۇت	Beryl
Markus bayan qilghan xush xewer	Gospel of Mark
ئازۇرىت	Azurite
بېلىز شەھىرى	Belize City
قۇشۇق ئارىلى	Kaşık Island
مارشال	Marshal
Chuju shehiri	Chuzhou
Rékazé shehiri	Samzhubzê District
قىرىم	Crimean Tatars
كىلون تېخنىكىسى	Cloning
پروڧېسسور	Professor
كورىنتلىقلارغا يېزىلغان ئىككىنچى خەت	Second Epistle to the Corinthians
مۇغلا ۋىلايىتى	Muğla Province
ئاسىيا قارا ئېيىق	Asian black bear
گۈلچىلىك	Gardening
ئىغدىر ۋىلايىتى	Iğdır Province
ياماگاتا ناھىيىسى	Yamagata Prefecture
قاڭشارلىق بۆكەن	Saiga antelope
كۈتاھيا ۋىلايىتى	Kütahya Province
كۆك ياقۇت	Sapphire
كۈرەشچى ئايروپىلان	Fighter aircraft
ئېرتىش دەرياسى	Irtysh River
ئىبرانىيلارغا يېزىلغان خەت	Epistle to the Hebrews
گالاتىيلىقلارغا يېزىلغان خەت	Epistle to the Galatians
شاڭ سۇلالىسى	Shang dynasty
كىلىس ۋىلايىتى	Kilis Province
تەكىرداغ ۋىلايىتى	Tekirdağ Province
سان	Thigh
مانىسا ۋىلايىتى	Manisa Province
كىچىك مېڭە	Cerebellum
كولوسىلىقلارغا يېزىلغان خەت	Epistle to the Colossians
ياقۇپ يازغان خەت	Epistle of James
يۇھاننا يازغان بىرىنچى خەت	First Epistle of John
فىلىمۇنغا يېزىلغان خەت	Epistle to Philemon
سالونىكىلىقلارغا يېزىلغان ئىككىنچى خەت	Second Epistle to the Thessalonians
پاۋىل كرۇگمەنن	Paul Krugman
سالونىكىلىقلارغا يېزىلغان بىرىنچى خەت	First Epistle to the Thessalonians
پېترۇس يازغان بىرىنچى خەت	First Epistle of Peter
پېترۇس يازغان ئىككىنچى خەت	Second Epistle of Peter
تىموتىيغا يېزىلغان بىرىنچى خەت	First Epistle to Timothy
ئېسكىموسلار	Eskimo
چىكاگو ئۇنىۋېرستېتى	University of Chicago
ماردىن ۋىلايىتى	Mardin Province
مالاتيا ۋىلايىتى	Malatya Province
مۇش ۋىلايىتى	Muş Province
يۇھاننا يازغان ئىككىنچى خەت	Second Epistle of John
يۇھاننا يازغان ئۈچىنچى خەت	Third Epistle of John
يەھۇدا يازغان خەت	Epistle of Jude
تىموتىيغا يېزىلغان ئىككىنچى خەت	Second Epistle to Timothy
تىتۇسغا يېزىلغان خەت	Epistle to Titus
قىرقلارەلى ۋىلايىتى	Kırklareli Province
ئاليۇمىن ئوكسىدى	Corundum
مەرسىن ۋىلايىتى	Mersin Province
ئوتتۇرا ئاسىيا ياۋا تۆگىسى	Bactrian camel
بۇشەھر ۋىلايىتى	Bushehr Province
تەكلىماكان قۇملۇقى	Taklamakan Desert
پاچاق	Leg
قاشقىئوغلاق	Raccoon dog
ئاشمورە ۋە كارتىئەر ئاراللىرى	Ashmore and Cartier Islands
قىرشەھەر ۋىلايىتى	Kırşehir Province
ئەردەبىل ۋىلايىتى	Ardabil Province
سىنوپ ۋىلايىتى	Sinop Province
Ajax	Ajax (programming)
ئاتىلار بايرىمى	Father's Day
شۆلگەي بېزى	Salivary gland
سېرىق قاشتېشى	Topaz
بىھارى تىلى	Bihari languages
Teynen shehiri	Tainan
ۋىتامىنE	Vitamin E
سۇلتان توغرۇلبەگ	Tughril
Xéngyang shehiri	Hengyang
مالاي ئېيىقى	Sun bear
زامان گېزىتى	Zaman (newspaper)
مانجۇ مىللىتى	Manchu people
تېرەك	Populus tremula
ھېيدېلبېرگ ئۇنىۋېرستېتى	Heidelberg University
سۇلايمان دېمىرەل	Süleyman Demirel
ۋەيران بولۇش	Bankruptcy
ج.ۋىللارد گىببس	Josiah Willard Gibbs
پۇت بارمىقى	Toe
نىغدە ۋىلايىتى	Niğde Province
ئوتتۇرا ئاناتولىيە رايونى	Central Anatolia Region
قارا دېڭىز رايونى	Black Sea Region
شەرقىي ئاناتولىيە رايونى	Eastern Anatolia Region
يەر ئوتتۇرا دېڭىزى رايونى	Mediterranean Region, Turkey
ئېگېي رايونى	Aegean Region
مارمارا رايونى	Marmara Region
شەرقىي جەنۇبىي ئاناتولىيە رايونى	Southeastern Anatolia Region
لېيدېن ئۇنىۋېرستېتى	Leiden University
مېڭە ئاستى بېزى	Pituitary gland
تۈر:سىياسىي جۇغراپىيە	Geopolitics
مۇرادئۈچ	Murad III
ئىدىنبۇرگ ئۇنىۋېرستېتى	University of Edinburgh
فارابى	Al-Farabi
كۆك قۇتان	Purple heron
گەۋدە	Torso
ياپونىيىلىك	Japanese people
پامىر ئېگىزلىكى	Pamir Mountains
تولۇق كۇرس	Bachelor's degree
تۆش بېزى	Thymus
دۆڭچە مېڭىنىڭ ئاستى	Hypothalamus
ئېلېكتر سىغىمى	Capacitance
يېشىل تاش	Malachite
سولچى	Left-wing politics
چاناق قەلئە ئۇرۇشى	Gallipoli Campaign
بىريۇزا(ياقۇت)	Turquoise
ئەخمەت نەدجەت سەزەر	Ahmet Necdet Sezer
ۋيېنا ئۇنىۋېرسىتېتى	University of Vienna
توشقانسىمان سۈلەيسۈن	Pallas's cat
ئافيون قاراھىسار	Afyonkarahisar
ئوتتۇرا بارماق	Middle finger
ئەبۇ مۇسا جابىر بىن ھەييام	Jābir ibn Hayyān
ئوشۇق	Ankle
ئادىياما	Adıyaman
تاغ ئۆچكىسى	Alpine ibex
پەنجاب	Punjab region
شىيا سۇلالىسى	Xia dynasty
باشكەنت ئۇنىۋېرستېتى	Başkent University
جىنەن شەھىرى	Jinan
يول بەلگىسى	Traffic sign
چىڭداۋ شەھىرى	Qingdao
كالسېدونىيە	Chalcedony
ئاسىيا تېنچ ئوكيان ئىقتىسادىي ھەمكارلىق تەشكىلاتى	Asia-Pacific Economic Cooperation
Glutséstér	Gloucester
قەشقەر شەھرى	Kashgar
ئىلام ۋىلايىتى	Ilam Province
نەنچاڭ شەھىرى	Nanchang
بېشىكتاش گىمناستىكا كۇلۇبى	Beşiktaş J.K.
تۈرك لىراسى	Turkish lira
ئۆچكە	Capra (genus)
بورمودىلى	Bohr model
ھەزىم يولى	Esophagus
چاڭشا شەھىر	Changsha
ئۆكچە	Heel
كېكىردەك	Pharynx
ئۇيغقاشتېشى	Jade
ۋىتامىن D	Vitamin D
قۇتۇبى ناھىيىسى	Hutubi County
2010 دۇنيا لوڭقىسى	2010 FIFA World Cup
نەسىرىدىن ئەپەندى	Nasreddin
سۇلايمانىيە جامىى	Süleymaniye Mosque
كاۋاپ	Kebab
Wéstminstér Shehiri	City of Westminster
نەننىڭ شەھىرى	Nanning
Durham	Durham, England
تۇرغۇت ئۆزال	Turgut Özal
ﮔﺎﮔﺎﯞﯗﺯ	Gagauz people
بادام بەز	Tonsil
مۇھەممەد خاتەمى	Mohammad Khatami
تورونتو ئۇنىۋېرستېتى	University of Toronto
ساردونىكس	Onyx
تروچكىزم	Trotskyism
ياڭ جىننىڭ	Chen-Ning Yang
Gawshyung	Kaohsiung
بىرىكمە ماتېرىيال	Composite material
مېڭە غولى	Brainstem
تاموژنا	Customs
كۈنمىڭ شەھىرى	Kunming
ۋىتامىنB	B vitamins
ئىسمەت ئىنۆنۈ	İsmet İnönü
مارگارېت ئاتۋود	Margaret Atwood
خۇيزۇ مىللىتى	Hui people
لەنجۇ شەھىرى	Lanzhou
Halva	Halva
لى جىڭداۋ	Tsung-Dao Lee
ماگىستىر	Master's degree
كۆرسەتكۈچ بارماق	Index finger
ئوتتۇرا مېڭە	Midbrain
ئۇپسالا ئۇنىۋېرستېتى	Uppsala University
Multan	Multan
خېفېي شەھىر	Hefei
ھىيلە	Wrist
ئىپار مۈشۈك ئائىلىسى	Viverridae
ئارقار	Argali
كوپېنھاگېن ئۇنىۋېرستېتى	University of Copenhagen
قارساق	Corsac fox
لوياڭ شەھىرى	Luoyang
زئەكئى مئۈرئەن	Zeki Müren
كۇئېنلۇن تاغ تىزمىسى	Kunlun Mountains
تىبەت مىللىتى	Tibetan people
لوندون ئىمپېرىيە ئىنستېتۇت	Imperial College London
يىلىك	Medulla oblongata
گۇيلىن شەھىرى	Guilin
گېئوتىت	Goethite
Xeyko shehir	Haikou
مولتىمىتىر	Multimeter
مەركىزىي مىللەتلەر ئۇنىۋېرسىتېتى	Minzu University of China
چىپار بۇغا	Sika deer
بەل	Limb (anatomy)
يۇگوسلاۋىيە پادىشاھلىقى	Kingdom of Yugoslavia
ئېۋېنكى مىللىتى	Evenks
راھىبە	Nun
سېرىق ياۋا مۈشۈك	Asian golden cat
گۇيياڭ شەھىرى	Guiyang
نامسىز بارماق	Ring finger
لىمبىك سىستېما	Limbic system
تۇرپان	Turpan
ئىلى دەرياسى	Ili River
مېڭە كۆۋرۈكى	Pons
دەريا بۇغىسى	Water deer
ﺑﺎﻟﻘﺎﺭ ﻣﯩﻠﻠﯩﺘﻰ	Balkars
ﻧﻮﻏﺎﻱ ﻣﯩﻠﻠﯩﺘﻰ	Nogais
كالا گۆشى	Beef
گلاسگوۋ ئۇنىۋېرستېتى	University of Glasgow
توخارلار	Tocharians
ئابادە	Abadeh
ئىستانبۇل ئۇنىۋېرسىتېتى	Istanbul University
Tuwa	Tuvans
بۇرما مۈڭگۈزلۈك بۆكەن	Takin
ئېلېكترون قەۋەت	Electron shell
مۇھەررىر	Editing
مىكروسكوپ	Microscope
كېمىنىڭ يان تىرەكلىرى	Rib
جاڭ خىڭ	Zhang Heng
جاڭ چيەن	Zhang Qian
موڭغۇلكۈرە ناھىيىسى	Zhaosu County
Juko shehiri	Zhoukou
جۇگىلىياڭ	Zhuge Liang
زىبو شەھىرى	Zibo
ۋىتامىن C	Vitamin C
سۇلتان ئالىپ ئارىسلان	Alp Arslan
گوللاندىيىلىكلەر	Dutch people
مەن، ماشىنا ئادەم (كىنو)	I, Robot (film)
جۇڭخۇا خەلق جۇمھۇرىيىتىنىڭ ئاساسىي قانۇنى	Constitution of the People's Republic of China
قاشتېشى	Jasper
تگرین اعظم	Tigranes the Great
كۆكمۇچ	Capsicum
چۆل مۈشۈكى	Chinese mountain cat
جۇڭگو شىنخۇا ئاگېنتلىقى	Xinhua News Agency
Lankastér	Lancaster, Lancashire
لىجياڭ شەھىرى	Lijiang
چىچىخار شەھىرى	Qiqihar
گەبزە	Gebze
ئەلنى ئىدارە قىلىشقا پايدىلىق ئومۇمىي ئۆرنەكلەر	Zizhi Tongjian
ئۇزۇن قۇيرۇق بۇغا	Père David's deer
سېرىق تەنلىكلەر	Mongoloid
Keyféng shehiri	Kaifeng
پارىژ ئۇنىۋېرسىتىتى	University of Paris
مياۋزۇ مىللىتى	Miao people
بېيخەي شەھىرى	Beihai
يەنتەي شەھىرى	Yantai
ﻗﯘﻣﯩﻖ	Kumyks
يىنچۈئەن شەھىرى	Yinchuan
سەئىد قۇتوب	Sayyid Qutb
ئېيقسىمان ئىپار مۈشۈك	Binturong
ئامستېردام ئۇنىۋېرستېتى	University of Amsterdam
دۇڭزۇ مىللىتى	Dong people
تارىم ئويمانلىقى	Tarim Basin
بۈيۈك ئويۇن	The Great Game
لازۇرىت	Lapis lazuli
قاراماي يۇقىر سۇرئەتلىك يولى	Karakoram Highway
داغۇر مىللىتى	Daur people
ساكاريا دەرياسى	Sakarya River
ﺭﺍﺩﯨﺸﺸﯧﯟ	Alexander Radishchev
ئوۋتېز	Joyce Carol Oates
مۇدەنجياڭ شەھىرى	Mudanjiang
ناشى مىللىتى	Nakhi people
ۋاشىنگتون ئۇنىۋېرستېتى	University of Washington
زونگۇلداق ۋىلايىتى	Zonguldak Province
سېرىق بوغۇز بولغۇن	Yellow-throated marten
شىزاڭ ياۋا ئېشىكى	Kiang
بىرمىنگام ئۇنىۋېرستېتى	University of Birmingham
چىمەلتەك	Little finger
بىلەك	Forearm
ماتېرىيال ئىلمى	Materials science
ھەنبەلىي مەزھىبى	Hanafi
سەي لۇن	Cai Lun
قوڭۇر بۇغا	Sambar deer
مىچىگان ئۇنىۋېرستېتى	University of Michigan
ئىرۇسالىمغا قايتىش ھەركىتى	Back to Jerusalem movement
ﺋﺎﻗﺴﺎﻱ ﭼﯩﻦ	Aksai Chin
مانچېستېر ئۇنىۋېرستېتى	University of Manchester
ئىككىنچى مەشرۇتىيەت	Second Constitutional Era
تارپان	Tarpan
امينة ساندال	Emina Jahović
ئاق تەنلىكلەر	White people
تارىم دەرياسى	Tarim River
مىننېسوتا ئۇنىۋېرستېتى	University of Minnesota
فۇكاڭ شەھىرى	Fukang
ئورخان پامۇك	Orhan Pamuk
ئەرتۇغرۇل غازى	Ertuğrul
ﻗﺎﺭﺍ ﭼﺎﻱ ﻣﯩﻠﻠﯩﺘﻰ	Karachays
نەجمەتتىن ئەرباقان	Necmettin Erbakan
ﺋﺎﻟﺘﺎﻱ مىللىتى	Altai people
Teyjong shehiri	Taichung
ﻛﺎﺷﻜﺎﻱ	Qashqai people
مىللەتچى ھەركەت پارتىيىسى	Nationalist Movement Party
ھەيبەلى ئارىلى	Heybeliada
ﭼﯘﯞﺍﺵ ﻣﯩﻠﻠﯩﺘﻰ	Chuvash people
گيېموسخۇس بۇغىسى	Water chevrotain
ئىسپارتا ۋىلايىتى	Isparta Province
قوڭۇر يىلپىز	Neofelis
چىقچىق	Little crake
سېرىق ئاغمىخان	Siberian weasel
شىزاڭ بۆكىن	Tibetan antelope
چانقىرى ۋىلايىتى	Çankırı Province
چورۇم ۋىلايىتى	Çorum Province
ئىران ئەزەربەيجان	Azerbaijan (Iran)
تۈركىيە بۈيۈك مىللەت مەجلىسى	Grand National Assembly of Turkey
بەيزۇ مىللىتى	Bai people
ﻗﺎﺭﺍ ﻗﺎﻟﭙﺎﻕ ﻣﯩﻠﻠﯩﺘﻰ	Karakalpaks
ئوسمانىيە ۋىلايىتى	Osmaniye Province
تۇرپان ئويمانلىغى	Turpan Depression
1.خاتىرەمدىكى ئامېرىكا	ABC News
Putbol	Football (disambiguation)
رابىيە قادىر	Rebiya Kadeer
سەزەن ئاقسۇ	Sezen Aksu
جاندان ارچتین	Candan Erçetin
ۋەن مارۋىجىك	Bert van Marwijk
Hidayet Türkoghli	Hedo Türkoğlu
داچىڭ شەھىر	Daqing
ئۆزگۈ نامال	Özgü Namal
لىزۇ مىللىتى	Li people
سۇلتان مەلىك شاھ	Malik-Shah I
مەھمەت ئەلىي تالات	Mehmet Ali Talat
ئابدۇراخمان جامى	Jami
مېلبۇرن ئۇنىۋېرستېتى	University of Melbourne
Dünxuang Shehiri	Dunhuang
لوپنۇر	Lop Nur
Senya shehiri	Sanya
Dostum	Abdul Rashid Dostum
ئەكمەلىتتىن ئىھسان ئوغلۇ	Ekmeleddin İhsanoğlu
مۇستاپا ساندال	Mustafa Sandal
تاغ بورسۇقى	Chinese ferret-badger
ئۈرۈمچى ناھىيىسى	Ürümqi County
سالار مىللىتى	Salar people
كيوتو ئۇنىۋېرستېتى	Kyoto University
بادام؛بادام؛بادام	Amygdala
ئىستانبۇل تېخنىكا ئۇنىۋېرسىتېتى	Istanbul Technical University
ئىزمىر ۋىلايىتى	İzmir Province
ئاد قەۋمى	ʿĀd
بۇغدىيەك	Adam's apple
بېڭبۇ شەھەرى	Bengbu
خۇەينەن شەھىرى	Huainan
مائەنشەن شەھىرى	Ma'anshan
ئەنچىڭ شەھىرى	Anqing
ياۋزۇ مىللىتى	Yao people
كرىستىن دەلفى	Christine Delphy
ئەرزۇرۇم ۋىلايىتى	Erzurum Province
روبوتلار ۋە ئىمپىرىيە	Robots and Empire
يۇنۇس ئەمرە	Yunus Emre
بىلگە قاغان	Bilge Khagan
باتۇر تەڭرىقۇت	Modu Chanyu
پرژىۋالسكى بۆكىنى	Przewalski's gazelle
ئەپراسىياپ	Afrasiab
يېڭى تاڭنامە	New Book of Tang
سۇلتان بەكيارۇق	Barkiyaruq
شانلى ئۇرفا ۋىلايىتى	Şanlıurfa Province
شهرزاد	Şehrazat
ترابزون ۋىلايىتى	Trabzon Province
كىليوس	Kilyos
برىتانى كولۇمبىيە ئۇنىۋېرستېتى	University of British Columbia
Metta bayan qilghan xush xewer	Gospel of Matthew
ئەلبورز ۋىلايىتى	Alborz Province
خوجا ئەھمەد يەسەۋى	Khoja Akhmet Yassawi
Tekshi choqqiliq tagh shehiri	Pingdingshan
شىنشياڭ شەھىرى	Xinxiang
Nenyang shehiri	Nanyang, Henan
Shinyang shehiri	Xinyang
ئەفەسلىكلەرگە يېزىلغان خەت	Epistle to the Ephesians
زەمچە	Potassium alum
ﺋﯩﻜﻜﯩﻨﭽﻰ ﻗﯩﺘﯩﻤﻠﯩﻖ ﯬﭘﻴﯘﻥ ﯰﺭﯗﺷﻰ	Second Opium War
ئاقچى ناھىيىسى	Akqi County
بۇغا	Cerf
ئاقسۇ ۋىلايىتى	Aksu Prefecture
ئاقسۇ شەھىرى	Aksu, Xinjiang
ئاقسۇ دەرياسى	Aksu River (Xinjiang)
تېتراپىررول	Tetrapyrrole
ئاقتو ناھىيىسى	Akto County
ميەنياڭ شەھىرى	Mianyang
ھلا رەڭ	Pink
نەۋشەھەر ۋىلايىتى	Nevşehir Province
نازارې	Nazareth
سۇماترا بۆكىنى	Sumatran serow
راۋاپ	Rawap
دۈزجە ۋىلايىتى	Düzce Province
ئالتاي شەھىرى	Altay City
سۈبھىدىكى روبوتلار	The Robots of Dawn
قۇندۇز ئۇرۇقدىشى	Lutra
مەلىكە ئاماننىساخان	Amannisa Khan
بەشىكتاش	Beşiktaş
برىستول ئۇنىۋېرستېتى	University of Bristol
ئاق بوغۇز بۆكەن	Goitered gazelle
يىزۇ مىللىتى	Yi people
روزا ھېيت	Eid al-Fitr
كۆكمەت	Bharal
شېڭ شىسەي	Sheng Shicai
بۈلەنت ئەرسوي	Bülent Ersoy
يالىڭاچ قۇياش	The Naked Sun
نوتتىڭخام ئۇنىۋېرستېتى	University of Nottingham
تايلاندلىقلار	Thai people
تۈركىيە جۇمھۇريىتى باش مىنىستىرى	List of Prime Ministers of Turkey
نەمەنگان ۋىلايىتى	Namangan Region
ھانى مىللىتى	Hani people
پولات قەلئەلەر	The Caves of Steel
گىرەسۇن ۋىلايىتى	Giresun Province
گۈمۈشخانە ۋىلايىتى	Gümüşhane Province
سىئىرت ۋىلايىتى	Siirt Province
قاھرامان ماراش ۋىلايىتى	Kahramanmaraş Province
ئومۇرتقا	Vertebral column
قارامان ۋىلايىتى	Karaman Province
سامسۇن ۋىلايىتى	Samsun Province
ئۆزبېك مىللىتى	Uzbeks
ئەسكىشەھەر ۋىلايىتى	Eskişehir Province
بايبۇرت ۋىلايىتى	Bayburt Province
ئۇشاق ۋىلايىتى	Uşak Province
يالوۋا ۋىلايىتى	Yalova Province
ئەلازىغ ۋىلايىتى	Elazığ Province
سىۋاس ۋىلايىتى	Sivas Province
غازى ئانتەپ ۋىلايىتى	Gaziantep Province
قارابۈك ۋىلايىتى	Karabük Province
ئەرزىنجان ۋىلايىتى	Erzincan Province
ئوردۇ ۋىلايىتى	Ordu Province
كاستامونۇ ۋىلايىتى	Kastamonu Province
توقات ۋىلايىتى	Tokat Province
نورۇز بايرىمى	Nowruz
كايسەرى ۋىلايىتى	Kayseri Province
رىزە ۋىلايىتى	Rize Province
تاجىك مىللىتى	Tajik people
مۇھەممەد ئىقبال	Muhammad Iqbal
پارسلار	Persian people
قاراقالپاقىستان	Karakalpakstan
قىرىققالە ۋىلايىتى	Kırıkkale Province
قىرغىز مىللىتى	Kyrgyz people
شاڭخەي ھەمكارلىق تەشكىلاتى	Shanghai Cooperation Organisation
تۈركىيە دەرىجىدىن تاشقىرى ئايلانمىسى	Süper Lig
تاركان	Tarkan (singer)
ﻳﺎﻗﯘﺕ ﻣﯩﻠﻠﯩﺘﻰ	Yakuts
فەرغانە ئويمانلىقى	Fergana Valley
فەرغانە	Fergana
Kanzas Shehiri, Kanzas	Kansas City, Kansas
پەرغانە ۋىلايىتى	Fergana Region
بۇخارا ۋىلايىتى	Bukhara Region
ئەنجان ۋىلايىتى	Andijan Region
سەمەرقەنت ۋىلايىتى	Samarqand Region
سۇرخاندەريا ۋىلايىتى	Surxondaryo Region
چاغاتاي خان	Chagatai Khan
سىردەريا ۋىلايىتى	Sirdaryo Region
سىدنېي ئۇنىۋېرستېتى	University of Sydney
خارەزىم ۋىلايىتى	Xorazm Region
نەۋايى ۋىلايىتى	Navoiy Region
قاشقادەريا ۋىلايىتى	Qashqadaryo Region
تاشكەنت ۋىلايىتى	Tashkent Region
ئانا ۋەتەن پارتىيىسى	Motherland Party (Turkey)
جىزاق ۋىلايىتى	Jizzakh Region
ئاۋكلاند ئۇنىۋېرستېتى	University of Auckland
قاراخانىيلار خانلىقى	Kara-Khanid Khanate
چىپار بۆكەن	Himalayan goral
ئوغۇزلار	Oghuz Turks
كۆمۈرچەك	Cartilage
ئەلشىر ناۋائى	Ali-Shir Nava'i
جەنۋە ئۇنىۋېرستېتى	University of Geneva
قىزىل تاغ	Flaming Mountains
تارىم توشقىنى	Yarkand hare
Openoffice	OpenOffice.org
قۇربان ھېيت	Eid al-Adha
تىمساھ	Alligator
ئىستانبۇل ۋىلايىتى	Istanbul Province
Kökxot shehiri	Hohhot
بەزگە مۇناسىۋەتلىك	Adenoid
ياقۇب بەگ	Yaqub Beg
يەكەن دەرياسى	Yarkand River
مەھمۇد قەشقىرى	Mahmud al-Kashgari
باۋتۇ شەھىر	Baotou
ھېنرىخ ھېينى مۇكاپاتى	Heinrich Heine Prize
كۈنەس ناھىيىسى	Künes County
سوغدى يېزىقى	Sogdian alphabet
كىنالى ئارىلى	Kınalıada
رومبىسىمان كرىستال كاتەكچىسى	Trigonal crystal system
تۇجيا مىللىتى	Tujia people
توقسۇن ناھىيىسى	Toksun County
تېھران ۋىلايىتى	Tehran Province
تۆش	Thorax
موناش ئۇنىۋېرستېتى	Monash University
كىچىك مونتياك	Hairy-fronted muntjac
ئۇلترا ئۆتكۈزگۈچ	Superconductor classification
بوکان	Bukan
رېگان ئىقتىسادشۇناسلىقى	Reaganomics
ئۆركەش دۆلەت	Wu'erkaixi
ئۇلۇغچات ناھىيىسى	Ulugqat County
دۇلۇڭ مىللىتى	Derung people
تۇنجەلى ۋىلايىتى	Tunceli Province
ئارال شەھرى	Aral, Xinjiang
خوتەن دەرياسى	Hotan River
چىپار يۈز قوڭغارچا	Masked palm civet
ئارا تۈرۈك ناھىيىسى	Yiwu County
مۇز تاغ ئاتا	Muztagh Ata
قابا ناھىيىسى	Habahe County
ئالبېرتا ئۇنىۋېرستېتى	University of Alberta
قوي گۆشى	Lamb and mutton
چەرچەن ناھىيىسى	Qiemo County
تارباغاتاي ۋىلايىتى	Tacheng Prefecture
قوڭۇر تاغ	Kongur Tagh
خەينە بۇغىسى	Eld's deer
شىرناق ۋىلايىتى	Şırnak Province
چۆچەك شەھىرى	Tacheng
قالقانسىمان يان بەز	Parathyroid gland
قۇمۇل شەھىرى	Hami City
ئوساكا ئۇنىۋېرستېتى	Osaka University
ﺗﻮﻓﺎ ﻣﯩﻠﻠﯩﺘﻰ	Tofalar
قاراماي شەھىرى	Karamay
ئاتۇش شەھىرى	Artux
ئارىشاڭ ناھىيىسى	Wenquan County
بۇيى مىللىت	Bouyei people
سۈلەيسۈن	Lynx
سەدەف ئارىلى	Sedef Island
تارماشىرىن	Tarmashirin
نان	Naan
سېرىق مۇنتجاك بۇغىسى	Reeves's muntjac
دۇنيا ئۇيغۇر قۇرۇلتىيى	World Uyghur Congress
بۆرەك ئۈستى بېزى	Adrenal gland
لىمفا ئىشلەپچىقىرىدىغان	Lymphatic system
يانپاش	Pelvis
ISO 639-1	ISO 639-1
چوسون مىللىتى	Koreans in China
تەيۋەن بۆكىنى	Taiwan serow
جاڭ چۈنشيەن	Zhang Chunxian
ۋاڭ لېچۈەن	Wang Lequan
ISO 639-2	ISO 639-2
يۇڭ تاجلىق بۇغا	Tufted deer
ھىمالايا چۇپۇرلۇق قويى	Himalayan tahr
ئاق تۇمشۇق بۇغا	Thorold's deer
ئۇرال - ئالتاي تىللىرى سېستىمىسى	Ural–Altaic languages
جەم يىلماز	Cem Yılmaz
تيېرى مېيىسسان	Thierry Meyssan
شېزۇ مىللىتى	She people
قەشقەر ۋىلايىتى	Kashgar Prefecture
نەي	Ney
تىن تىننىڭ سەرگۈزەشتىلىرى	The Adventures of Tintin
يوپۇرغا ناھىيىسى	Yopurga County
دۇڭشياڭ مىللىتى	Dongxiangs
XMCD	X-ray magnetic circular dichroism
لاخۇ مىللىتى	Lahu people
بازا	Foundation (Isaac Asimov novel)
قارىقۇيرۇق	Mongolian gazelle
چوڭ ئىپار مۈشۈك	Large Indian civet
مەكىت ناھىيىسى	Makit County
ئۈرۈمچى دىۋوپۇ خەلقئارا ئايروپورتى	Ürümqi Diwopu International Airport
ئالتاي ۋىلايىتى	Altay Prefecture
نەگۈبەئى	Negübei
ۋۇجياچۈ شەھىرى	Wujiaqu
ئاۋات ناھىيىسى	Awat County
ئايدىڭكۆل	Ayding Lake
بابۇر	Babur
جەرەنبۇلاق رايونى	Baijiantan District
باركۆل قازاق ئاپتونوم ناھىيىسى	Barköl Kazakh Autonomous County
باي ناھىيىس	Baicheng County
بايىنغولىن موڭغۇل ئاپتونوم ئوبلاستى	Bayingolin Mongol Autonomous Prefecture
بونان مىللىتى	Bonans
قارا تەنلىكلەر	Black people
ئورخۇن ئۇيغۇر خانلىقى	Uyghur Khaganate
بورىس ۋاسىلىيىۋ	Boris Vasilyev (writer)
كورلا شەھىرى	Korla
بازا ۋە ئىمپىرىيە	Foundation and Empire
دەيزۇ مىللىتى	Dai people
مېنبا مىللىتى	Monpa people
شەرقىي تۈركىستان	East Turkestan
چياڭزۇ مىللىتى	Qiang people
ۋازۇ مىللىتى	Wa people
5-ئىيۇل ۋەقەسى	July 2009 Ürümqi riots
تاجىسىمان يۇرەك قان تومۇر كېسىلى	Coronary artery disease
ISO 639-3	ISO 639-3
شىمالىي ئامېرىكىلىق	Americans
ئىلى قازاق ئاپتونوم ۋىلايىتى	Ili Kazakh Autonomous Prefecture
قىز مۇنارى	Maiden's Tower
شىخەنزە شەھىرى	Shihezi
دوكتور ئاسپرانتى	Doctorate
ئاچاڭ مىللىتى	Achang people
تۇزۇ مىللىتى	Monguor people
ئېگىز تاغ بۆكىنى	Goa (antelope)
ئىككىنچى بازا	Second Foundation
لوبا مىللىتى	Lhoba people
يەكەن ناھىيىسى	Yarkant County
لىسۇ مىللىتى	Lisu people
QQ	Tencent QQ
تېڭشۈن شىركىتى	Tencent
قىزىلسۇ قىرغىز ئاپتونوم ئوبلاستى	Kizilsu Kirghiz Autonomous Prefecture
بىلكەنت ئۇنىۋېستېتى	Bilkent University
كۋېنسلاند ئۇنىۋېرستېتى	University of Queensland
غۇلجا شەھىرى	Yining City
نۇزۇ مىللىتى	Nu people
مۇلاۋ مىللىتى	Mulao people
تۇرپان ۋىلايىتى	Turpan Prefecture
Néwkastl Undérlim	Newcastle-under-Lyme
تۇڭگان مىللىتى	Dungan people
بورتالا موڭغۇل ئاپتونوم ئوبلاستى	Bortala Mongol Autonomous Prefecture
ﺷﻮﺭ ﻣﯩﻠﻠﯩﺘﻰ	Shors
پۇمى مىللىتى	Pumi people
قئارئاهوجئا	Gaochang
布朗族	Blang people
باغراش ناھىيىسى	Bagrax County
بورتالا شەھىرى	Bole, Xinjiang
جىمىسار ناھىيىسى	Jimsar County
تاشقۇرقان تاجىك ئاپتونوم ناھىيىسى	Tashkurgan Tajik Autonomous County
روبوت چاتما رومانى	Robot series (Asimov)
قىزىل بۆكەن	Red goral
ياردەم:ياردەم	Help:Contents
خوتەن ناھىيىسى	Hotan County
لوپ ناھىيىسى	Lop County
بازىنىڭ چېتى	Foundation's Edge
پارىژ ساھىلى	Paris-Plages
يۈسۈپ خاس ھاجىپ	Yusuf Khass Hajib
مەھمەت شىمشەك	Mehmet Şimşek
ئورقۇ رايونى	Urho District
تاشقۇرغان	Tashkurgan Town
شىنجاڭ ئۇنىۋېرستېتى	Xinjiang University
چوڭ تەخسە توخۇ قورۇمىسى	Dapanji
ئىپارخان	Fragrant Concubine
لاتىن ھەرپلىرى ئاساسىدىكى ئۇيغۇر يېڭى يېزىقى	Uyghur Latin alphabet
لۇتپۇللا مۇتەللىپ	Lutpulla Mutellip
شەرقى تۈركىستان جۇمھۇرىيىتى	First East Turkestan Republic
تۇمشۇق شەھىرى	Tumxuk
بۈيۈك ئارال	Büyükada
خوتەن ۋىلايىتى	Hotan Prefecture
قۇمۇل ۋىلايىتى	Hami Prefecture
سانجى خۇيزۇ ئاپتونوم ئوبلاستى	Changji Hui Autonomous Prefecture
كۈيتۇن شەھىرى	Kuytun
سانجى شەھىرى	Changji
چاپچال شىبە ئاپتونوم يېزىسى	Qapqal Xibe Autonomous County
فارس ۋىلايىتى	Fars Province
بۇرگاز ئارىلى	Burgazada
بۇرچىن ناھىيىسى	Burqin County
بۇرۇلتوقاي ناھىيىسى	Fuhai County
بۈيۈك بىرلىك پارتىيىسى	Great Union Party
يېڭىسار ناھىيىسى	Yengisar County
ۋۇسۇ شەھىرى	Wusu
دۆربىلجىن ناھىيىسى	Dörbiljin County
پوسكام ناھىيىسى	Poskam County
گۇچۇڭ ناھىيىسى	Qitai County
قورغاس ناھىيىسى	Huocheng County
يەنجى خۇيزۇ ئاپتونوم ناھىيىسى	Yanqi Hui Autonomous County
لوپنۇر ناھىيىسى	Yuli County
كوكتوقاي ناھىيىسى	Fuyun County
قوبۇقسار موڭغۇل ئاپتونوم ناھىيىسى	Hoboksar Mongol Autonomous County
قەشقەر كونا شەھەر ناھىيىسى	Shufu County
ساۋەن ناھىيىسى	Shawan County
قاغىلىق ناھىيىسى	Kargilik County
خېجىڭ ناھىيىسى	Hejing County
چاغانتوقاي ناھىيىسى	Yumin County
پىچان ناھىيىسى	Piqan County
كۇچار ناھىيىسى	Kuqa County
مايتاغ رايونى	Dushanzi District
چاقىلىق ناھىيىسى	Ruoqiang County
بۈگۈر ناھىيىسى	Luntai County
قەشقەر يېڭىشەھەر ناھىيىسى	Shule County
شايار ناھىيىسى	Xayar County
مارالبېشى ناھىيىسى	Maralbexi County
ماناس ناھىيىسى	Manas County
ئونسۇ ناھىيىسى	Wensu County
چىڭگىل ناھىيىسى	Qinggil County
پەيزاۋات ناھىيىسى	Peyziwat County
مورى قازاق ئاپتونوم ناھىيىسى	Mori Kazakh Autonomous County
تولى ناھىيىسى	Toli County
خوشۇت ناھىيىسى	Hoxud County
يېڭىشەھەر رايونى	Xinshi District, Ürümqi
تۇدۇڭخابا رايونى	Toutunhe District
تەڭرىتاغ رايونى	Tianshan District
داۋانچىڭ رايونى	Dabancheng District
گۇما ناھىيىسى	Pishan County
سايباغ رايونى	Saybagh District
ئاشقازان	Stomach
يەسۇن تۆمۇرخان	Yesun Temur (Chagatai Khanate)
چاڭشى	Changshi
ئېلىك	Capreolus
شىبە مىللىتى	Xibe people
كىنو مىللىتى	Jino people
كروران قەدىمكى شەهىرى	Loulan Kingdom
ئورۇنچون مىللىتى	Oroqen people
ئەنقەرە ئۇنىۋېرسىتېتى	Ankara University
مەمتىمىن ھوشۇر	Memtimin Hoshur
مۇسئەب ئىبن ئۆمەير	Mus`ab ibn `Umair
پېشاۋار	Peshawar
دۇتار	Dutar
كونا تاڭنامە	Old Book of Tang
تاڭ سۇلالىسىگە دائىر مۇھىم خاتىرىلەر	Tang Huiyao
مۇئاز ئىبنى جەبەل	Muadh ibn Jabal
جۇڭغار ئويمانلىقى	Dzungar basin
قاراشەھەر بازىرى	Karasahr
سۈينامە	Book of Sui
سەئىدىيە خانلىقى	Yarkent Khanate
شىمالىي سۇلالىلەرنىڭ تارىخى	History of the Northern Dynasties
باش تومۇز	Xiaoshu
تۇغلۇق تۆمۇرخان	Tughlugh Timur
چەتئەلگە چىقىپ ئوقۇش	Study abroad
قارا ھۈلەگۈ	Qara Hülëgü
ئۇچتۇرپان ناھىيىسى	Uqturpan County
چىرا ناھىيىسى	Qira County
كەلپىن ناھىيىسى	Kalpin County
قاراقاش ناھىيىسى	Karakax County
جىڭ ناھىيىسى	Jinghe County
نىيە ناھىيىسى	Minfeng County
غۇلجا ناھىيىسى	Yining County
شۇيموگۇ رايونى	Shuimogou District
كېرىيە ناھىيىسى	Keriya County
تۇخۇم نەيچىسى	Fallopian tube
ئابادە ناھىيىسى	Abadeh County
شىنجاڭ ئىشلەپچىقىرىش - قۇرۇلۇش بىڭتۇەنى	Xinjiang Production and Construction Corps
قەشقەر ھېيتگاھ مەسچىتى	Id Kah Mosque
شياڭگاڭ پەن ـ تېخنىكا ئۇنىۋېرسىتېتى	Hong Kong University of Science and Technology
كونا بەش دەۋر تارىخى	Old History of the Five Dynasties
دۇۋا	Duwa
باراق	Ghiyas-ud-din Baraq
ﻣﯧﯔ ﺟىيەنﺠﯘ	Meng Jianzhu
جېمىنەي ناھىيىسى	Jeminay County
توققۇزتارا ناھىيىسى	Tokkuztara County
قاراماي رايونى	Karamay District
نىلقا ناھىيىسى	Nilka County
مۇرات ناسىروۋ	Murat Nasyrov
رۇس مىللىتى	Russians in China
تېكەس ناھىيىسى	Tekes County
توقسۇ ناھىيىسى	Toksu County
ئېسفەھان ۋىلايىتى	Isfahan Province
تۈر:تۈركىيە	Category:Turkey
تۈر:ئۆسۈملۈك	Category:Plants
تۈر:فىزىكا	Category:Physics
تۈر:تەبىئىي پەن	Category:Natural sciences
تۈر:Geografia	Category:Geography
غازى ئۇنىۋېرسىتېتى	Gazi University
قەشقەر دەرياسى	Kashgar River
غىجەك	Ghaychak
كۆكتوقاي بازىرى	Koktokay
لەغمەن	Lamian
تۈركىي مىللەتلەر	Turkish
ھاجەتتەپە ئۇنىۋرېستېتى	Hacettepe University
خۇيزۇ	Hui
سائادەت پارتىيىسى	Felicity Party
دوگانا	Dogana
ساكاريا ئۇنىۋېرسىتېتى	Sakarya University
ماخۇاتېڭ	Ma Huateng
قۇتادغۇبىلىك	Kutadgu Bilig
شەيدۇللا	Xaidulla
ئۇيغۇر بازىرى	Uygur, Amasya
سالانق تەشمەسى	Salang Tunnel
سىۋرى ئارىلى	Sivriada
ياسسى ئارىلى	Yassıada
تۈر:خرىستىئان دىنى	Category:Christianity
بارلاس قەبىلىسى	Barlas
قەدىمكى ئۇيغۇر يېزىقى	Old Uyghur alphabet
جىڭزۇ مىللىتى	Overseas Vietnamese
ئائىلە جەمئىيەتشۇناسلىقى	Sociology of the family
ئەنقەرە ۋىلايىتى	Ankara Province
قاراقاش دەرياسى	Karakash River
يورۇڭقاش دەرياسى	White Jade River
جۇڭغار قۇلانى	Mongolian wild ass
ئەرەب ھەرپلىرى ئاساسىدىكى ئۇيغۇر يېزىقى	Uyghur Arabic alphabet
چەرچەن دەرياسى	Qiemo River
تۇنيۇقۇق	Tonyukuk
قاراباغ	Karabakh
ئىراق ۋە شام ئىسلام دۆلىتى	Islamic State of Iraq and the Levant
ماجيەن	Muhammad Ma Jian
پوزىترونىك مىڭە	Positronic brain
بۇزان	Buzan
پۇشتۇ مىللىتى	Pashtun people
يەسۈ مۆڭكە	Yesü Möngke
تارانچى	Taranchi
مەشرەپ	Meshrep
شىخەنزە ئۇنىۋېرسىتېتى	Shihezi University
قەشقەر ئايىرپورت	Kashgar Airport
مۇقام	Muqam
ئابدۇخالىق ئۇيغۇر	Abduxaliq Uyghur
ئەخمەتجان ﻗﺎﺳﯩﻤﻰ	Ehmetjan Qasim
ئەلجىگىدەي	Eljigidey
گېئورگى بۇچنېر ئەدەبىيات مۇكاپاتى	Georg Büchner Prize
توشقان دەرياسى	Toshkan River
چاڭ	Çeng
مۇباراك شاھ	Mubarak Shah
كۆنچەك	Könchek
ئابدۇرېھىم ئۆتكۈر	Abdurehim Ötkür
سۇلتان سەئىدخان	Sultan Said Khan
دۇۋا تۆمۇرخان	Duwa Temür
تالىقۇ	Taliqu
كېسەل	Calf (anatomy)
نۇر بەكرى	Nur Bekri
ﺩﯨﻠﺒﻪﺭ ﻳﯘﻧﯘﺱ	Dilber Yunus
سۇلتان سۇتۇق بۇغراخان	Sultan Satuq Bughra Khan
بىنەپشە رەڭ	Purple
سەيپىدىن ئەزىزى	Saifuddin Azizi
ئاتىلىم ئۇنىۋېرستېتى	Atılım University
پراۋوسلاۋىيە دىنى	Orthodox Christianity
ئەركىن ئابدۇللا	Erkin Abdulla
ئىستانبۇلدىكى ئۇنىۋېرسىتېتلار:	List of universities in Istanbul
باھچەشەھىر ئۇنىۋېرستېتى	Bahçeşehir University
تەمبۈر	Tanbur
Ördek	Duck
ساران	Saran, East Azerbaijan
قېلىپ:Tl	Template:Tl
قېلىپ:Userbox	Template:Userbox
ئۇخاۋچۈ يېزىسى	Wuhaoqu Township
Wikipedia:Administrators	Wikipedia:Administrators
تۈر:جۇڭخۇا مىللەتلىرى	Category:Ethnic groups in China
مىسىر	Egypt
زوردۇن سابىر	Zordun Sabir
قېلىپ:Bot	Template:Bot
كانادا	Canada
Wikipedia:ھەققىدە	Wikipedia:About
قېلىپ:Flagicon	Template:Flagicon
قېلىپ:Documentation	Template:Documentation
Sung Jae-gi	Sung Jae-gi
تۈرك نەي	Turkish ney
مۇزات دەرياسى	Muzat River
ئايكۆل يېزىسى	Aykol
تۇرغۇن ئالماس	Turghun Almas
قېلىپ:Softredirect	Template:Soft redirect
قېلىپ:Delete	Template:Db
بېيداچۈ يېزىسى	Beidaqu Township
بورقاي يېزىسى	Borhoi Township
تۈر:تىل	Category:Languages
Wikipedia:General disclaimer	Wikipedia:General disclaimer
قېلىپ:Navbox	Template:Navbox
ئورقۇن-يېنسەي يېزىقى	Old Turkic alphabet
خالتىلىق چاشقان	Kangaroo
19 - ماي ئاتاتۈركنى خاتىرلەش، ياشلار ۋە تەنتەربىيە بايرىمى	Commemoration of Atatürk, Youth and Sports Day
ئالاتاۋ ئېغىزى	Alashankou
ئىسمايىل تىلىۋالدى	Ismail Tiliwaldi
قېلىپ:Tnavbar	Template:Navbar
قېلىپ:Babel	Template:Babel
قېلىپ:Commons	Template:Commons
قېلىپ:Reflist	Template:Reflist
قېلىپ:Stub	Template:Stub
قېلىپ:User az	Template:User az
قېلىپ:User de	Template:User de
قېلىپ:User de-1	Template:User de-1
قېلىپ:User es	Template:User es
قېلىپ:User de-3	Template:User de-3
قېلىپ:User en-3	Template:User en-3
قېلىپ:User en-1	Template:User en-1
قېلىپ:User en-2	Template:User en-2
قېلىپ:User en-4	Template:User en-4
قېلىپ:User en	Template:User en
قېلىپ:User de-2	Template:User de-2
قېلىپ:User es-1	Template:User es-1
قېلىپ:User fr-1	Template:User fr-1
قېلىپ:User ja-4	Template:User ja-4
قېلىپ:User sk	Template:User sk
قېلىپ:User tr-2	Template:User tr-2
قېلىپ:User tr	Template:User tr
قېلىپ:User ja	Template:User ja
قېلىپ:User ja-1	Template:User ja-1
قېلىپ:User fr	Template:User fr
قېلىپ:Location map/Info	Template:Location map/Info
قېلىپ:Mod	Template:Mod
قېلىپ:Welcome	Template:Welcome
تۈر:كىشلىك ئالاقە	Category:Human communication
تۈر:User fr-1	Category:User fr-1
قېلىپ:Country showdata	Template:Country showdata
قېلىپ:Category handler	Template:Category handler
قېلىپ:ئافرىقا	Template:Countries of Africa
قېلىپ:Country data NEP	Template:Country data Nepal
قېلىپ:Documentation/docname	Template:Documentation/docname
تۈر:User en-4	Category:User en-4
تۈر:User en	Category:User en
تۈر:User zh	Category:User zh
تۈر:User zh-N	Category:User zh-N
تۈر:User en-2	Category:User en-2
قېلىپ:Infobox	Template:Infobox
قېلىپ:ئىراننىڭ ۋىلايەتلىرى	Template:Provinces of Iran
قېلىپ:User zh	Template:User zh
قېلىپ:Protected title	Template:Protected title
قېلىپ:Legend	Template:Legend
قېلىپ:Ombox	Template:Ombox
قېلىپ:Country data	Template:Country data
قېلىپ:Pp-template	Template:Pp-template
قېلىپ:User ru	Template:User ru
قېلىپ:IPA	Template:IPA
قېلىپ:ئىنجىل	Template:Books of the New Testament
قېلىپ:ئوكيانىيە	Template:Countries and territories of Oceania
قېلىپ:Unreferenced	Category:Articles lacking sources
قېلىپ:جۇڭخۇا خەلق جۇمھۇرىيىتى	Template:Province-level divisions of China
شىنجاڭ تىببى ئۇنىۋېرسىتېتى	Xinjiang Medical University
قېلىپ:Provinces of Uzbekistan	Template:Regions of Uzbekistan
قېلىپ:ياپونىيە	Template:Regions and administrative divisions of Japan
زۇنۇن قادىرى	Zunun Kadir
تۈر:User ja-N	Category:User ja-N
تۈر:سانائەت	Category:Industries
قېلىپ:Tick	Template:Tick
قېلىپ:رۇسىيە	Template:Subdivisions of Russia
قېلىپ:Infobox person	Template:Infobox person
قېلىپ:ياۋروپا	Template:Sovereign states of Europe
تۈر:User az	Category:User az
تۈر:User sk	Category:User sk
تۈر:User fr	Category:User fr
تۈر:User ja	Category:User ja
تۈر:User mn	Category:User mn
تۈر:User az-3	Category:User az-3
تۈر:User fr-3	Category:User fr-3
تۈر:User ja-3	Category:User ja-3
تۈر:User tr-3	Category:User tr-3
تۈر:User tr-1	Category:User tr-1
تۈر:User fr-4	Category:User fr-4
تۈر:User fr-2	Category:User fr-2
تۈر:User ja-2	Category:User ja-2
تۈر:User kk-2	Category:User kk-2
تۈر:User tr-2	Category:User tr-2
تۈر:User ko-N	Category:User ko-N
تۈر:User fr-N	Category:User fr-N
تۈر:User ru-N	Category:User ru-N
تۈر:User fr-5	Category:User fr-5
تۈر:Articles with hCards	Category:Articles with hCards
تۈر:User az-1	Category:User az-1
تۈر:User az-2	Category:User az-2
تۈر:User az-4	Category:User az-4
تۈر:User az-N	Category:User az-N
تۈر:User sk-N	Category:User sk-N
تۈر:User de	Category:User de
تۈر:User de-2	Category:User de-2
تۈر:User de-3	Category:User de-3
تۈر:User de-4	Category:User de-4
تۈر:User de-N	Category:User de-N
شىراز	Shiraz
تۈر:User en-3	Category:User en-3
تۈر:User en-N	Category:User en-N
تۈر:User es	Category:User es
تۈر:User es-1	Category:User es-1
تۈر:User es-N	Category:User es-N
خۇشتار	Khushtar
تۈر:Articles with microformats	Category:Articles with microformats
تۈر:User ja-1	Category:User ja-1
تۈر:User kk	Category:User kk
تۈر:User kk-3	Category:User kk-3
تۈر:User kk-4	Category:User kk-4
تۈر:User kk-N	Category:User kk-N
تۈر:User ko	Category:User ko
تۈر:User ko-3	Category:User ko-3
تۈر:User ky	Category:User ky
تۈر:User ky-2	Category:User ky-2
تۈر:User ky-N	Category:User ky-N
جۇڭخۇا خةلق جۇمھۇرىيتىنىڭ ئةمگةك توختام قانۇنى	Labour Law of the People's Republic of China
تۈر:User ru-1	Category:User ru-1
تۈر:User mn-1	Category:User mn-1
قېلىپ:Table Greekletters	Template:Greek alphabet sidebar
تۈر:ئىقتىساد	Category:Economies
باشقۇرغۇچى مەشغۇلات قوللانمىسى	Wikipedia:Administrators' how-to guide
تۈر:User zh-min-nan	Category:User nan
تۈر:User zh-min-nan-3	Category:User nan-3
قېلىپ:Sockpuppet	Template:Sockpuppet
قېلىپ:User ru-2	Template:User ru-2
تۈر:User ru	Category:User ru
تۈر:User tk	Category:User tk
تۈر:User tk-2	Category:User tk-2
تۈر:User tr	Category:User tr
تۈر:User tr-4	Category:User tr-4
تۈر:User tr-N	Category:User tr-N
تۈر:User ug	Category:User ug
تۈر:User ug-1	Category:User ug-1
تۈر:User ug-2	Category:User ug-2
تۈر:User ug-3	Category:User ug-3
تۈر:User ug-N	Category:User ug-N
تۈر:User uz	Category:User uz
تۈر:User uz-3	Category:User uz-3
ۋىكىپېدىيە:ھۆججەت ئىشلىتىش پىرىنسىپى	Wikipedia:Image use policy
ئۇيغۇر سىرىل يېزىقى	Uyghur Cyrillic alphabet
كرورەن	Loulan
قېلىپ:Infobox City Japan	Template:Infobox city Japan
ساتار	Sataer
تۈر:ۋىتامىنلار	Category:Vitamins
قېلىپ:User ru-1	Template:User ru-1
قېلىپ:User tr-1	Template:User tr-1
قېلىپ:User tr-3	Template:User tr-3
قېلىپ:User uz	Template:User uz
قېلىپ:User zh-1	Template:User zh-1
قېلىپ:User zh-2	Template:User zh-2
قېلىپ:User zh-3	Template:User zh-3
قېلىپ:User zh-4	Template:User zh-4
تۈر:شىنجاڭ ئۇيغۇر ئاپتونوم رايونىدىكى ئالى مەكتەپلەر	Category:Universities and colleges in Xinjiang
تۈر:User zh-1	Category:User zh-1
تۈر:User zh-4	Category:User zh-4
تۈر:User zh-3	Category:User zh-3
تۈر:User zh-2	Category:User zh-2
تۈر:خىمىيىۋى ئېلېمېنت	Category:Chemical elements
تۈر:لېكسىكولوگىيە	Category:Lexicology
تۈر:ئۆزبېكىستان	Category:Uzbekistan
تۈر:جەمئىيەت مەسلىسى	Category:Social issues
تۈر:ئاتوم يادرو فىزىكىسى	Category:Nuclear physics
ئەينەك تالا	Fiberglass
سەۋزە	Carrot
چاغانچېكە يېزىسى	Qagan Qehe Township
تۈر:قەشقەر	Category:Kashgar
تۈر:ئېتمولوگىيە	Category:Etymology
قېلىپ:Flag	Template:Flag
قېلىپ:User ug-1	Template:User ug-1
شىنجاڭ يېزائېگىلىك ئۇنىۋېرسىتېتى	Xinjiang Agricultural University
شىنجاڭ سەنئەت ئىنىستىتۇتى	Xinjiang Arts Institute
شىنجاڭ مالىيە-ئىقتىساد ئۇنىۋېرسىتېتى	Xinjiang University of Finance and Economics
قېلىپ:جۇڭگودىكى مىللەتلەر	Template:Ethnic groups in China
قېلىپ:User ug	Template:User ug
قېلىپ:User mn-1	Template:User mn-1
قېلىپ:UF-hcard-geo	Template:UF-hcard-geo
تۈر:بىيولوگ	Category:Biologists
تراگۇلۇس بۇغىسى	Chevrotain
تۈر:خاس ئات ئىلمى	Category:Onomastics
تۈر:Uyghur tili	Category:Uyghur language
تۈر:User en-1	Category:User en-1
تۈر:User de-1	Category:User de-1
قېلىپ:ئانتروپوتومىيە	Template:Human regional anatomy
قېلىپ:User zh-min-nan-3	Template:User nan-3
قېلىپ:User ug-2	Template:User ug-2
قېلىپ:User ug-3	Template:User ug-3
قېلىپ:User ug-4	Template:User ug-4
ﻗﺎﺭﺍ ﭘﺎﭘﺎﻕ ﻣﯩﻠﻠﯩﺘﻰ	Qarapapaqs
قېلىپ:شىنجاڭ	Template:Xinjiang
سېسىق قوزان	Civet
بۇقا تۆمۇرخان	Buqa Temür
تاش	Roche
كۆكتۈرك خانلىقى	Turkic Khaganate
خوتەن شەھىرى	Hotan
ئالاھىدە:RecentChanges	Special:RecentChanges
تۈر:User ja-4	Category:User ja-4
خارۇكو ئوبوكاتا	Haruko Obokata
ئەركىن سىدىق	Erkin Sidick
